Parish,Date,Labor force size,Employment,Unemployment,Unemployment rate,National labor force size,National employment,National unemployment,National unemployment rate
Acadia,1/1/1990,20286,19091,1195,5.9,125833,119081,6752,5.4
Acadia,2/1/1990,20485,19375,1110,5.4,125710,119059,6651,5.3
Acadia,3/1/1990,20837,19710,1127,5.4,125801,119203,6598,5.2
Acadia,4/1/1990,20955,19904,1051,5,125649,118852,6797,5.4
Acadia,5/1/1990,21237,20029,1208,5.7,125893,119151,6742,5.4
Acadia,6/1/1990,21810,20254,1556,7.1,125573,118983,6590,5.2
Acadia,7/1/1990,22890,20700,2190,9.6,125732,118810,6922,5.5
Acadia,8/1/1990,22731,20916,1815,8,125990,118802,7188,5.7
Acadia,9/1/1990,21957,20384,1573,7.2,125892,118524,7368,5.9
Acadia,10/1/1990,21907,20510,1397,6.4,125995,118536,7459,5.9
Acadia,11/1/1990,21778,20504,1274,5.8,126070,118306,7764,6.2
Acadia,12/1/1990,21678,20469,1209,5.6,126142,118241,7901,6.3
Acadia,1/1/1991,21235,19929,1306,6.2,125955,117940,8015,6.4
Acadia,2/1/1991,21368,20074,1294,6.1,126020,117755,8265,6.6
Acadia,3/1/1991,21773,20380,1393,6.4,126238,117652,8586,6.8
Acadia,4/1/1991,22088,20715,1373,6.2,126548,118109,8439,6.7
Acadia,5/1/1991,21995,20603,1392,6.3,126176,117440,8736,6.9
Acadia,6/1/1991,22511,20779,1732,7.7,126331,117639,8692,6.9
Acadia,7/1/1991,23313,21036,2277,9.8,126154,117568,8586,6.8
Acadia,8/1/1991,22380,20783,1597,7.1,126150,117484,8666,6.9
Acadia,9/1/1991,22233,20674,1559,7,126650,117928,8722,6.9
Acadia,10/1/1991,22336,20636,1700,7.6,126642,117800,8842,7
Acadia,11/1/1991,22229,20624,1605,7.2,126701,117770,8931,7
Acadia,12/1/1991,22032,20480,1552,7,126664,117466,9198,7.3
Acadia,1/1/1992,21623,19698,1925,8.9,127261,117978,9283,7.3
Acadia,2/1/1992,21492,19696,1796,8.4,127207,117753,9454,7.4
Acadia,3/1/1992,21782,19898,1884,8.6,127604,118144,9460,7.4
Acadia,4/1/1992,21925,20066,1859,8.5,127841,118426,9415,7.4
Acadia,5/1/1992,21819,19922,1897,8.7,128119,118375,9744,7.6
Acadia,6/1/1992,22504,20041,2463,10.9,128459,118419,10040,7.8
Acadia,7/1/1992,23090,20870,2220,9.6,128563,118713,9850,7.7
Acadia,8/1/1992,22933,20751,2182,9.5,128613,118826,9787,7.6
Acadia,9/1/1992,22519,20418,2101,9.3,128501,118720,9781,7.6
Acadia,10/1/1992,22292,20423,1869,8.4,128026,118628,9398,7.3
Acadia,11/1/1992,22118,20545,1573,7.1,128441,118876,9565,7.4
Acadia,12/1/1992,21553,20080,1473,6.8,128554,118997,9557,7.4
Acadia,1/1/1993,21058,19410,1648,7.8,128400,119075,9325,7.3
Acadia,2/1/1993,21074,19603,1471,7,128458,119275,9183,7.1
Acadia,3/1/1993,21434,19832,1602,7.5,128598,119542,9056,7
Acadia,4/1/1993,21567,19981,1586,7.4,128584,119474,9110,7.1
Acadia,5/1/1993,21694,20044,1650,7.6,129264,120115,9149,7.1
Acadia,6/1/1993,22060,20015,2045,9.3,129411,120290,9121,7
Acadia,7/1/1993,22253,20347,1906,8.6,129397,120467,8930,6.9
Acadia,8/1/1993,22234,20420,1814,8.2,129619,120856,8763,6.8
Acadia,9/1/1993,21699,20172,1527,7,129268,120554,8714,6.7
Acadia,10/1/1993,21952,20298,1654,7.5,129573,120823,8750,6.8
Acadia,11/1/1993,21924,20375,1549,7.1,129711,121169,8542,6.6
Acadia,12/1/1993,21806,20327,1479,6.8,129941,121464,8477,6.5
Acadia,1/1/1994,21432,19676,1756,8.2,130596,121966,8630,6.6
Acadia,2/1/1994,21434,19887,1547,7.2,130669,122086,8583,6.6
Acadia,3/1/1994,21683,20077,1606,7.4,130400,121930,8470,6.5
Acadia,4/1/1994,21890,20306,1584,7.2,130621,122290,8331,6.4
Acadia,5/1/1994,21848,20424,1424,6.5,130779,122864,7915,6.1
Acadia,6/1/1994,22180,20374,1806,8.1,130561,122634,7927,6.1
Acadia,7/1/1994,22533,20815,1718,7.6,130652,122706,7946,6.1
Acadia,8/1/1994,22483,20832,1651,7.3,131275,123342,7933,6
Acadia,9/1/1994,22256,20609,1647,7.4,131421,123687,7734,5.9
Acadia,10/1/1994,22139,20520,1619,7.3,131744,124112,7632,5.8
Acadia,11/1/1994,22065,20658,1407,6.4,131891,124516,7375,5.6
Acadia,12/1/1994,21800,20485,1315,6,131951,124721,7230,5.5
Acadia,1/1/1995,21478,19916,1562,7.3,132038,124663,7375,5.6
Acadia,2/1/1995,21582,20144,1438,6.7,132115,124928,7187,5.4
Acadia,3/1/1995,21814,20436,1378,6.3,132108,124955,7153,5.4
Acadia,4/1/1995,22083,20625,1458,6.6,132590,124945,7645,5.8
Acadia,5/1/1995,21860,20486,1374,6.3,131851,124421,7430,5.6
Acadia,6/1/1995,22262,20593,1669,7.5,131949,124522,7427,5.6
Acadia,7/1/1995,22999,20878,2121,9.2,132343,124816,7527,5.7
Acadia,8/1/1995,22449,20878,1571,7,132336,124852,7484,5.7
Acadia,9/1/1995,22274,20747,1527,6.9,132611,125133,7478,5.6
Acadia,10/1/1995,22281,20771,1510,6.8,132716,125388,7328,5.5
Acadia,11/1/1995,22446,20911,1535,6.8,132614,125188,7426,5.6
Acadia,12/1/1995,22277,20813,1464,6.6,132511,125088,7423,5.6
Acadia,1/1/1996,22480,20282,2198,9.8,132616,125125,7491,5.6
Acadia,2/1/1996,22355,20579,1776,7.9,132952,125639,7313,5.5
Acadia,3/1/1996,22464,20778,1686,7.5,133180,125862,7318,5.5
Acadia,4/1/1996,22635,20959,1676,7.4,133409,125994,7415,5.6
Acadia,5/1/1996,22661,20981,1680,7.4,133667,126244,7423,5.6
Acadia,6/1/1996,22897,21143,1754,7.7,133697,126602,7095,5.3
Acadia,7/1/1996,23099,21539,1560,6.8,134284,126947,7337,5.5
Acadia,8/1/1996,23155,21679,1476,6.4,134054,127172,6882,5.1
Acadia,9/1/1996,23033,21524,1509,6.6,134515,127536,6979,5.2
Acadia,10/1/1996,23115,21661,1454,6.3,134921,127890,7031,5.2
Acadia,11/1/1996,23061,21677,1384,6,135007,127771,7236,5.4
Acadia,12/1/1996,22927,21663,1264,5.5,135113,127860,7253,5.4
Acadia,1/1/1997,22350,21015,1335,6,135456,128298,7158,5.3
Acadia,2/1/1997,22215,21121,1094,4.9,135400,128298,7102,5.2
Acadia,3/1/1997,22578,21425,1153,5.1,135891,128891,7000,5.2
Acadia,4/1/1997,22784,21661,1123,4.9,136016,129143,6873,5.1
Acadia,5/1/1997,22811,21719,1092,4.8,136119,129464,6655,4.9
Acadia,6/1/1997,23146,21748,1398,6,136211,129412,6799,5
Acadia,7/1/1997,23424,22125,1299,5.5,136477,129822,6655,4.9
Acadia,8/1/1997,24164,22112,2052,8.5,136618,130010,6608,4.8
Acadia,9/1/1997,24009,21826,2183,9.1,136675,130019,6656,4.9
Acadia,10/1/1997,23111,22020,1091,4.7,136633,130179,6454,4.7
Acadia,11/1/1997,22976,21980,996,4.3,136961,130653,6308,4.6
Acadia,12/1/1997,22949,22014,935,4.1,137155,130679,6476,4.7
Acadia,1/1/1998,22605,21461,1144,5.1,137095,130726,6368,4.6
Acadia,2/1/1998,22623,21636,987,4.4,137112,130807,6306,4.6
Acadia,3/1/1998,22916,21838,1078,4.7,137236,130814,6422,4.7
Acadia,4/1/1998,23381,22138,1243,5.3,137150,131209,5941,4.3
Acadia,5/1/1998,23430,22157,1273,5.4,137372,131325,6047,4.4
Acadia,6/1/1998,23814,22263,1551,6.5,137455,131244,6212,4.5
Acadia,7/1/1998,23959,22504,1455,6.1,137588,131329,6259,4.5
Acadia,8/1/1998,24097,22465,1632,6.8,137570,131390,6179,4.5
Acadia,9/1/1998,23881,22181,1700,7.1,138286,131986,6300,4.6
Acadia,10/1/1998,23448,21998,1450,6.2,138279,131999,6280,4.5
Acadia,11/1/1998,23335,22001,1334,5.7,138381,132280,6100,4.4
Acadia,12/1/1998,23202,21875,1327,5.7,138634,132602,6032,4.4
Acadia,1/1/1999,22828,21190,1638,7.2,139003,133027,5976,4.3
Acadia,2/1/1999,22807,21289,1518,6.7,138967,132856,6111,4.4
Acadia,3/1/1999,23234,21382,1852,8,138730,132947,5783,4.2
Acadia,4/1/1999,23414,21513,1901,8.1,138959,132955,6004,4.3
Acadia,5/1/1999,22928,21449,1479,6.5,139107,133311,5796,4.2
Acadia,6/1/1999,23394,21527,1867,8,139329,133378,5951,4.3
Acadia,7/1/1999,23313,21587,1726,7.4,139439,133414,6025,4.3
Acadia,8/1/1999,23119,21548,1571,6.8,139430,133591,5838,4.2
Acadia,9/1/1999,23366,21398,1968,8.4,139622,133707,5915,4.2
Acadia,10/1/1999,23295,21505,1790,7.7,139771,133993,5778,4.1
Acadia,11/1/1999,23067,21541,1526,6.6,140025,134309,5716,4.1
Acadia,12/1/1999,22853,21467,1386,6.1,140177,134523,5653,4
Acadia,1/1/2000,23765,22367,1398,5.9,142267,136559,5708,4
Acadia,2/1/2000,23673,22436,1237,5.2,142456,136598,5858,4.1
Acadia,3/1/2000,23846,22515,1331,5.6,142434,136701,5733,4
Acadia,4/1/2000,23449,22265,1184,5,142751,137270,5481,3.8
Acadia,5/1/2000,23871,22516,1355,5.7,142388,136630,5758,4
Acadia,6/1/2000,24541,23002,1539,6.3,142591,136940,5651,4
Acadia,7/1/2000,24733,23317,1416,5.7,142278,136531,5747,4
Acadia,8/1/2000,24130,22710,1420,5.9,142514,136662,5853,4.1
Acadia,9/1/2000,23589,22187,1402,5.9,142518,136893,5625,3.9
Acadia,10/1/2000,23470,22154,1316,5.6,142622,137088,5534,3.9
Acadia,11/1/2000,23248,21960,1288,5.5,142962,137322,5639,3.9
Acadia,12/1/2000,23340,22133,1207,5.2,143248,137614,5634,3.9
Acadia,1/1/2001,23410,21989,1421,6.1,143800,137778,6023,4.2
Acadia,2/1/2001,23370,22118,1252,5.4,143701,137612,6089,4.2
Acadia,3/1/2001,23476,22189,1287,5.5,143924,137783,6141,4.3
Acadia,4/1/2001,23341,22088,1253,5.4,143569,137299,6271,4.4
Acadia,5/1/2001,23360,22064,1296,5.5,143318,137092,6226,4.3
Acadia,6/1/2001,24035,22435,1600,6.7,143357,136873,6484,4.5
Acadia,7/1/2001,23862,22435,1427,6,143654,137071,6583,4.6
Acadia,8/1/2001,23785,22364,1421,6,143284,136241,7042,4.9
Acadia,9/1/2001,24102,22627,1475,6.1,143989,136846,7142,5
Acadia,10/1/2001,24279,22842,1437,5.9,144086,136392,7694,5.3
Acadia,11/1/2001,23970,22549,1421,5.9,144240,136238,8003,5.5
Acadia,12/1/2001,23638,22263,1375,5.8,144305,136047,8258,5.7
Acadia,1/1/2002,23553,22028,1525,6.5,143883,135701,8182,5.7
Acadia,2/1/2002,23619,22301,1318,5.6,144653,136438,8215,5.7
Acadia,3/1/2002,23660,22310,1350,5.7,144481,136177,8304,5.7
Acadia,4/1/2002,23854,22445,1409,5.9,144725,136126,8599,5.9
Acadia,5/1/2002,23856,22461,1395,5.8,144938,136539,8399,5.8
Acadia,6/1/2002,24175,22539,1636,6.8,144808,136415,8393,5.8
Acadia,7/1/2002,23831,22323,1508,6.3,144803,136413,8390,5.8
Acadia,8/1/2002,23744,22254,1490,6.3,145009,136705,8304,5.7
Acadia,9/1/2002,23779,22267,1512,6.4,145552,137302,8251,5.7
Acadia,10/1/2002,23931,22491,1440,6,145314,137008,8307,5.7
Acadia,11/1/2002,23912,22502,1410,5.9,145041,136521,8520,5.9
Acadia,12/1/2002,23716,22292,1424,6,145066,136426,8640,6
Acadia,1/1/2003,24001,22392,1609,6.7,145937,137417,8520,5.8
Acadia,2/1/2003,23615,22173,1442,6.1,146100,137482,8618,5.9
Acadia,3/1/2003,23837,22348,1489,6.2,146022,137434,8588,5.9
Acadia,4/1/2003,24229,22794,1435,5.9,146474,137633,8842,6
Acadia,5/1/2003,24138,22613,1525,6.3,146500,137544,8957,6.1
Acadia,6/1/2003,24775,22792,1983,8,147056,137790,9266,6.3
Acadia,7/1/2003,24454,22569,1885,7.7,146485,137474,9011,6.2
Acadia,8/1/2003,24137,22405,1732,7.2,146445,137549,8896,6.1
Acadia,9/1/2003,23951,22280,1671,7,146530,137609,8921,6.1
Acadia,10/1/2003,24111,22580,1531,6.3,146716,137984,8732,6
Acadia,11/1/2003,23921,22469,1452,6.1,147000,138424,8576,5.8
Acadia,12/1/2003,23680,22299,1381,5.8,146729,138411,8317,5.7
Acadia,1/1/2004,23644,22125,1519,6.4,146842,138472,8370,5.7
Acadia,2/1/2004,23391,22109,1282,5.5,146709,138542,8167,5.6
Acadia,3/1/2004,23575,22234,1341,5.7,146944,138453,8491,5.8
Acadia,4/1/2004,23796,22540,1256,5.3,146850,138680,8170,5.6
Acadia,5/1/2004,23722,22402,1320,5.6,147065,138852,8212,5.6
Acadia,6/1/2004,24194,22671,1523,6.3,147460,139174,8286,5.6
Acadia,7/1/2004,24196,22813,1383,5.7,147692,139556,8136,5.5
Acadia,8/1/2004,24074,22885,1189,4.9,147564,139573,7990,5.4
Acadia,9/1/2004,23837,22547,1290,5.4,147415,139487,7927,5.4
Acadia,10/1/2004,24265,23030,1235,5.1,147793,139732,8061,5.5
Acadia,11/1/2004,24104,22856,1248,5.2,148162,140231,7932,5.4
Acadia,12/1/2004,23910,22674,1236,5.2,148059,140125,7934,5.4
Acadia,1/1/2005,24213,22828,1385,5.7,148029,140245,7784,5.3
Acadia,2/1/2005,23900,22621,1279,5.4,148364,140385,7980,5.4
Acadia,3/1/2005,24052,22830,1222,5.1,148391,140654,7737,5.2
Acadia,4/1/2005,24058,22895,1163,4.8,148926,141254,7672,5.2
Acadia,5/1/2005,24137,22881,1256,5.2,149261,141609,7651,5.1
Acadia,6/1/2005,24775,23298,1477,6,149238,141714,7524,5
Acadia,7/1/2005,24239,22895,1344,5.5,149432,142026,7406,5
Acadia,8/1/2005,23947,22675,1272,5.3,149779,142434,7345,4.9
Acadia,9/1/2005,26491,24175,2316,8.7,149954,142401,7553,5
Acadia,10/1/2005,29591,27246,2345,7.9,150001,142548,7453,5
Acadia,11/1/2005,29685,27366,2319,7.8,150065,142499,7566,5
Acadia,12/1/2005,28331,27168,1163,4.1,150030,142752,7279,4.9
Acadia,1/1/2006,27010,26031,979,3.6,150214,143150,7064,4.7
Acadia,2/1/2006,26843,26068,775,2.9,150641,143457,7184,4.8
Acadia,3/1/2006,26898,26080,818,3,150813,143741,7072,4.7
Acadia,4/1/2006,26339,25544,795,3,150881,143761,7120,4.7
Acadia,5/1/2006,25850,24972,878,3.4,151069,144089,6980,4.6
Acadia,6/1/2006,26296,25224,1072,4.1,151354,144353,7001,4.6
Acadia,7/1/2006,26264,25379,885,3.4,151377,144202,7175,4.7
Acadia,8/1/2006,25915,25024,891,3.4,151716,144625,7091,4.7
Acadia,9/1/2006,25866,24959,907,3.5,151662,144815,6847,4.5
Acadia,10/1/2006,26009,25105,904,3.5,152041,145314,6727,4.4
Acadia,11/1/2006,25998,25068,930,3.6,152406,145534,6872,4.5
Acadia,12/1/2006,25773,24953,820,3.2,152732,145970,6762,4.4
Acadia,1/1/2007,25815,24848,967,3.7,153144,146028,7116,4.6
Acadia,2/1/2007,25743,24905,838,3.3,152983,146057,6927,4.5
Acadia,3/1/2007,26182,25293,889,3.4,153051,146320,6731,4.4
Acadia,4/1/2007,26238,25381,857,3.3,152435,145586,6850,4.5
Acadia,5/1/2007,26369,25370,999,3.8,152670,145903,6766,4.4
Acadia,6/1/2007,26943,25801,1142,4.2,153041,146063,6979,4.6
Acadia,7/1/2007,26851,25813,1038,3.9,153054,145905,7149,4.7
Acadia,8/1/2007,26729,25759,970,3.6,152749,145682,7067,4.6
Acadia,9/1/2007,26622,25621,1001,3.8,153414,146244,7170,4.7
Acadia,10/1/2007,26428,25543,885,3.3,153183,145946,7237,4.7
Acadia,11/1/2007,26527,25614,913,3.4,153835,146595,7240,4.7
Acadia,12/1/2007,26356,25434,922,3.5,153918,146273,7645,5
Acadia,1/1/2008,26732,25655,1077,4,154063,146378,7685,5
Acadia,2/1/2008,26603,25724,879,3.3,153653,146156,7497,4.9
Acadia,3/1/2008,26912,25939,973,3.6,153908,146086,7822,5.1
Acadia,4/1/2008,26847,26020,827,3.1,153769,146132,7637,5
Acadia,5/1/2008,26980,25969,1011,3.7,154303,145908,8395,5.4
Acadia,6/1/2008,27321,26112,1209,4.4,154313,145737,8575,5.6
Acadia,7/1/2008,27454,26347,1107,4,154469,145532,8937,5.8
Acadia,8/1/2008,27266,26086,1180,4.3,154641,145203,9438,6.1
Acadia,9/1/2008,26970,25893,1077,4,154570,145076,9494,6.1
Acadia,10/1/2008,27493,26328,1165,4.2,154876,144802,10074,6.5
Acadia,11/1/2008,27021,25855,1166,4.3,154639,144100,10538,6.8
Acadia,12/1/2008,26661,25475,1186,4.4,154655,143369,11286,7.3
Acadia,1/1/2009,26091,24713,1378,5.3,154210,142152,12058,7.8
Acadia,2/1/2009,26061,24709,1352,5.2,154538,141640,12898,8.3
Acadia,3/1/2009,26299,24729,1570,6,154133,140707,13426,8.7
Acadia,4/1/2009,26588,25010,1578,5.9,154509,140656,13853,9
Acadia,5/1/2009,26657,24939,1718,6.4,154747,140248,14499,9.4
Acadia,6/1/2009,26976,24980,1996,7.4,154716,140009,14707,9.5
Acadia,7/1/2009,26883,25045,1838,6.8,154502,139901,14601,9.5
Acadia,8/1/2009,26543,24721,1822,6.9,154307,139492,14814,9.6
Acadia,9/1/2009,26273,24501,1772,6.7,153827,138818,15009,9.8
Acadia,10/1/2009,26285,24577,1708,6.5,153784,138432,15352,10
Acadia,11/1/2009,26226,24599,1627,6.2,153878,138659,15219,9.9
Acadia,12/1/2009,25624,23968,1656,6.5,153111,138013,15098,9.9
Acadia,1/1/2010,25470,23566,1904,7.5,153484,138438,15046,9.8
Acadia,2/1/2010,25672,23986,1686,6.6,153694,138581,15113,9.8
Acadia,3/1/2010,25844,24149,1695,6.6,153954,138751,15202,9.9
Acadia,4/1/2010,26286,24634,1652,6.3,154622,139297,15325,9.9
Acadia,5/1/2010,26319,24583,1736,6.6,154091,139241,14849,9.6
Acadia,6/1/2010,26636,24687,1949,7.3,153616,139141,14474,9.4
Acadia,7/1/2010,26852,25006,1846,6.9,153691,139179,14512,9.4
Acadia,8/1/2010,26575,24682,1893,7.1,154086,139438,14648,9.5
Acadia,9/1/2010,26298,24521,1777,6.8,153975,139396,14579,9.5
Acadia,10/1/2010,26400,24618,1782,6.8,153635,139119,14516,9.4
Acadia,11/1/2010,26177,24431,1746,6.7,154125,139044,15081,9.8
Acadia,12/1/2010,25750,24135,1615,6.3,153650,139301,14348,9.3
Acadia,1/1/2011,25353,23499,1854,7.3,153263,139250,14013,9.1
Acadia,2/1/2011,25416,23765,1651,6.5,153214,139394,13820,9
Acadia,3/1/2011,25492,23892,1600,6.3,153376,139639,13737,9
Acadia,4/1/2011,25755,24234,1521,5.9,153543,139586,13957,9.1
Acadia,5/1/2011,25866,24233,1633,6.3,153479,139624,13855,9
Acadia,6/1/2011,26102,24312,1790,6.9,153346,139384,13962,9.1
Acadia,7/1/2011,26447,24746,1701,6.4,153288,139524,13763,9
Acadia,8/1/2011,26255,24629,1626,6.2,153760,139942,13818,9
Acadia,9/1/2011,26168,24545,1623,6.2,154131,140183,13948,9
Acadia,10/1/2011,26262,24668,1594,6.1,153961,140368,13594,8.8
Acadia,11/1/2011,26237,24746,1491,5.7,154128,140826,13302,8.6
Acadia,12/1/2011,25967,24549,1418,5.5,153995,140902,13093,8.5
Acadia,1/1/2012,25572,23966,1606,6.3,154381,141584,12797,8.3
Acadia,2/1/2012,25882,24389,1493,5.8,154671,141858,12813,8.3
Acadia,3/1/2012,25977,24507,1470,5.7,154749,142036,12713,8.2
Acadia,4/1/2012,26313,24915,1398,5.3,154545,141899,12646,8.2
Acadia,5/1/2012,26589,25039,1550,5.8,154866,142206,12660,8.2
Acadia,6/1/2012,26949,25163,1786,6.6,155083,142391,12692,8.2
Acadia,7/1/2012,26853,25210,1643,6.1,154948,142292,12656,8.2
Acadia,8/1/2012,26302,24807,1495,5.7,154763,142291,12471,8.1
Acadia,9/1/2012,26144,24754,1390,5.3,155160,143044,12115,7.8
Acadia,10/1/2012,26427,25039,1388,5.3,155554,143431,12124,7.8
Acadia,11/1/2012,26322,25042,1280,4.9,155338,143333,12005,7.7
Acadia,12/1/2012,26286,24888,1398,5.3,155628,143330,12298,7.9
Acadia,1/1/2013,25977,24258,1719,6.6,155763,143292,12471,8
Acadia,2/1/2013,25926,24473,1453,5.6,155312,143362,11950,7.7
Acadia,3/1/2013,25936,24485,1451,5.6,155005,143316,11689,7.5
Acadia,4/1/2013,26226,24787,1439,5.5,155394,143635,11760,7.6
Acadia,5/1/2013,26494,24898,1596,6,155536,143882,11654,7.5
Acadia,6/1/2013,26924,25090,1834,6.8,155749,143999,11751,7.5
Acadia,7/1/2013,27053,25395,1658,6.1,155599,144264,11335,7.3
Acadia,8/1/2013,26667,25101,1566,5.9,155605,144326,11279,7.2
Acadia,9/1/2013,26469,24995,1474,5.6,155687,144418,11270,7.2
Acadia,10/1/2013,26252,24836,1416,5.4,154673,143537,11136,7.2
Acadia,11/1/2013,26203,24917,1286,4.9,155265,144479,10787,6.9
Acadia,12/1/2013,26040,24909,1131,4.3,155182,144778,10404,6.7
Acadia,1/1/2014,25814,24501,1313,5.1,155352,145150,10202,6.6
Acadia,2/1/2014,25884,24689,1195,4.6,155483,145134,10349,6.7
Acadia,3/1/2014,26061,24766,1295,5,156028,145648,10380,6.7
Acadia,4/1/2014,26221,25007,1214,4.6,155369,145667,9702,6.2
Acadia,5/1/2014,26322,24887,1435,5.5,155684,145825,9859,6.3
Acadia,6/1/2014,26689,25055,1634,6.1,155707,146247,9460,6.1
Acadia,7/1/2014,27184,25435,1749,6.4,156007,146399,9608,6.2
Acadia,8/1/2014,26989,25252,1737,6.4,156130,146530,9599,6.1
Acadia,9/1/2014,26819,25194,1625,6.1,156040,146778,9262,5.9
Acadia,10/1/2014,26862,25239,1623,6,156417,147427,8990,5.7
Acadia,11/1/2014,26749,25122,1627,6.1,156494,147404,9090,5.8
Acadia,12/1/2014,26602,25126,1476,5.5,156332,147615,8717,5.6
Acadia,1/1/2015,26118,24428,1690,6.5,157030,148145,8885,5.7
Acadia,2/1/2015,25940,24303,1637,6.3,156644,148045,8599,5.5
Acadia,3/1/2015,26072,24356,1716,6.6,156643,148128,8515,5.4
Acadia,4/1/2015,25841,24156,1685,6.5,157060,148511,8550,5.4
Acadia,5/1/2015,25937,24100,1837,7.1,157651,148817,8834,5.6
Acadia,6/1/2015,26122,24166,1956,7.5,157062,148816,8247,5.3
Acadia,7/1/2015,26046,24146,1900,7.3,156997,148830,8167,5.2
Acadia,8/1/2015,25650,23869,1781,6.9,157172,149181,7992,5.1
Acadia,9/1/2015,25265,23510,1755,6.9,156733,148826,7907,5
Acadia,10/1/2015,25185,23468,1717,6.8,157167,149246,7922,5
Acadia,11/1/2015,25079,23431,1648,6.6,157463,149463,8000,5.1
Acadia,12/1/2015,24954,23396,1558,6.2,158035,150128,7907,5
Acadia,1/1/2016,24753,22953,1800,7.3,158280,150653,7627,4.8
Acadia,2/1/2016,24696,22968,1728,7,158640,150939,7702,4.9
Acadia,3/1/2016,24838,23051,1787,7.2,159179,151218,7961,5
Acadia,4/1/2016,24654,22899,1755,7.1,159141,151074,8067,5.1
Acadia,5/1/2016,24739,22915,1824,7.4,158784,151132,7652,4.8
Acadia,6/1/2016,24978,22906,2072,8.3,158967,151223,7744,4.9
Acadia,7/1/2016,24938,22934,2004,8,159194,151554,7641,4.8
Acadia,8/1/2016,24398,22532,1866,7.6,159562,151779,7784,4.9
Acadia,9/1/2016,24258,22336,1922,7.9,159714,151761,7953,5
Acadia,10/1/2016,23962,22243,1719,7.2,159605,151793,7811,4.9
Acadia,11/1/2016,23953,22373,1580,6.6,159506,151954,7553,4.7
Acadia,12/1/2016,23850,22277,1573,6.6,159678,152157,7521,4.7
Acadia,1/1/2017,23799,22081,1718,7.2,159620,152152,7468,4.7
Acadia,2/1/2017,23856,22305,1551,6.5,159859,152480,7379,4.6
Acadia,3/1/2017,24088,22600,1488,6.2,160137,153065,7073,4.4
Acadia,4/1/2017,24086,22670,1416,5.9,160345,153255,7089,4.4
Acadia,5/1/2017,24139,22726,1413,5.9,160068,153069,7000,4.4
Acadia,6/1/2017,24521,22959,1562,6.4,160192,153318,6873,4.3
Acadia,7/1/2017,24546,23054,1492,6.1,160462,153569,6892,4.3
Acadia,8/1/2017,24131,22679,1452,6,160586,153503,7082,4.4
Acadia,9/1/2017,24013,22633,1380,5.7,161140,154286,6854,4.3
Acadia,10/1/2017,23681,22475,1206,5.1,160309,153609,6700,4.2
Acadia,11/1/2017,23650,22455,1195,5.1,160579,153805,6774,4.2
Acadia,12/1/2017,23517,22388,1129,4.8,160535,153904,6632,4.1
Acadia,1/1/2018,23481,22205,1276,5.4,160914,154425,6489,4
Acadia,2/1/2018,23657,22449,1208,5.1,161778,155197,6581,4.1
Acadia,3/1/2018,23942,22720,1222,5.1,161686,155214,6472,4
Acadia,4/1/2018,23944,22765,1179,4.9,161771,155312,6459,4
Acadia,5/1/2018,24020,22774,1246,5.2,161848,155652,6196,3.8
Acadia,6/1/2018,24349,22764,1585,6.5,162210,155762,6447,4
Acadia,7/1/2018,24394,22932,1462,6,162341,156146,6195,3.8
Acadia,8/1/2018,23819,22503,1316,5.5,161660,155504,6156,3.8
Acadia,9/1/2018,23699,22452,1247,5.3,162087,156015,6073,3.7
Acadia,10/1/2018,23909,22715,1194,5,162602,156391,6211,3.8
Acadia,11/1/2018,23787,22635,1152,4.8,162836,156721,6115,3.8
Acadia,12/1/2018,23681,22540,1141,4.8,163206,156817,6389,3.9
Acadia,1/1/2019,23493,22150,1343,5.7,162963,156487,6475,4
Acadia,2/1/2019,23613,22470,1143,4.8,162999,156863,6136,3.8
Acadia,3/1/2019,23689,22619,1070,4.5,162904,156701,6202,3.8
Acadia,4/1/2019,23636,22629,1007,4.3,162586,156625,5961,3.7
Acadia,5/1/2019,23825,22665,1160,4.9,162751,156821,5930,3.6
Acadia,6/1/2019,24121,22703,1418,5.9,163168,157232,5935,3.6
Acadia,7/1/2019,24151,22784,1367,5.7,163590,157529,6061,3.7
Acadia,8/1/2019,24043,22737,1306,5.4,163774,157829,5945,3.6
Acadia,9/1/2019,24094,22824,1270,5.3,164092,158339,5753,3.5
Acadia,10/1/2019,24084,22830,1254,5.2,164416,158545,5871,3.6
Acadia,11/1/2019,23864,22658,1206,5.1,164496,158629,5868,3.6
Acadia,12/1/2019,23639,22484,1155,4.9,164699,158845,5853,3.6
Acadia,1/1/2020,23368,22143,1225,5.2,164377,158508,5869,3.6
Acadia,2/1/2020,23340,22351,989,4.2,164467,158714,5753,3.5
Acadia,3/1/2020,23894,22147,1747,7.3,162559,155353,7206,4.4
Acadia,4/1/2020,21926,19741,2185,10,156269,133185,23084,14.8
Acadia,5/1/2020,22595,20261,2334,10.3,158101,137173,20929,13.2
Acadia,6/1/2020,23133,20842,2291,9.9,159994,142342,17652,11
Acadia,7/1/2020,23264,21029,2235,9.6,160132,143779,16352,10.2
Acadia,8/1/2020,23188,21320,1868,8.1,160706,147245,13461,8.4
Acadia,9/1/2020,23305,21407,1898,8.1,160174,147620,12554,7.8
Acadia,10/1/2020,23458,21777,1681,7.2,161003,149931,11072,6.9
Acadia,11/1/2020,23226,21724,1502,6.5,160629,149934,10694,6.7
Acadia,12/1/2020,23232,21722,1510,6.5,160745,149975,10770,6.7
Acadia,1/1/2021,23030,21493,1537,6.7,160088,149852,10236,6.4
Acadia,2/1/2021,23118,21682,1436,6.2,160184,150189,9995,6.2
Acadia,3/1/2021,23252,21880,1372,5.9,160400,150644,9756,6.1
Acadia,4/1/2021,23380,22087,1293,5.5,160843,151081,9762,6.1
Acadia,5/1/2021,23292,22006,1286,5.5,160800,151535,9266,5.8
Acadia,6/1/2021,23734,22223,1511,6.4,161197,151734,9462,5.9
Acadia,7/1/2021,23683,22383,1300,5.5,161504,152773,8731,5.4
Acadia,8/1/2021,23341,22185,1156,5,161527,153250,8276,5.1
Acadia,9/1/2021,23592,22566,1026,4.3,161495,153843,7652,4.7
Acadia,10/1/2021,23361,22448,913,3.9,161754,154475,7279,4.5
Acadia,11/1/2021,23376,22544,832,3.6,162281,155530,6751,4.2
Acadia,12/1/2021,23356,22618,738,3.2,162497,156099,6398,3.9
Acadia,1/1/2022,23368,22429,939,4,163627,157115,6512,4
Acadia,2/1/2022,23420,22590,830,3.5,163899,157598,6301,3.8
Acadia,3/1/2022,23633,22820,813,3.4,164220,158206,6014,3.7
Acadia,4/1/2022,23683,22931,752,3.2,163893,157891,6002,3.7
Acadia,5/1/2022,23596,22780,816,3.5,164362,158378,5983,3.6
Acadia,6/1/2022,23935,22849,1086,4.5,164046,158094,5951,3.6
Acadia,7/1/2022,24101,23096,1005,4.2,164026,158258,5768,3.5
Acadia,8/1/2022,23656,22739,917,3.9,164654,158735,5919,3.6
Acadia,9/1/2022,23656,22784,872,3.7,164602,158810,5792,3.5
Acadia,10/1/2022,23695,22889,806,3.4,164648,158684,5964,3.6
Acadia,11/1/2022,23627,22862,765,3.2,164450,158507,5943,3.6
Acadia,12/1/2022,23649,22859,790,3.3,165025,159259,5766,3.5
Acadia,1/1/2023,23497,22619,878,3.7,165964,160217,5747,3.5
Acadia,2/1/2023,23539,22694,845,3.6,166358,160395,5962,3.6
Acadia,3/1/2023,23689,22906,783,3.3,166651,160812,5839,3.5
Acadia,4/1/2023,23798,23095,703,3,166725,160974,5751,3.4
Acadia,5/1/2023,23755,22890,865,3.6,166886,160796,6089,3.6
Acadia,6/1/2023,24072,23049,1023,4.2,166937,160979,5958,3.6
Acadia,7/1/2023,24099,23241,858,3.6,167103,161183,5920,3.5
Acadia,8/1/2023,23827,22907,920,3.9,167759,161475,6284,3.7
Acadia,9/1/2023,23885,22895,990,4.1,167767,161442,6326,3.8
Acadia,10/1/2023,23883,22902,981,4.1,167690,161211,6479,3.9
Acadia,11/1/2023,23901,22974,927,3.9,168140,161886,6254,3.7
Acadia,12/1/2023,23762,22816,946,4,167439,161124,6315,3.8
Acadia,1/1/2024,23809,22769,1040,4.4,167339,161190,6149,3.7
Acadia,2/1/2024,23672,22639,1033,4.4,167475,161013,6462,3.9
Acadia,3/1/2024,23862,22858,1004,4.2,167922,161425,6497,3.9
Acadia,4/1/2024,24005,23089,916,3.8,167988,161495,6492,3.9
Acadia,5/1/2024,23783,22827,956,4,167799,161164,6635,4
Acadia,6/1/2024,24337,23092,1245,5.1,168005,161155,6849,4.1
Acadia,7/1/2024,24460,23287,1173,4.8,168315,161219,7097,4.2
Acadia,8/1/2024,24106,22949,1157,4.8,168496,161425,7071,4.2
Acadia,9/1/2024,24015,22869,1146,4.8,168703,161802,6901,4.1
Acadia,10/1/2024,24062,22936,1126,4.7,168428,161456,6972,4.1
Acadia,11/1/2024,23935,22851,1084,4.5,168304,161183,7121,4.2
Acadia,12/1/2024,23826,22823,1003,4.2,168547,161661,6886,4.1
Acadia,1/1/2025,23067,22127,940,4.1,170744,163895,6849,4
Acadia,2/1/2025,23168,22252,916,4,170359,163307,7052,4.1
Allen,1/1/1990,7163,6518,645,9,125833,119081,6752,5.4
Allen,2/1/1990,7179,6541,638,8.9,125710,119059,6651,5.3
Allen,3/1/1990,7260,6677,583,8,125801,119203,6598,5.2
Allen,4/1/1990,7436,6710,726,9.8,125649,118852,6797,5.4
Allen,5/1/1990,7252,6680,572,7.9,125893,119151,6742,5.4
Allen,6/1/1990,7396,6688,708,9.6,125573,118983,6590,5.2
Allen,7/1/1990,7568,6819,749,9.9,125732,118810,6922,5.5
Allen,8/1/1990,7582,6796,786,10.4,125990,118802,7188,5.7
Allen,9/1/1990,7606,6715,891,11.7,125892,118524,7368,5.9
Allen,10/1/1990,7534,6695,839,11.1,125995,118536,7459,5.9
Allen,11/1/1990,7749,6877,872,11.3,126070,118306,7764,6.2
Allen,12/1/1990,7935,7024,911,11.5,126142,118241,7901,6.3
Allen,1/1/1991,8027,6986,1041,13,125955,117940,8015,6.4
Allen,2/1/1991,8051,6579,1472,18.3,126020,117755,8265,6.6
Allen,3/1/1991,7993,6591,1402,17.5,126238,117652,8586,6.8
Allen,4/1/1991,7437,6520,917,12.3,126548,118109,8439,6.7
Allen,5/1/1991,7585,6680,905,11.9,126176,117440,8736,6.9
Allen,6/1/1991,7750,6755,995,12.8,126331,117639,8692,6.9
Allen,7/1/1991,8178,7212,966,11.8,126154,117568,8586,6.8
Allen,8/1/1991,7993,7102,891,11.1,126150,117484,8666,6.9
Allen,9/1/1991,7920,7049,871,11,126650,117928,8722,6.9
Allen,10/1/1991,7882,7074,808,10.3,126642,117800,8842,7
Allen,11/1/1991,7934,7150,784,9.9,126701,117770,8931,7
Allen,12/1/1991,7927,7120,807,10.2,126664,117466,9198,7.3
Allen,1/1/1992,8086,7140,946,11.7,127261,117978,9283,7.3
Allen,2/1/1992,7830,6997,833,10.6,127207,117753,9454,7.4
Allen,3/1/1992,7844,7046,798,10.2,127604,118144,9460,7.4
Allen,4/1/1992,7939,7149,790,10,127841,118426,9415,7.4
Allen,5/1/1992,8020,7139,881,11,128119,118375,9744,7.6
Allen,6/1/1992,8308,7160,1148,13.8,128459,118419,10040,7.8
Allen,7/1/1992,8706,7681,1025,11.8,128563,118713,9850,7.7
Allen,8/1/1992,8521,7612,909,10.7,128613,118826,9787,7.6
Allen,9/1/1992,8420,7577,843,10,128501,118720,9781,7.6
Allen,10/1/1992,8126,7321,805,9.9,128026,118628,9398,7.3
Allen,11/1/1992,8065,7297,768,9.5,128441,118876,9565,7.4
Allen,12/1/1992,8080,7238,842,10.4,128554,118997,9557,7.4
Allen,1/1/1993,8400,7392,1008,12,128400,119075,9325,7.3
Allen,2/1/1993,8286,7371,915,11,128458,119275,9183,7.1
Allen,3/1/1993,8331,7451,880,10.6,128598,119542,9056,7
Allen,4/1/1993,8342,7432,910,10.9,128584,119474,9110,7.1
Allen,5/1/1993,8311,7517,794,9.6,129264,120115,9149,7.1
Allen,6/1/1993,8670,7641,1029,11.9,129411,120290,9121,7
Allen,7/1/1993,8506,7656,850,10,129397,120467,8930,6.9
Allen,8/1/1993,8592,7758,834,9.7,129619,120856,8763,6.8
Allen,9/1/1993,8418,7688,730,8.7,129268,120554,8714,6.7
Allen,10/1/1993,8366,7575,791,9.5,129573,120823,8750,6.8
Allen,11/1/1993,8331,7557,774,9.3,129711,121169,8542,6.6
Allen,12/1/1993,8280,7523,757,9.1,129941,121464,8477,6.5
Allen,1/1/1994,8380,7337,1043,12.4,130596,121966,8630,6.6
Allen,2/1/1994,8271,7397,874,10.6,130669,122086,8583,6.6
Allen,3/1/1994,8283,7403,880,10.6,130400,121930,8470,6.5
Allen,4/1/1994,8254,7391,863,10.5,130621,122290,8331,6.4
Allen,5/1/1994,8294,7464,830,10,130779,122864,7915,6.1
Allen,6/1/1994,8332,7427,905,10.9,130561,122634,7927,6.1
Allen,7/1/1994,8434,7561,873,10.4,130652,122706,7946,6.1
Allen,8/1/1994,8412,7562,850,10.1,131275,123342,7933,6
Allen,9/1/1994,8350,7540,810,9.7,131421,123687,7734,5.9
Allen,10/1/1994,8383,7580,803,9.6,131744,124112,7632,5.8
Allen,11/1/1994,8509,7717,792,9.3,131891,124516,7375,5.6
Allen,12/1/1994,8549,7752,797,9.3,131951,124721,7230,5.5
Allen,1/1/1995,7391,6472,919,12.4,132038,124663,7375,5.6
Allen,2/1/1995,8613,7775,838,9.7,132115,124928,7187,5.4
Allen,3/1/1995,8577,7747,830,9.7,132108,124955,7153,5.4
Allen,4/1/1995,8468,7579,889,10.5,132590,124945,7645,5.8
Allen,5/1/1995,8349,7587,762,9.1,131851,124421,7430,5.6
Allen,6/1/1995,8648,7777,871,10.1,131949,124522,7427,5.6
Allen,7/1/1995,8857,8077,780,8.8,132343,124816,7527,5.7
Allen,8/1/1995,8842,8107,735,8.3,132336,124852,7484,5.7
Allen,9/1/1995,8944,8227,717,8,132611,125133,7478,5.6
Allen,10/1/1995,8759,8103,656,7.5,132716,125388,7328,5.5
Allen,11/1/1995,8719,8098,621,7.1,132614,125188,7426,5.6
Allen,12/1/1995,8664,8046,618,7.1,132511,125088,7423,5.6
Allen,1/1/1996,8666,7859,807,9.3,132616,125125,7491,5.6
Allen,2/1/1996,8644,7995,649,7.5,132952,125639,7313,5.5
Allen,3/1/1996,8685,8015,670,7.7,133180,125862,7318,5.5
Allen,4/1/1996,8544,7867,677,7.9,133409,125994,7415,5.6
Allen,5/1/1996,8532,7852,680,8,133667,126244,7423,5.6
Allen,6/1/1996,8782,8029,753,8.6,133697,126602,7095,5.3
Allen,7/1/1996,8714,8006,708,8.1,134284,126947,7337,5.5
Allen,8/1/1996,8641,8040,601,7,134054,127172,6882,5.1
Allen,9/1/1996,8884,8263,621,7,134515,127536,6979,5.2
Allen,10/1/1996,8697,8077,620,7.1,134921,127890,7031,5.2
Allen,11/1/1996,8762,8221,541,6.2,135007,127771,7236,5.4
Allen,12/1/1996,8870,8256,614,6.9,135113,127860,7253,5.4
Allen,1/1/1997,8563,7812,751,8.8,135456,128298,7158,5.3
Allen,2/1/1997,8476,7874,602,7.1,135400,128298,7102,5.2
Allen,3/1/1997,8542,7872,670,7.8,135891,128891,7000,5.2
Allen,4/1/1997,8599,8007,592,6.9,136016,129143,6873,5.1
Allen,5/1/1997,8800,8208,592,6.7,136119,129464,6655,4.9
Allen,6/1/1997,8997,8243,754,8.4,136211,129412,6799,5
Allen,7/1/1997,9071,8415,656,7.2,136477,129822,6655,4.9
Allen,8/1/1997,9051,8399,652,7.2,136618,130010,6608,4.8
Allen,9/1/1997,8957,8365,592,6.6,136675,130019,6656,4.9
Allen,10/1/1997,8861,8325,536,6,136633,130179,6454,4.7
Allen,11/1/1997,8797,8275,522,5.9,136961,130653,6308,4.6
Allen,12/1/1997,8673,8184,489,5.6,137155,130679,6476,4.7
Allen,1/1/1998,8687,8047,640,7.4,137095,130726,6368,4.6
Allen,2/1/1998,8487,7966,521,6.1,137112,130807,6306,4.6
Allen,3/1/1998,8665,8068,597,6.9,137236,130814,6422,4.7
Allen,4/1/1998,8657,8079,578,6.7,137150,131209,5941,4.3
Allen,5/1/1998,8644,8174,470,5.4,137372,131325,6047,4.4
Allen,6/1/1998,8976,8361,615,6.9,137455,131244,6212,4.5
Allen,7/1/1998,9251,8685,566,6.1,137588,131329,6259,4.5
Allen,8/1/1998,9200,8620,580,6.3,137570,131390,6179,4.5
Allen,9/1/1998,9101,8502,599,6.6,138286,131986,6300,4.6
Allen,10/1/1998,9319,8654,665,7.1,138279,131999,6280,4.5
Allen,11/1/1998,9268,8626,642,6.9,138381,132280,6100,4.4
Allen,12/1/1998,9235,8603,632,6.8,138634,132602,6032,4.4
Allen,1/1/1999,9646,8842,804,8.3,139003,133027,5976,4.3
Allen,2/1/1999,9476,8840,636,6.7,138967,132856,6111,4.4
Allen,3/1/1999,9492,8891,601,6.3,138730,132947,5783,4.2
Allen,4/1/1999,9619,9015,604,6.3,138959,132955,6004,4.3
Allen,5/1/1999,9577,9002,575,6,139107,133311,5796,4.2
Allen,6/1/1999,9942,9191,751,7.6,139329,133378,5951,4.3
Allen,7/1/1999,9732,9098,634,6.5,139439,133414,6025,4.3
Allen,8/1/1999,9769,9146,623,6.4,139430,133591,5838,4.2
Allen,9/1/1999,9646,9058,588,6.1,139622,133707,5915,4.2
Allen,10/1/1999,9781,9256,525,5.4,139771,133993,5778,4.1
Allen,11/1/1999,9654,9227,427,4.4,140025,134309,5716,4.1
Allen,12/1/1999,9644,9220,424,4.4,140177,134523,5653,4
Allen,1/1/2000,8923,8349,574,6.4,142267,136559,5708,4
Allen,2/1/2000,8840,8328,512,5.8,142456,136598,5858,4.1
Allen,3/1/2000,8904,8348,556,6.2,142434,136701,5733,4
Allen,4/1/2000,8778,8273,505,5.8,142751,137270,5481,3.8
Allen,5/1/2000,8545,7985,560,6.6,142388,136630,5758,4
Allen,6/1/2000,8677,8027,650,7.5,142591,136940,5651,4
Allen,7/1/2000,8619,8040,579,6.7,142278,136531,5747,4
Allen,8/1/2000,8556,7949,607,7.1,142514,136662,5853,4.1
Allen,9/1/2000,8474,7874,600,7.1,142518,136893,5625,3.9
Allen,10/1/2000,8667,8113,554,6.4,142622,137088,5534,3.9
Allen,11/1/2000,8611,8048,563,6.5,142962,137322,5639,3.9
Allen,12/1/2000,8604,8054,550,6.4,143248,137614,5634,3.9
Allen,1/1/2001,8697,8007,690,7.9,143800,137778,6023,4.2
Allen,2/1/2001,8659,8038,621,7.2,143701,137612,6089,4.2
Allen,3/1/2001,8774,8127,647,7.4,143924,137783,6141,4.3
Allen,4/1/2001,8589,7977,612,7.1,143569,137299,6271,4.4
Allen,5/1/2001,8469,7883,586,6.9,143318,137092,6226,4.3
Allen,6/1/2001,8644,7968,676,7.8,143357,136873,6484,4.5
Allen,7/1/2001,8665,8059,606,7,143654,137071,6583,4.6
Allen,8/1/2001,8484,7883,601,7.1,143284,136241,7042,4.9
Allen,9/1/2001,8560,7935,625,7.3,143989,136846,7142,5
Allen,10/1/2001,8627,8020,607,7,144086,136392,7694,5.3
Allen,11/1/2001,8674,8035,639,7.4,144240,136238,8003,5.5
Allen,12/1/2001,8668,8011,657,7.6,144305,136047,8258,5.7
Allen,1/1/2002,8695,7934,761,8.8,143883,135701,8182,5.7
Allen,2/1/2002,8601,7964,637,7.4,144653,136438,8215,5.7
Allen,3/1/2002,8639,7972,667,7.7,144481,136177,8304,5.7
Allen,4/1/2002,8563,7909,654,7.6,144725,136126,8599,5.9
Allen,5/1/2002,8537,7848,689,8.1,144938,136539,8399,5.8
Allen,6/1/2002,8984,8199,785,8.7,144808,136415,8393,5.8
Allen,7/1/2002,8778,8075,703,8,144803,136413,8390,5.8
Allen,8/1/2002,8806,8105,701,8,145009,136705,8304,5.7
Allen,9/1/2002,8726,8054,672,7.7,145552,137302,8251,5.7
Allen,10/1/2002,8822,8175,647,7.3,145314,137008,8307,5.7
Allen,11/1/2002,8903,8224,679,7.6,145041,136521,8520,5.9
Allen,12/1/2002,8915,8223,692,7.8,145066,136426,8640,6
Allen,1/1/2003,9189,8387,802,8.7,145937,137417,8520,5.8
Allen,2/1/2003,9111,8336,775,8.5,146100,137482,8618,5.9
Allen,3/1/2003,9082,8284,798,8.8,146022,137434,8588,5.9
Allen,4/1/2003,8998,8241,757,8.4,146474,137633,8842,6
Allen,5/1/2003,8947,8173,774,8.7,146500,137544,8957,6.1
Allen,6/1/2003,9222,8261,961,10.4,147056,137790,9266,6.3
Allen,7/1/2003,9069,8209,860,9.5,146485,137474,9011,6.2
Allen,8/1/2003,9074,8296,778,8.6,146445,137549,8896,6.1
Allen,9/1/2003,8922,8183,739,8.3,146530,137609,8921,6.1
Allen,10/1/2003,8979,8307,672,7.5,146716,137984,8732,6
Allen,11/1/2003,8909,8265,644,7.2,147000,138424,8576,5.8
Allen,12/1/2003,8778,8143,635,7.2,146729,138411,8317,5.7
Allen,1/1/2004,8854,8048,806,9.1,146842,138472,8370,5.7
Allen,2/1/2004,8788,8069,719,8.2,146709,138542,8167,5.6
Allen,3/1/2004,8812,8080,732,8.3,146944,138453,8491,5.8
Allen,4/1/2004,8784,8038,746,8.5,146850,138680,8170,5.6
Allen,5/1/2004,8669,7976,693,8,147065,138852,8212,5.6
Allen,6/1/2004,8796,7973,823,9.4,147460,139174,8286,5.6
Allen,7/1/2004,8778,8049,729,8.3,147692,139556,8136,5.5
Allen,8/1/2004,8768,8115,653,7.4,147564,139573,7990,5.4
Allen,9/1/2004,8663,8022,641,7.4,147415,139487,7927,5.4
Allen,10/1/2004,8712,8077,635,7.3,147793,139732,8061,5.5
Allen,11/1/2004,8692,8054,638,7.3,148162,140231,7932,5.4
Allen,12/1/2004,8538,7925,613,7.2,148059,140125,7934,5.4
Allen,1/1/2005,8598,7876,722,8.4,148029,140245,7784,5.3
Allen,2/1/2005,8382,7719,663,7.9,148364,140385,7980,5.4
Allen,3/1/2005,8345,7732,613,7.3,148391,140654,7737,5.2
Allen,4/1/2005,8339,7755,584,7,148926,141254,7672,5.2
Allen,5/1/2005,8319,7714,605,7.3,149261,141609,7651,5.1
Allen,6/1/2005,8704,7947,757,8.7,149238,141714,7524,5
Allen,7/1/2005,8494,7805,689,8.1,149432,142026,7406,5
Allen,8/1/2005,8270,7670,600,7.3,149779,142434,7345,4.9
Allen,9/1/2005,9273,8198,1075,11.6,149954,142401,7553,5
Allen,10/1/2005,10077,8372,1705,16.9,150001,142548,7453,5
Allen,11/1/2005,9824,8167,1657,16.9,150065,142499,7566,5
Allen,12/1/2005,8634,8085,549,6.4,150030,142752,7279,4.9
Allen,1/1/2006,8633,8158,475,5.5,150214,143150,7064,4.7
Allen,2/1/2006,8563,8198,365,4.3,150641,143457,7184,4.8
Allen,3/1/2006,8696,8332,364,4.2,150813,143741,7072,4.7
Allen,4/1/2006,8760,8412,348,4,150881,143761,7120,4.7
Allen,5/1/2006,8729,8326,403,4.6,151069,144089,6980,4.6
Allen,6/1/2006,8903,8366,537,6,151354,144353,7001,4.6
Allen,7/1/2006,8930,8466,464,5.2,151377,144202,7175,4.7
Allen,8/1/2006,8927,8463,464,5.2,151716,144625,7091,4.7
Allen,9/1/2006,8792,8347,445,5.1,151662,144815,6847,4.5
Allen,10/1/2006,8954,8527,427,4.8,152041,145314,6727,4.4
Allen,11/1/2006,8986,8553,433,4.8,152406,145534,6872,4.5
Allen,12/1/2006,8805,8388,417,4.7,152732,145970,6762,4.4
Allen,1/1/2007,8875,8366,509,5.7,153144,146028,7116,4.6
Allen,2/1/2007,8889,8442,447,5,152983,146057,6927,4.5
Allen,3/1/2007,8846,8401,445,5,153051,146320,6731,4.4
Allen,4/1/2007,8771,8285,486,5.5,152435,145586,6850,4.5
Allen,5/1/2007,8717,8234,483,5.5,152670,145903,6766,4.4
Allen,6/1/2007,8823,8201,622,7,153041,146063,6979,4.6
Allen,7/1/2007,8875,8306,569,6.4,153054,145905,7149,4.7
Allen,8/1/2007,8792,8288,504,5.7,152749,145682,7067,4.6
Allen,9/1/2007,8904,8429,475,5.3,153414,146244,7170,4.7
Allen,10/1/2007,9015,8628,387,4.3,153183,145946,7237,4.7
Allen,11/1/2007,8810,8398,412,4.7,153835,146595,7240,4.7
Allen,12/1/2007,8702,8248,454,5.2,153918,146273,7645,5
Allen,1/1/2008,8700,8177,523,6,154063,146378,7685,5
Allen,2/1/2008,8599,8168,431,5,153653,146156,7497,4.9
Allen,3/1/2008,8731,8263,468,5.4,153908,146086,7822,5.1
Allen,4/1/2008,8790,8376,414,4.7,153769,146132,7637,5
Allen,5/1/2008,8819,8349,470,5.3,154303,145908,8395,5.4
Allen,6/1/2008,8904,8279,625,7,154313,145737,8575,5.6
Allen,7/1/2008,9076,8482,594,6.5,154469,145532,8937,5.8
Allen,8/1/2008,8912,8339,573,6.4,154641,145203,9438,6.1
Allen,9/1/2008,8860,8325,535,6,154570,145076,9494,6.1
Allen,10/1/2008,8972,8439,533,5.9,154876,144802,10074,6.5
Allen,11/1/2008,8903,8369,534,6,154639,144100,10538,6.8
Allen,12/1/2008,8712,8142,570,6.5,154655,143369,11286,7.3
Allen,1/1/2009,8778,8101,677,7.7,154210,142152,12058,7.8
Allen,2/1/2009,8767,8087,680,7.8,154538,141640,12898,8.3
Allen,3/1/2009,8807,7882,925,10.5,154133,140707,13426,8.7
Allen,4/1/2009,9013,8115,898,10,154509,140656,13853,9
Allen,5/1/2009,9064,8270,794,8.8,154747,140248,14499,9.4
Allen,6/1/2009,9433,8466,967,10.3,154716,140009,14707,9.5
Allen,7/1/2009,9542,8602,940,9.9,154502,139901,14601,9.5
Allen,8/1/2009,9443,8589,854,9,154307,139492,14814,9.6
Allen,9/1/2009,9254,8433,821,8.9,153827,138818,15009,9.8
Allen,10/1/2009,9298,8505,793,8.5,153784,138432,15352,10
Allen,11/1/2009,9314,8498,816,8.8,153878,138659,15219,9.9
Allen,12/1/2009,9181,8231,950,10.3,153111,138013,15098,9.9
Allen,1/1/2010,9466,8478,988,10.4,153484,138438,15046,9.8
Allen,2/1/2010,9272,8369,903,9.7,153694,138581,15113,9.8
Allen,3/1/2010,9391,8434,957,10.2,153954,138751,15202,9.9
Allen,4/1/2010,9407,8559,848,9,154622,139297,15325,9.9
Allen,5/1/2010,9363,8508,855,9.1,154091,139241,14849,9.6
Allen,6/1/2010,9458,8487,971,10.3,153616,139141,14474,9.4
Allen,7/1/2010,9628,8748,880,9.1,153691,139179,14512,9.4
Allen,8/1/2010,9482,8635,847,8.9,154086,139438,14648,9.5
Allen,9/1/2010,9386,8572,814,8.7,153975,139396,14579,9.5
Allen,10/1/2010,9414,8638,776,8.2,153635,139119,14516,9.4
Allen,11/1/2010,9350,8560,790,8.4,154125,139044,15081,9.8
Allen,12/1/2010,9223,8444,779,8.4,153650,139301,14348,9.3
Allen,1/1/2011,9346,8375,971,10.4,153263,139250,14013,9.1
Allen,2/1/2011,9266,8462,804,8.7,153214,139394,13820,9
Allen,3/1/2011,9144,8357,787,8.6,153376,139639,13737,9
Allen,4/1/2011,9276,8552,724,7.8,153543,139586,13957,9.1
Allen,5/1/2011,9276,8504,772,8.3,153479,139624,13855,9
Allen,6/1/2011,9349,8466,883,9.4,153346,139384,13962,9.1
Allen,7/1/2011,9386,8549,837,8.9,153288,139524,13763,9
Allen,8/1/2011,9255,8451,804,8.7,153760,139942,13818,9
Allen,9/1/2011,9101,8336,765,8.4,154131,140183,13948,9
Allen,10/1/2011,9261,8506,755,8.2,153961,140368,13594,8.8
Allen,11/1/2011,9254,8529,725,7.8,154128,140826,13302,8.6
Allen,12/1/2011,9167,8454,713,7.8,153995,140902,13093,8.5
Allen,1/1/2012,8982,8170,812,9,154381,141584,12797,8.3
Allen,2/1/2012,8924,8185,739,8.3,154671,141858,12813,8.3
Allen,3/1/2012,8947,8242,705,7.9,154749,142036,12713,8.2
Allen,4/1/2012,9107,8454,653,7.2,154545,141899,12646,8.2
Allen,5/1/2012,9133,8441,692,7.6,154866,142206,12660,8.2
Allen,6/1/2012,9254,8429,825,8.9,155083,142391,12692,8.2
Allen,7/1/2012,9429,8646,783,8.3,154948,142292,12656,8.2
Allen,8/1/2012,9243,8541,702,7.6,154763,142291,12471,8.1
Allen,9/1/2012,9171,8547,624,6.8,155160,143044,12115,7.8
Allen,10/1/2012,9261,8660,601,6.5,155554,143431,12124,7.8
Allen,11/1/2012,9166,8607,559,6.1,155338,143333,12005,7.7
Allen,12/1/2012,9139,8520,619,6.8,155628,143330,12298,7.9
Allen,1/1/2013,8754,8034,720,8.2,155763,143292,12471,8
Allen,2/1/2013,8731,8089,642,7.4,155312,143362,11950,7.7
Allen,3/1/2013,8673,8050,623,7.2,155005,143316,11689,7.5
Allen,4/1/2013,8736,8110,626,7.2,155394,143635,11760,7.6
Allen,5/1/2013,8746,8102,644,7.4,155536,143882,11654,7.5
Allen,6/1/2013,8827,8043,784,8.9,155749,143999,11751,7.5
Allen,7/1/2013,8741,8023,718,8.2,155599,144264,11335,7.3
Allen,8/1/2013,8714,8070,644,7.4,155605,144326,11279,7.2
Allen,9/1/2013,8773,8188,585,6.7,155687,144418,11270,7.2
Allen,10/1/2013,8798,8229,569,6.5,154673,143537,11136,7.2
Allen,11/1/2013,8774,8267,507,5.8,155265,144479,10787,6.9
Allen,12/1/2013,8651,8161,490,5.7,155182,144778,10404,6.7
Allen,1/1/2014,8743,8179,564,6.5,155352,145150,10202,6.6
Allen,2/1/2014,8742,8228,514,5.9,155483,145134,10349,6.7
Allen,3/1/2014,8731,8184,547,6.3,156028,145648,10380,6.7
Allen,4/1/2014,8769,8272,497,5.7,155369,145667,9702,6.2
Allen,5/1/2014,8840,8275,565,6.4,155684,145825,9859,6.3
Allen,6/1/2014,9008,8315,693,7.7,155707,146247,9460,6.1
Allen,7/1/2014,8777,8043,734,8.4,156007,146399,9608,6.2
Allen,8/1/2014,8838,8129,709,8,156130,146530,9599,6.1
Allen,9/1/2014,9002,8336,666,7.4,156040,146778,9262,5.9
Allen,10/1/2014,8965,8303,662,7.4,156417,147427,8990,5.7
Allen,11/1/2014,8912,8238,674,7.6,156494,147404,9090,5.8
Allen,12/1/2014,8874,8220,654,7.4,156332,147615,8717,5.6
Allen,1/1/2015,8892,8172,720,8.1,157030,148145,8885,5.7
Allen,2/1/2015,8796,8153,643,7.3,156644,148045,8599,5.5
Allen,3/1/2015,8817,8204,613,7,156643,148128,8515,5.4
Allen,4/1/2015,8875,8279,596,6.7,157060,148511,8550,5.4
Allen,5/1/2015,8854,8246,608,6.9,157651,148817,8834,5.6
Allen,6/1/2015,8971,8291,680,7.6,157062,148816,8247,5.3
Allen,7/1/2015,8648,7981,667,7.7,156997,148830,8167,5.2
Allen,8/1/2015,8566,7991,575,6.7,157172,149181,7992,5.1
Allen,9/1/2015,8707,8151,556,6.4,156733,148826,7907,5
Allen,10/1/2015,8786,8247,539,6.1,157167,149246,7922,5
Allen,11/1/2015,8769,8240,529,6,157463,149463,8000,5.1
Allen,12/1/2015,8664,8140,524,6,158035,150128,7907,5
Allen,1/1/2016,8842,8259,583,6.6,158280,150653,7627,4.8
Allen,2/1/2016,8853,8312,541,6.1,158640,150939,7702,4.9
Allen,3/1/2016,8863,8311,552,6.2,159179,151218,7961,5
Allen,4/1/2016,8940,8415,525,5.9,159141,151074,8067,5.1
Allen,5/1/2016,8961,8426,535,6,158784,151132,7652,4.8
Allen,6/1/2016,9127,8468,659,7.2,158967,151223,7744,4.9
Allen,7/1/2016,8842,8203,639,7.2,159194,151554,7641,4.8
Allen,8/1/2016,8757,8149,608,6.9,159562,151779,7784,4.9
Allen,9/1/2016,8988,8385,603,6.7,159714,151761,7953,5
Allen,10/1/2016,8942,8392,550,6.2,159605,151793,7811,4.9
Allen,11/1/2016,8906,8394,512,5.7,159506,151954,7553,4.7
Allen,12/1/2016,8733,8213,520,6,159678,152157,7521,4.7
Allen,1/1/2017,8954,8398,556,6.2,159620,152152,7468,4.7
Allen,2/1/2017,8872,8402,470,5.3,159859,152480,7379,4.6
Allen,3/1/2017,8938,8490,448,5,160137,153065,7073,4.4
Allen,4/1/2017,9034,8599,435,4.8,160345,153255,7089,4.4
Allen,5/1/2017,9058,8614,444,4.9,160068,153069,7000,4.4
Allen,6/1/2017,9184,8654,530,5.8,160192,153318,6873,4.3
Allen,7/1/2017,8929,8408,521,5.8,160462,153569,6892,4.3
Allen,8/1/2017,8892,8401,491,5.5,160586,153503,7082,4.4
Allen,9/1/2017,9012,8550,462,5.1,161140,154286,6854,4.3
Allen,10/1/2017,8942,8526,416,4.7,160309,153609,6700,4.2
Allen,11/1/2017,8958,8522,436,4.9,160579,153805,6774,4.2
Allen,12/1/2017,8792,8341,451,5.1,160535,153904,6632,4.1
Allen,1/1/2018,8862,8334,528,6,160914,154425,6489,4
Allen,2/1/2018,8827,8355,472,5.3,161778,155197,6581,4.1
Allen,3/1/2018,8802,8330,472,5.4,161686,155214,6472,4
Allen,4/1/2018,8849,8368,481,5.4,161771,155312,6459,4
Allen,5/1/2018,8824,8351,473,5.4,161848,155652,6196,3.8
Allen,6/1/2018,8918,8316,602,6.8,162210,155762,6447,4
Allen,7/1/2018,8603,8028,575,6.7,162341,156146,6195,3.8
Allen,8/1/2018,8587,8089,498,5.8,161660,155504,6156,3.8
Allen,9/1/2018,8673,8213,460,5.3,162087,156015,6073,3.7
Allen,10/1/2018,8809,8367,442,5,162602,156391,6211,3.8
Allen,11/1/2018,8751,8315,436,5,162836,156721,6115,3.8
Allen,12/1/2018,8596,8141,455,5.3,163206,156817,6389,3.9
Allen,1/1/2019,8793,8244,549,6.2,162963,156487,6475,4
Allen,2/1/2019,8731,8308,423,4.8,162999,156863,6136,3.8
Allen,3/1/2019,8688,8280,408,4.7,162904,156701,6202,3.8
Allen,4/1/2019,8751,8375,376,4.3,162586,156625,5961,3.7
Allen,5/1/2019,8835,8393,442,5,162751,156821,5930,3.6
Allen,6/1/2019,9000,8436,564,6.3,163168,157232,5935,3.6
Allen,7/1/2019,8634,8088,546,6.3,163590,157529,6061,3.7
Allen,8/1/2019,8682,8200,482,5.6,163774,157829,5945,3.6
Allen,9/1/2019,8951,8481,470,5.3,164092,158339,5753,3.5
Allen,10/1/2019,8902,8439,463,5.2,164416,158545,5871,3.6
Allen,11/1/2019,8800,8321,479,5.4,164496,158629,5868,3.6
Allen,12/1/2019,8719,8198,521,6,164699,158845,5853,3.6
Allen,1/1/2020,8750,8215,535,6.1,164377,158508,5869,3.6
Allen,2/1/2020,8694,8245,449,5.2,164467,158714,5753,3.5
Allen,3/1/2020,8910,8192,718,8.1,162559,155353,7206,4.4
Allen,4/1/2020,8710,7554,1156,13.3,156269,133185,23084,14.8
Allen,5/1/2020,8098,6893,1205,14.9,158101,137173,20929,13.2
Allen,6/1/2020,8329,7278,1051,12.6,159994,142342,17652,11
Allen,7/1/2020,8010,7028,982,12.3,160132,143779,16352,10.2
Allen,8/1/2020,8034,7244,790,9.8,160706,147245,13461,8.4
Allen,9/1/2020,8233,7350,883,10.7,160174,147620,12554,7.8
Allen,10/1/2020,8158,7476,682,8.4,161003,149931,11072,6.9
Allen,11/1/2020,8115,7515,600,7.4,160629,149934,10694,6.7
Allen,12/1/2020,7993,7395,598,7.5,160745,149975,10770,6.7
Allen,1/1/2021,8011,7425,586,7.3,160088,149852,10236,6.4
Allen,2/1/2021,8073,7530,543,6.7,160184,150189,9995,6.2
Allen,3/1/2021,8054,7535,519,6.4,160400,150644,9756,6.1
Allen,4/1/2021,8146,7618,528,6.5,160843,151081,9762,6.1
Allen,5/1/2021,8120,7618,502,6.2,160800,151535,9266,5.8
Allen,6/1/2021,8267,7680,587,7.1,161197,151734,9462,5.9
Allen,7/1/2021,7883,7372,511,6.5,161504,152773,8731,5.4
Allen,8/1/2021,7861,7429,432,5.5,161527,153250,8276,5.1
Allen,9/1/2021,8215,7838,377,4.6,161495,153843,7652,4.7
Allen,10/1/2021,8037,7699,338,4.2,161754,154475,7279,4.5
Allen,11/1/2021,7949,7643,306,3.8,162281,155530,6751,4.2
Allen,12/1/2021,7834,7552,282,3.6,162497,156099,6398,3.9
Allen,1/1/2022,8078,7713,365,4.5,163627,157115,6512,4
Allen,2/1/2022,8001,7680,321,4,163899,157598,6301,3.8
Allen,3/1/2022,7990,7673,317,4,164220,158206,6014,3.7
Allen,4/1/2022,8140,7847,293,3.6,163893,157891,6002,3.7
Allen,5/1/2022,8125,7804,321,4,164362,158378,5983,3.6
Allen,6/1/2022,8288,7844,444,5.4,164046,158094,5951,3.6
Allen,7/1/2022,8034,7631,403,5,164026,158258,5768,3.5
Allen,8/1/2022,7956,7602,354,4.4,164654,158735,5919,3.6
Allen,9/1/2022,8191,7875,316,3.9,164602,158810,5792,3.5
Allen,10/1/2022,8162,7878,284,3.5,164648,158684,5964,3.6
Allen,11/1/2022,8104,7800,304,3.8,164450,158507,5943,3.6
Allen,12/1/2022,8131,7822,309,3.8,165025,159259,5766,3.5
Allen,1/1/2023,8169,7806,363,4.4,165964,160217,5747,3.5
Allen,2/1/2023,8104,7787,317,3.9,166358,160395,5962,3.6
Allen,3/1/2023,8153,7856,297,3.6,166651,160812,5839,3.5
Allen,4/1/2023,8182,7902,280,3.4,166725,160974,5751,3.4
Allen,5/1/2023,8156,7827,329,4,166886,160796,6089,3.6
Allen,6/1/2023,8305,7892,413,5,166937,160979,5958,3.6
Allen,7/1/2023,7848,7497,351,4.5,167103,161183,5920,3.5
Allen,8/1/2023,7901,7543,358,4.5,167759,161475,6284,3.7
Allen,9/1/2023,8199,7844,355,4.3,167767,161442,6326,3.8
Allen,10/1/2023,8206,7843,363,4.4,167690,161211,6479,3.9
Allen,11/1/2023,8194,7840,354,4.3,168140,161886,6254,3.7
Allen,12/1/2023,8087,7733,354,4.4,167439,161124,6315,3.8
Allen,1/1/2024,8205,7791,414,5,167339,161190,6149,3.7
Allen,2/1/2024,8106,7738,368,4.5,167475,161013,6462,3.9
Allen,3/1/2024,8201,7850,351,4.3,167922,161425,6497,3.9
Allen,4/1/2024,8314,7956,358,4.3,167988,161495,6492,3.9
Allen,5/1/2024,8238,7878,360,4.4,167799,161164,6635,4
Allen,6/1/2024,8466,7996,470,5.6,168005,161155,6849,4.1
Allen,7/1/2024,8177,7693,484,5.9,168315,161219,7097,4.2
Allen,8/1/2024,8155,7718,437,5.4,168496,161425,7071,4.2
Allen,9/1/2024,8285,7872,413,5,168703,161802,6901,4.1
Allen,10/1/2024,8257,7843,414,5,168428,161456,6972,4.1
Allen,11/1/2024,8139,7749,390,4.8,168304,161183,7121,4.2
Allen,12/1/2024,8133,7730,403,5,168547,161661,6886,4.1
Allen,1/1/2025,7837,7463,374,4.8,170744,163895,6849,4
Allen,2/1/2025,7873,7518,355,4.5,170359,163307,7052,4.1
Ascension,1/1/1990,26294,24539,1755,6.7,125833,119081,6752,5.4
Ascension,2/1/1990,26484,24916,1568,5.9,125710,119059,6651,5.3
Ascension,3/1/1990,26644,25108,1536,5.8,125801,119203,6598,5.2
Ascension,4/1/1990,26740,25106,1634,6.1,125649,118852,6797,5.4
Ascension,5/1/1990,26683,25061,1622,6.1,125893,119151,6742,5.4
Ascension,6/1/1990,27469,25336,2133,7.8,125573,118983,6590,5.2
Ascension,7/1/1990,27395,25564,1831,6.7,125732,118810,6922,5.5
Ascension,8/1/1990,26963,25113,1850,6.9,125990,118802,7188,5.7
Ascension,9/1/1990,27101,25081,2020,7.5,125892,118524,7368,5.9
Ascension,10/1/1990,27174,25391,1783,6.6,125995,118536,7459,5.9
Ascension,11/1/1990,27227,25541,1686,6.2,126070,118306,7764,6.2
Ascension,12/1/1990,27214,25465,1749,6.4,126142,118241,7901,6.3
Ascension,1/1/1991,27006,24871,2135,7.9,125955,117940,8015,6.4
Ascension,2/1/1991,27169,25271,1898,7,126020,117755,8265,6.6
Ascension,3/1/1991,27174,25484,1690,6.2,126238,117652,8586,6.8
Ascension,4/1/1991,27470,25711,1759,6.4,126548,118109,8439,6.7
Ascension,5/1/1991,27289,25335,1954,7.2,126176,117440,8736,6.9
Ascension,6/1/1991,28135,25789,2346,8.3,126331,117639,8692,6.9
Ascension,7/1/1991,28467,26184,2283,8,126154,117568,8586,6.8
Ascension,8/1/1991,27809,25632,2177,7.8,126150,117484,8666,6.9
Ascension,9/1/1991,27975,25987,1988,7.1,126650,117928,8722,6.9
Ascension,10/1/1991,27590,25944,1646,6,126642,117800,8842,7
Ascension,11/1/1991,27632,25999,1633,5.9,126701,117770,8931,7
Ascension,12/1/1991,27465,25873,1592,5.8,126664,117466,9198,7.3
Ascension,1/1/1992,27570,25509,2061,7.5,127261,117978,9283,7.3
Ascension,2/1/1992,27638,25980,1658,6,127207,117753,9454,7.4
Ascension,3/1/1992,27943,26222,1721,6.2,127604,118144,9460,7.4
Ascension,4/1/1992,27973,26336,1637,5.9,127841,118426,9415,7.4
Ascension,5/1/1992,27743,26155,1588,5.7,128119,118375,9744,7.6
Ascension,6/1/1992,28709,26637,2072,7.2,128459,118419,10040,7.8
Ascension,7/1/1992,29747,27751,1996,6.7,128563,118713,9850,7.7
Ascension,8/1/1992,29358,27341,2017,6.9,128613,118826,9787,7.6
Ascension,9/1/1992,29134,27118,2016,6.9,128501,118720,9781,7.6
Ascension,10/1/1992,28756,27103,1653,5.7,128026,118628,9398,7.3
Ascension,11/1/1992,28671,27015,1656,5.8,128441,118876,9565,7.4
Ascension,12/1/1992,27860,26179,1681,6,128554,118997,9557,7.4
Ascension,1/1/1993,27780,25740,2040,7.3,128400,119075,9325,7.3
Ascension,2/1/1993,27867,26176,1691,6.1,128458,119275,9183,7.1
Ascension,3/1/1993,27891,26202,1689,6.1,128598,119542,9056,7
Ascension,4/1/1993,27942,26326,1616,5.8,128584,119474,9110,7.1
Ascension,5/1/1993,27982,26277,1705,6.1,129264,120115,9149,7.1
Ascension,6/1/1993,28484,26423,2061,7.2,129411,120290,9121,7
Ascension,7/1/1993,28731,26605,2126,7.4,129397,120467,8930,6.9
Ascension,8/1/1993,28507,26139,2368,8.3,129619,120856,8763,6.8
Ascension,9/1/1993,28472,26209,2263,7.9,129268,120554,8714,6.7
Ascension,10/1/1993,28630,26385,2245,7.8,129573,120823,8750,6.8
Ascension,11/1/1993,28690,26571,2119,7.4,129711,121169,8542,6.6
Ascension,12/1/1993,28400,26310,2090,7.4,129941,121464,8477,6.5
Ascension,1/1/1994,28813,26394,2419,8.4,130596,121966,8630,6.6
Ascension,2/1/1994,29168,26928,2240,7.7,130669,122086,8583,6.6
Ascension,3/1/1994,29277,26922,2355,8,130400,121930,8470,6.5
Ascension,4/1/1994,29152,26745,2407,8.3,130621,122290,8331,6.4
Ascension,5/1/1994,29191,26745,2446,8.4,130779,122864,7915,6.1
Ascension,6/1/1994,29881,27084,2797,9.4,130561,122634,7927,6.1
Ascension,7/1/1994,29799,27394,2405,8.1,130652,122706,7946,6.1
Ascension,8/1/1994,29710,27238,2472,8.3,131275,123342,7933,6
Ascension,9/1/1994,29686,27557,2129,7.2,131421,123687,7734,5.9
Ascension,10/1/1994,29498,27583,1915,6.5,131744,124112,7632,5.8
Ascension,11/1/1994,29314,27717,1597,5.4,131891,124516,7375,5.6
Ascension,12/1/1994,29054,27458,1596,5.5,131951,124721,7230,5.5
Ascension,1/1/1995,29715,27543,2172,7.3,132038,124663,7375,5.6
Ascension,2/1/1995,29710,27990,1720,5.8,132115,124928,7187,5.4
Ascension,3/1/1995,30090,28193,1897,6.3,132108,124955,7153,5.4
Ascension,4/1/1995,30299,28146,2153,7.1,132590,124945,7645,5.8
Ascension,5/1/1995,29986,27899,2087,7,131851,124421,7430,5.6
Ascension,6/1/1995,30298,28134,2164,7.1,131949,124522,7427,5.6
Ascension,7/1/1995,30557,28645,1912,6.3,132343,124816,7527,5.7
Ascension,8/1/1995,30127,28143,1984,6.6,132336,124852,7484,5.7
Ascension,9/1/1995,30086,28238,1848,6.1,132611,125133,7478,5.6
Ascension,10/1/1995,30170,28581,1589,5.3,132716,125388,7328,5.5
Ascension,11/1/1995,30322,28755,1567,5.2,132614,125188,7426,5.6
Ascension,12/1/1995,30080,28278,1802,6,132511,125088,7423,5.6
Ascension,1/1/1996,30672,28305,2367,7.7,132616,125125,7491,5.6
Ascension,2/1/1996,30886,28954,1932,6.3,132952,125639,7313,5.5
Ascension,3/1/1996,31039,29294,1745,5.6,133180,125862,7318,5.5
Ascension,4/1/1996,30953,29134,1819,5.9,133409,125994,7415,5.6
Ascension,5/1/1996,31046,29175,1871,6,133667,126244,7423,5.6
Ascension,6/1/1996,31599,29544,2055,6.5,133697,126602,7095,5.3
Ascension,7/1/1996,31808,29741,2067,6.5,134284,126947,7337,5.5
Ascension,8/1/1996,31377,29527,1850,5.9,134054,127172,6882,5.1
Ascension,9/1/1996,31712,29804,1908,6,134515,127536,6979,5.2
Ascension,10/1/1996,31880,30132,1748,5.5,134921,127890,7031,5.2
Ascension,11/1/1996,31781,30209,1572,4.9,135007,127771,7236,5.4
Ascension,12/1/1996,31281,29807,1474,4.7,135113,127860,7253,5.4
Ascension,1/1/1997,31406,29658,1748,5.6,135456,128298,7158,5.3
Ascension,2/1/1997,31518,30039,1479,4.7,135400,128298,7102,5.2
Ascension,3/1/1997,31993,30468,1525,4.8,135891,128891,7000,5.2
Ascension,4/1/1997,31823,30314,1509,4.7,136016,129143,6873,5.1
Ascension,5/1/1997,31652,29977,1675,5.3,136119,129464,6655,4.9
Ascension,6/1/1997,32153,30140,2013,6.3,136211,129412,6799,5
Ascension,7/1/1997,32258,30393,1865,5.8,136477,129822,6655,4.9
Ascension,8/1/1997,31801,30092,1709,5.4,136618,130010,6608,4.8
Ascension,9/1/1997,32077,30314,1763,5.5,136675,130019,6656,4.9
Ascension,10/1/1997,32168,30683,1485,4.6,136633,130179,6454,4.7
Ascension,11/1/1997,32342,30954,1388,4.3,136961,130653,6308,4.6
Ascension,12/1/1997,32162,30849,1313,4.1,137155,130679,6476,4.7
Ascension,1/1/1998,32133,30522,1611,5,137095,130726,6368,4.6
Ascension,2/1/1998,32510,31072,1438,4.4,137112,130807,6306,4.6
Ascension,3/1/1998,32756,31274,1482,4.5,137236,130814,6422,4.7
Ascension,4/1/1998,33020,31603,1417,4.3,137150,131209,5941,4.3
Ascension,5/1/1998,33041,31492,1549,4.7,137372,131325,6047,4.4
Ascension,6/1/1998,33523,31627,1896,5.7,137455,131244,6212,4.5
Ascension,7/1/1998,33686,31940,1746,5.2,137588,131329,6259,4.5
Ascension,8/1/1998,33495,31742,1753,5.2,137570,131390,6179,4.5
Ascension,9/1/1998,33655,31930,1725,5.1,138286,131986,6300,4.6
Ascension,10/1/1998,33760,32314,1446,4.3,138279,131999,6280,4.5
Ascension,11/1/1998,33744,32416,1328,3.9,138381,132280,6100,4.4
Ascension,12/1/1998,33605,32356,1249,3.7,138634,132602,6032,4.4
Ascension,1/1/1999,33906,32436,1470,4.3,139003,133027,5976,4.3
Ascension,2/1/1999,34312,33013,1299,3.8,138967,132856,6111,4.4
Ascension,3/1/1999,34303,33038,1265,3.7,138730,132947,5783,4.2
Ascension,4/1/1999,34470,33219,1251,3.6,138959,132955,6004,4.3
Ascension,5/1/1999,34243,33048,1195,3.5,139107,133311,5796,4.2
Ascension,6/1/1999,34974,33392,1582,4.5,139329,133378,5951,4.3
Ascension,7/1/1999,35400,33690,1710,4.8,139439,133414,6025,4.3
Ascension,8/1/1999,35367,33585,1782,5,139430,133591,5838,4.2
Ascension,9/1/1999,35560,33741,1819,5.1,139622,133707,5915,4.2
Ascension,10/1/1999,35696,34065,1631,4.6,139771,133993,5778,4.1
Ascension,11/1/1999,35699,34299,1400,3.9,140025,134309,5716,4.1
Ascension,12/1/1999,35522,34144,1378,3.9,140177,134523,5653,4
Ascension,1/1/2000,38221,36175,2046,5.4,142267,136559,5708,4
Ascension,2/1/2000,38402,36576,1826,4.8,142456,136598,5858,4.1
Ascension,3/1/2000,38583,36723,1860,4.8,142434,136701,5733,4
Ascension,4/1/2000,38782,37122,1660,4.3,142751,137270,5481,3.8
Ascension,5/1/2000,38301,36425,1876,4.9,142388,136630,5758,4
Ascension,6/1/2000,38884,36700,2184,5.6,142591,136940,5651,4
Ascension,7/1/2000,37960,35907,2053,5.4,142278,136531,5747,4
Ascension,8/1/2000,38033,35874,2159,5.7,142514,136662,5853,4.1
Ascension,9/1/2000,37917,35871,2046,5.4,142518,136893,5625,3.9
Ascension,10/1/2000,37884,35984,1900,5,142622,137088,5534,3.9
Ascension,11/1/2000,38062,36067,1995,5.2,142962,137322,5639,3.9
Ascension,12/1/2000,37950,36033,1917,5.1,143248,137614,5634,3.9
Ascension,1/1/2001,38876,36616,2260,5.8,143800,137778,6023,4.2
Ascension,2/1/2001,38596,36660,1936,5,143701,137612,6089,4.2
Ascension,3/1/2001,38557,36631,1926,5,143924,137783,6141,4.3
Ascension,4/1/2001,38795,36860,1935,5,143569,137299,6271,4.4
Ascension,5/1/2001,38617,36708,1909,4.9,143318,137092,6226,4.3
Ascension,6/1/2001,39090,36833,2257,5.8,143357,136873,6484,4.5
Ascension,7/1/2001,38606,36510,2096,5.4,143654,137071,6583,4.6
Ascension,8/1/2001,38343,36211,2132,5.6,143284,136241,7042,4.9
Ascension,9/1/2001,38557,36367,2190,5.7,143989,136846,7142,5
Ascension,10/1/2001,39122,36923,2199,5.6,144086,136392,7694,5.3
Ascension,11/1/2001,39090,36867,2223,5.7,144240,136238,8003,5.5
Ascension,12/1/2001,38969,36720,2249,5.8,144305,136047,8258,5.7
Ascension,1/1/2002,39118,36592,2526,6.5,143883,135701,8182,5.7
Ascension,2/1/2002,39367,37064,2303,5.9,144653,136438,8215,5.7
Ascension,3/1/2002,39449,36988,2461,6.2,144481,136177,8304,5.7
Ascension,4/1/2002,39884,37361,2523,6.3,144725,136126,8599,5.9
Ascension,5/1/2002,39476,37013,2463,6.2,144938,136539,8399,5.8
Ascension,6/1/2002,40164,37290,2874,7.2,144808,136415,8393,5.8
Ascension,7/1/2002,39756,37137,2619,6.6,144803,136413,8390,5.8
Ascension,8/1/2002,39645,37078,2567,6.5,145009,136705,8304,5.7
Ascension,9/1/2002,39782,37331,2451,6.2,145552,137302,8251,5.7
Ascension,10/1/2002,40000,37646,2354,5.9,145314,137008,8307,5.7
Ascension,11/1/2002,39741,37387,2354,5.9,145041,136521,8520,5.9
Ascension,12/1/2002,39459,37101,2358,6,145066,136426,8640,6
Ascension,1/1/2003,40385,37642,2743,6.8,145937,137417,8520,5.8
Ascension,2/1/2003,40744,38320,2424,5.9,146100,137482,8618,5.9
Ascension,3/1/2003,40819,38238,2581,6.3,146022,137434,8588,5.9
Ascension,4/1/2003,41339,38759,2580,6.2,146474,137633,8842,6
Ascension,5/1/2003,40997,38307,2690,6.6,146500,137544,8957,6.1
Ascension,6/1/2003,41664,38246,3418,8.2,147056,137790,9266,6.3
Ascension,7/1/2003,41684,38519,3165,7.6,146485,137474,9011,6.2
Ascension,8/1/2003,41168,38248,2920,7.1,146445,137549,8896,6.1
Ascension,9/1/2003,41121,38300,2821,6.9,146530,137609,8921,6.1
Ascension,10/1/2003,41395,38885,2510,6.1,146716,137984,8732,6
Ascension,11/1/2003,41242,38787,2455,6,147000,138424,8576,5.8
Ascension,12/1/2003,40868,38521,2347,5.7,146729,138411,8317,5.7
Ascension,1/1/2004,41974,39085,2889,6.9,146842,138472,8370,5.7
Ascension,2/1/2004,42127,39705,2422,5.7,146709,138542,8167,5.6
Ascension,3/1/2004,42522,40002,2520,5.9,146944,138453,8491,5.8
Ascension,4/1/2004,42962,40098,2864,6.7,146850,138680,8170,5.6
Ascension,5/1/2004,42447,39550,2897,6.8,147065,138852,8212,5.6
Ascension,6/1/2004,43325,39954,3371,7.8,147460,139174,8286,5.6
Ascension,7/1/2004,42956,40151,2805,6.5,147692,139556,8136,5.5
Ascension,8/1/2004,42665,40011,2654,6.2,147564,139573,7990,5.4
Ascension,9/1/2004,42669,39997,2672,6.3,147415,139487,7927,5.4
Ascension,10/1/2004,42857,40384,2473,5.8,147793,139732,8061,5.5
Ascension,11/1/2004,42983,40657,2326,5.4,148162,140231,7932,5.4
Ascension,12/1/2004,42612,40398,2214,5.2,148059,140125,7934,5.4
Ascension,1/1/2005,43374,40890,2484,5.7,148029,140245,7784,5.3
Ascension,2/1/2005,43626,41450,2176,5,148364,140385,7980,5.4
Ascension,3/1/2005,43953,41772,2181,5,148391,140654,7737,5.2
Ascension,4/1/2005,44612,42434,2178,4.9,148926,141254,7672,5.2
Ascension,5/1/2005,44055,41777,2278,5.2,149261,141609,7651,5.1
Ascension,6/1/2005,44530,41926,2604,5.8,149238,141714,7524,5
Ascension,7/1/2005,44575,42175,2400,5.4,149432,142026,7406,5
Ascension,8/1/2005,44426,42179,2247,5.1,149779,142434,7345,4.9
Ascension,9/1/2005,51062,45433,5629,11,149954,142401,7553,5
Ascension,10/1/2005,51000,46251,4749,9.3,150001,142548,7453,5
Ascension,11/1/2005,50921,46306,4615,9.1,150065,142499,7566,5
Ascension,12/1/2005,48245,45756,2489,5.2,150030,142752,7279,4.9
Ascension,1/1/2006,48039,46047,1992,4.1,150214,143150,7064,4.7
Ascension,2/1/2006,48319,46622,1697,3.5,150641,143457,7184,4.8
Ascension,3/1/2006,48457,46738,1719,3.5,150813,143741,7072,4.7
Ascension,4/1/2006,48275,46546,1729,3.6,150881,143761,7120,4.7
Ascension,5/1/2006,48119,46185,1934,4,151069,144089,6980,4.6
Ascension,6/1/2006,48138,45906,2232,4.6,151354,144353,7001,4.6
Ascension,7/1/2006,47368,45486,1882,4,151377,144202,7175,4.7
Ascension,8/1/2006,47454,45622,1832,3.9,151716,144625,7091,4.7
Ascension,9/1/2006,47450,45671,1779,3.7,151662,144815,6847,4.5
Ascension,10/1/2006,47976,46250,1726,3.6,152041,145314,6727,4.4
Ascension,11/1/2006,47994,46240,1754,3.7,152406,145534,6872,4.5
Ascension,12/1/2006,47926,46293,1633,3.4,152732,145970,6762,4.4
Ascension,1/1/2007,48001,45944,2057,4.3,153144,146028,7116,4.6
Ascension,2/1/2007,48273,46467,1806,3.7,152983,146057,6927,4.5
Ascension,3/1/2007,48801,46994,1807,3.7,153051,146320,6731,4.4
Ascension,4/1/2007,48921,47105,1816,3.7,152435,145586,6850,4.5
Ascension,5/1/2007,48950,46994,1956,4,152670,145903,6766,4.4
Ascension,6/1/2007,49559,47327,2232,4.5,153041,146063,6979,4.6
Ascension,7/1/2007,49745,47686,2059,4.1,153054,145905,7149,4.7
Ascension,8/1/2007,49038,47196,1842,3.8,152749,145682,7067,4.6
Ascension,9/1/2007,49336,47507,1829,3.7,153414,146244,7170,4.7
Ascension,10/1/2007,49524,47899,1625,3.3,153183,145946,7237,4.7
Ascension,11/1/2007,49790,48128,1662,3.3,153835,146595,7240,4.7
Ascension,12/1/2007,49608,47858,1750,3.5,153918,146273,7645,5
Ascension,1/1/2008,49609,47625,1984,4,154063,146378,7685,5
Ascension,2/1/2008,49661,48030,1631,3.3,153653,146156,7497,4.9
Ascension,3/1/2008,50169,48365,1804,3.6,153908,146086,7822,5.1
Ascension,4/1/2008,50419,48816,1603,3.2,153769,146132,7637,5
Ascension,5/1/2008,50393,48496,1897,3.8,154303,145908,8395,5.4
Ascension,6/1/2008,51334,49024,2310,4.5,154313,145737,8575,5.6
Ascension,7/1/2008,51374,49062,2312,4.5,154469,145532,8937,5.8
Ascension,8/1/2008,50818,48546,2272,4.5,154641,145203,9438,6.1
Ascension,9/1/2008,51253,48635,2618,5.1,154570,145076,9494,6.1
Ascension,10/1/2008,51510,49231,2279,4.4,154876,144802,10074,6.5
Ascension,11/1/2008,51405,49201,2204,4.3,154639,144100,10538,6.8
Ascension,12/1/2008,51328,48958,2370,4.6,154655,143369,11286,7.3
Ascension,1/1/2009,51169,48300,2869,5.6,154210,142152,12058,7.8
Ascension,2/1/2009,51450,48706,2744,5.3,154538,141640,12898,8.3
Ascension,3/1/2009,51788,48932,2856,5.5,154133,140707,13426,8.7
Ascension,4/1/2009,52028,49205,2823,5.4,154509,140656,13853,9
Ascension,5/1/2009,51818,48751,3067,5.9,154747,140248,14499,9.4
Ascension,6/1/2009,52373,48850,3523,6.7,154716,140009,14707,9.5
Ascension,7/1/2009,52615,49401,3214,6.1,154502,139901,14601,9.5
Ascension,8/1/2009,52134,48994,3140,6,154307,139492,14814,9.6
Ascension,9/1/2009,52218,49156,3062,5.9,153827,138818,15009,9.8
Ascension,10/1/2009,51953,49011,2942,5.7,153784,138432,15352,10
Ascension,11/1/2009,52094,49168,2926,5.6,153878,138659,15219,9.9
Ascension,12/1/2009,51473,48384,3089,6,153111,138013,15098,9.9
Ascension,1/1/2010,52966,49280,3686,7,153484,138438,15046,9.8
Ascension,2/1/2010,52765,49503,3262,6.2,153694,138581,15113,9.8
Ascension,3/1/2010,53267,49893,3374,6.3,153954,138751,15202,9.9
Ascension,4/1/2010,53513,50140,3373,6.3,154622,139297,15325,9.9
Ascension,5/1/2010,53490,49729,3761,7,154091,139241,14849,9.6
Ascension,6/1/2010,54102,49879,4223,7.8,153616,139141,14474,9.4
Ascension,7/1/2010,53968,49835,4133,7.7,153691,139179,14512,9.4
Ascension,8/1/2010,53760,49766,3994,7.4,154086,139438,14648,9.5
Ascension,9/1/2010,53670,49785,3885,7.2,153975,139396,14579,9.5
Ascension,10/1/2010,53700,50007,3693,6.9,153635,139119,14516,9.4
Ascension,11/1/2010,53661,49977,3684,6.9,154125,139044,15081,9.8
Ascension,12/1/2010,53221,49699,3522,6.6,153650,139301,14348,9.3
Ascension,1/1/2011,54075,50047,4028,7.4,153263,139250,14013,9.1
Ascension,2/1/2011,54162,50541,3621,6.7,153214,139394,13820,9
Ascension,3/1/2011,54486,50891,3595,6.6,153376,139639,13737,9
Ascension,4/1/2011,54420,50981,3439,6.3,153543,139586,13957,9.1
Ascension,5/1/2011,54174,50565,3609,6.7,153479,139624,13855,9
Ascension,6/1/2011,54374,50345,4029,7.4,153346,139384,13962,9.1
Ascension,7/1/2011,54226,50411,3815,7,153288,139524,13763,9
Ascension,8/1/2011,53694,50066,3628,6.8,153760,139942,13818,9
Ascension,9/1/2011,54300,50740,3560,6.6,154131,140183,13948,9
Ascension,10/1/2011,54636,51276,3360,6.1,153961,140368,13594,8.8
Ascension,11/1/2011,54439,51264,3175,5.8,154128,140826,13302,8.6
Ascension,12/1/2011,53999,50841,3158,5.8,153995,140902,13093,8.5
Ascension,1/1/2012,54513,50937,3576,6.6,154381,141584,12797,8.3
Ascension,2/1/2012,54855,51550,3305,6,154671,141858,12813,8.3
Ascension,3/1/2012,55235,52043,3192,5.8,154749,142036,12713,8.2
Ascension,4/1/2012,55186,52190,2996,5.4,154545,141899,12646,8.2
Ascension,5/1/2012,55138,51844,3294,6,154866,142206,12660,8.2
Ascension,6/1/2012,55682,51897,3785,6.8,155083,142391,12692,8.2
Ascension,7/1/2012,55200,51629,3571,6.5,154948,142292,12656,8.2
Ascension,8/1/2012,54948,51714,3234,5.9,154763,142291,12471,8.1
Ascension,9/1/2012,55391,52391,3000,5.4,155160,143044,12115,7.8
Ascension,10/1/2012,55697,52847,2850,5.1,155554,143431,12124,7.8
Ascension,11/1/2012,55372,52781,2591,4.7,155338,143333,12005,7.7
Ascension,12/1/2012,55080,52231,2849,5.2,155628,143330,12298,7.9
Ascension,1/1/2013,55803,52302,3501,6.3,155763,143292,12471,8
Ascension,2/1/2013,55937,52951,2986,5.3,155312,143362,11950,7.7
Ascension,3/1/2013,56501,53530,2971,5.3,155005,143316,11689,7.5
Ascension,4/1/2013,57001,54095,2906,5.1,155394,143635,11760,7.6
Ascension,5/1/2013,57101,53915,3186,5.6,155536,143882,11654,7.5
Ascension,6/1/2013,57541,53919,3622,6.3,155749,143999,11751,7.5
Ascension,7/1/2013,57249,53946,3303,5.8,155599,144264,11335,7.3
Ascension,8/1/2013,56849,53755,3094,5.4,155605,144326,11279,7.2
Ascension,9/1/2013,57143,54207,2936,5.1,155687,144418,11270,7.2
Ascension,10/1/2013,57114,54329,2785,4.9,154673,143537,11136,7.2
Ascension,11/1/2013,57261,54612,2649,4.6,155265,144479,10787,6.9
Ascension,12/1/2013,56421,53973,2448,4.3,155182,144778,10404,6.7
Ascension,1/1/2014,57105,54384,2721,4.8,155352,145150,10202,6.6
Ascension,2/1/2014,57582,55061,2521,4.4,155483,145134,10349,6.7
Ascension,3/1/2014,58472,55763,2709,4.6,156028,145648,10380,6.7
Ascension,4/1/2014,58656,56121,2535,4.3,155369,145667,9702,6.2
Ascension,5/1/2014,59085,56158,2927,5,155684,145825,9859,6.3
Ascension,6/1/2014,59537,56169,3368,5.7,155707,146247,9460,6.1
Ascension,7/1/2014,59957,56382,3575,6,156007,146399,9608,6.2
Ascension,8/1/2014,60010,56445,3565,5.9,156130,146530,9599,6.1
Ascension,9/1/2014,60337,56955,3382,5.6,156040,146778,9262,5.9
Ascension,10/1/2014,61097,57787,3310,5.4,156417,147427,8990,5.7
Ascension,11/1/2014,60716,57349,3367,5.5,156494,147404,9090,5.8
Ascension,12/1/2014,59904,56714,3190,5.3,156332,147615,8717,5.6
Ascension,1/1/2015,60680,57118,3562,5.9,157030,148145,8885,5.7
Ascension,2/1/2015,60879,57646,3233,5.3,156644,148045,8599,5.5
Ascension,3/1/2015,61272,58148,3124,5.1,156643,148128,8515,5.4
Ascension,4/1/2015,61491,58476,3015,4.9,157060,148511,8550,5.4
Ascension,5/1/2015,61638,58458,3180,5.2,157651,148817,8834,5.6
Ascension,6/1/2015,61651,58302,3349,5.4,157062,148816,8247,5.3
Ascension,7/1/2015,61761,58514,3247,5.3,156997,148830,8167,5.2
Ascension,8/1/2015,61298,58277,3021,4.9,157172,149181,7992,5.1
Ascension,9/1/2015,61284,58340,2944,4.8,156733,148826,7907,5
Ascension,10/1/2015,61728,58864,2864,4.6,157167,149246,7922,5
Ascension,11/1/2015,61607,58877,2730,4.4,157463,149463,8000,5.1
Ascension,12/1/2015,60822,58266,2556,4.2,158035,150128,7907,5
Ascension,1/1/2016,61159,58135,3024,4.9,158280,150653,7627,4.8
Ascension,2/1/2016,61706,58926,2780,4.5,158640,150939,7702,4.9
Ascension,3/1/2016,62415,59525,2890,4.6,159179,151218,7961,5
Ascension,4/1/2016,62337,59507,2830,4.5,159141,151074,8067,5.1
Ascension,5/1/2016,61966,59028,2938,4.7,158784,151132,7652,4.8
Ascension,6/1/2016,62585,59094,3491,5.6,158967,151223,7744,4.9
Ascension,7/1/2016,62624,59262,3362,5.4,159194,151554,7641,4.8
Ascension,8/1/2016,61379,58214,3165,5.2,159562,151779,7784,4.9
Ascension,9/1/2016,62119,58813,3306,5.3,159714,151761,7953,5
Ascension,10/1/2016,62341,59424,2917,4.7,159605,151793,7811,4.9
Ascension,11/1/2016,61928,59155,2773,4.5,159506,151954,7553,4.7
Ascension,12/1/2016,61098,58356,2742,4.5,159678,152157,7521,4.7
Ascension,1/1/2017,61867,58775,3092,5,159620,152152,7468,4.7
Ascension,2/1/2017,62657,59848,2809,4.5,159859,152480,7379,4.6
Ascension,3/1/2017,62924,60210,2714,4.3,160137,153065,7073,4.4
Ascension,4/1/2017,62894,60205,2689,4.3,160345,153255,7089,4.4
Ascension,5/1/2017,62200,59562,2638,4.2,160068,153069,7000,4.4
Ascension,6/1/2017,62520,59542,2978,4.8,160192,153318,6873,4.3
Ascension,7/1/2017,62887,59977,2910,4.6,160462,153569,6892,4.3
Ascension,8/1/2017,62798,59978,2820,4.5,160586,153503,7082,4.4
Ascension,9/1/2017,63261,60621,2640,4.2,161140,154286,6854,4.3
Ascension,10/1/2017,63061,60776,2285,3.6,160309,153609,6700,4.2
Ascension,11/1/2017,63051,60741,2310,3.7,160579,153805,6774,4.2
Ascension,12/1/2017,62430,60220,2210,3.5,160535,153904,6632,4.1
Ascension,1/1/2018,62848,60282,2566,4.1,160914,154425,6489,4
Ascension,2/1/2018,63728,61262,2466,3.9,161778,155197,6581,4.1
Ascension,3/1/2018,64533,62043,2490,3.9,161686,155214,6472,4
Ascension,4/1/2018,64424,61961,2463,3.8,161771,155312,6459,4
Ascension,5/1/2018,63834,61287,2547,4,161848,155652,6196,3.8
Ascension,6/1/2018,64732,61505,3227,5,162210,155762,6447,4
Ascension,7/1/2018,64643,61640,3003,4.6,162341,156146,6195,3.8
Ascension,8/1/2018,63849,61049,2800,4.4,161660,155504,6156,3.8
Ascension,9/1/2018,64152,61552,2600,4.1,162087,156015,6073,3.7
Ascension,10/1/2018,64580,62136,2444,3.8,162602,156391,6211,3.8
Ascension,11/1/2018,64750,62417,2333,3.6,162836,156721,6115,3.8
Ascension,12/1/2018,64165,61863,2302,3.6,163206,156817,6389,3.9
Ascension,1/1/2019,64708,61879,2829,4.4,162963,156487,6475,4
Ascension,2/1/2019,65124,62734,2390,3.7,162999,156863,6136,3.8
Ascension,3/1/2019,65290,63060,2230,3.4,162904,156701,6202,3.8
Ascension,4/1/2019,64902,62817,2085,3.2,162586,156625,5961,3.7
Ascension,5/1/2019,64534,62154,2380,3.7,162751,156821,5930,3.6
Ascension,6/1/2019,64982,62042,2940,4.5,163168,157232,5935,3.6
Ascension,7/1/2019,64739,61855,2884,4.5,163590,157529,6061,3.7
Ascension,8/1/2019,64418,61648,2770,4.3,163774,157829,5945,3.6
Ascension,9/1/2019,64770,62124,2646,4.1,164092,158339,5753,3.5
Ascension,10/1/2019,65180,62527,2653,4.1,164416,158545,5871,3.6
Ascension,11/1/2019,65372,62791,2581,3.9,164496,158629,5868,3.6
Ascension,12/1/2019,64314,61866,2448,3.8,164699,158845,5853,3.6
Ascension,1/1/2020,64387,61711,2676,4.2,164377,158508,5869,3.6
Ascension,2/1/2020,64750,62460,2290,3.5,164467,158714,5753,3.5
Ascension,3/1/2020,65715,61654,4061,6.2,162559,155353,7206,4.4
Ascension,4/1/2020,60588,53589,6999,11.6,156269,133185,23084,14.8
Ascension,5/1/2020,61813,55147,6666,10.8,158101,137173,20929,13.2
Ascension,6/1/2020,63167,57037,6130,9.7,159994,142342,17652,11
Ascension,7/1/2020,63568,57919,5649,8.9,160132,143779,16352,10.2
Ascension,8/1/2020,63686,59300,4386,6.9,160706,147245,13461,8.4
Ascension,9/1/2020,64604,60125,4479,6.9,160174,147620,12554,7.8
Ascension,10/1/2020,65316,61455,3861,5.9,161003,149931,11072,6.9
Ascension,11/1/2020,64674,61278,3396,5.3,160629,149934,10694,6.7
Ascension,12/1/2020,64229,60801,3428,5.3,160745,149975,10770,6.7
Ascension,1/1/2021,63663,60114,3549,5.6,160088,149852,10236,6.4
Ascension,2/1/2021,64203,60907,3296,5.1,160184,150189,9995,6.2
Ascension,3/1/2021,64599,61559,3040,4.7,160400,150644,9756,6.1
Ascension,4/1/2021,64933,61870,3063,4.7,160843,151081,9762,6.1
Ascension,5/1/2021,64689,61660,3029,4.7,160800,151535,9266,5.8
Ascension,6/1/2021,64481,61003,3478,5.4,161197,151734,9462,5.9
Ascension,7/1/2021,64601,61510,3091,4.8,161504,152773,8731,5.4
Ascension,8/1/2021,64427,61710,2717,4.2,161527,153250,8276,5.1
Ascension,9/1/2021,65936,63461,2475,3.8,161495,153843,7652,4.7
Ascension,10/1/2021,65813,63673,2140,3.3,161754,154475,7279,4.5
Ascension,11/1/2021,66084,64174,1910,2.9,162281,155530,6751,4.2
Ascension,12/1/2021,65521,63805,1716,2.6,162497,156099,6398,3.9
Ascension,1/1/2022,65737,63597,2140,3.3,163627,157115,6512,4
Ascension,2/1/2022,66592,64670,1922,2.9,163899,157598,6301,3.8
Ascension,3/1/2022,67033,65167,1866,2.8,164220,158206,6014,3.7
Ascension,4/1/2022,66627,64875,1752,2.6,163893,157891,6002,3.7
Ascension,5/1/2022,66379,64465,1914,2.9,164362,158378,5983,3.6
Ascension,6/1/2022,66499,64014,2485,3.7,164046,158094,5951,3.6
Ascension,7/1/2022,66538,64322,2216,3.3,164026,158258,5768,3.5
Ascension,8/1/2022,66445,64375,2070,3.1,164654,158735,5919,3.6
Ascension,9/1/2022,66506,64533,1973,3,164602,158810,5792,3.5
Ascension,10/1/2022,66539,64723,1816,2.7,164648,158684,5964,3.6
Ascension,11/1/2022,66504,64770,1734,2.6,164450,158507,5943,3.6
Ascension,12/1/2022,66095,64367,1728,2.6,165025,159259,5766,3.5
Ascension,1/1/2023,65746,63732,2014,3.1,165964,160217,5747,3.5
Ascension,2/1/2023,66495,64622,1873,2.8,166358,160395,5962,3.6
Ascension,3/1/2023,67145,65374,1771,2.6,166651,160812,5839,3.5
Ascension,4/1/2023,66801,65163,1638,2.5,166725,160974,5751,3.4
Ascension,5/1/2023,66460,64505,1955,2.9,166886,160796,6089,3.6
Ascension,6/1/2023,66371,64095,2276,3.4,166937,160979,5958,3.6
Ascension,7/1/2023,66407,64458,1949,2.9,167103,161183,5920,3.5
Ascension,8/1/2023,66622,64522,2100,3.2,167759,161475,6284,3.7
Ascension,9/1/2023,67193,65037,2156,3.2,167767,161442,6326,3.8
Ascension,10/1/2023,67506,65370,2136,3.2,167690,161211,6479,3.9
Ascension,11/1/2023,67770,65725,2045,3,168140,161886,6254,3.7
Ascension,12/1/2023,66977,64855,2122,3.2,167439,161124,6315,3.8
Ascension,1/1/2024,66772,64376,2396,3.6,167339,161190,6149,3.7
Ascension,2/1/2024,67274,64997,2277,3.4,167475,161013,6462,3.9
Ascension,3/1/2024,68162,65949,2213,3.2,167922,161425,6497,3.9
Ascension,4/1/2024,67810,65866,1944,2.9,167988,161495,6492,3.9
Ascension,5/1/2024,67386,65288,2098,3.1,167799,161164,6635,4
Ascension,6/1/2024,67442,64731,2711,4,168005,161155,6849,4.1
Ascension,7/1/2024,67602,64963,2639,3.9,168315,161219,7097,4.2
Ascension,8/1/2024,67473,64808,2665,3.9,168496,161425,7071,4.2
Ascension,9/1/2024,67251,64697,2554,3.8,168703,161802,6901,4.1
Ascension,10/1/2024,67618,65101,2517,3.7,168428,161456,6972,4.1
Ascension,11/1/2024,67581,65139,2442,3.6,168304,161183,7121,4.2
Ascension,12/1/2024,67161,64797,2364,3.5,168547,161661,6886,4.1
Ascension,1/1/2025,67656,65176,2480,3.7,170744,163895,6849,4
Ascension,2/1/2025,68277,65942,2335,3.4,170359,163307,7052,4.1
Assumption,1/1/1990,9138,8269,869,9.5,125833,119081,6752,5.4
Assumption,2/1/1990,9021,8276,745,8.3,125710,119059,6651,5.3
Assumption,3/1/1990,9070,8356,714,7.9,125801,119203,6598,5.2
Assumption,4/1/1990,9006,8445,561,6.2,125649,118852,6797,5.4
Assumption,5/1/1990,8937,8418,519,5.8,125893,119151,6742,5.4
Assumption,6/1/1990,9369,8687,682,7.3,125573,118983,6590,5.2
Assumption,7/1/1990,9507,8928,579,6.1,125732,118810,6922,5.5
Assumption,8/1/1990,9440,8896,544,5.8,125990,118802,7188,5.7
Assumption,9/1/1990,9404,8829,575,6.1,125892,118524,7368,5.9
Assumption,10/1/1990,9331,8777,554,5.9,125995,118536,7459,5.9
Assumption,11/1/1990,9273,8771,502,5.4,126070,118306,7764,6.2
Assumption,12/1/1990,9314,8758,556,6,126142,118241,7901,6.3
Assumption,1/1/1991,9654,8535,1119,11.6,125955,117940,8015,6.4
Assumption,2/1/1991,9725,8699,1026,10.6,126020,117755,8265,6.6
Assumption,3/1/1991,9528,8773,755,7.9,126238,117652,8586,6.8
Assumption,4/1/1991,9470,8754,716,7.6,126548,118109,8439,6.7
Assumption,5/1/1991,9672,8942,730,7.5,126176,117440,8736,6.9
Assumption,6/1/1991,9939,9143,796,8,126331,117639,8692,6.9
Assumption,7/1/1991,9802,9020,782,8,126154,117568,8586,6.8
Assumption,8/1/1991,9568,8887,681,7.1,126150,117484,8666,6.9
Assumption,9/1/1991,9381,8751,630,6.7,126650,117928,8722,6.9
Assumption,10/1/1991,9135,8659,476,5.2,126642,117800,8842,7
Assumption,11/1/1991,8951,8538,413,4.6,126701,117770,8931,7
Assumption,12/1/1991,8851,8330,521,5.9,126664,117466,9198,7.3
Assumption,1/1/1992,9309,8076,1233,13.2,127261,117978,9283,7.3
Assumption,2/1/1992,9075,8064,1011,11.1,127207,117753,9454,7.4
Assumption,3/1/1992,8991,8078,913,10.2,127604,118144,9460,7.4
Assumption,4/1/1992,8929,8088,841,9.4,127841,118426,9415,7.4
Assumption,5/1/1992,8855,8018,837,9.5,128119,118375,9744,7.6
Assumption,6/1/1992,9138,8172,966,10.6,128459,118419,10040,7.8
Assumption,7/1/1992,9222,8292,930,10.1,128563,118713,9850,7.7
Assumption,8/1/1992,8978,8182,796,8.9,128613,118826,9787,7.6
Assumption,9/1/1992,8990,8136,854,9.5,128501,118720,9781,7.6
Assumption,10/1/1992,8962,8237,725,8.1,128026,118628,9398,7.3
Assumption,11/1/1992,8972,8242,730,8.1,128441,118876,9565,7.4
Assumption,12/1/1992,8893,8055,838,9.4,128554,118997,9557,7.4
Assumption,1/1/1993,9093,7822,1271,14,128400,119075,9325,7.3
Assumption,2/1/1993,8959,7943,1016,11.3,128458,119275,9183,7.1
Assumption,3/1/1993,8907,8014,893,10,128598,119542,9056,7
Assumption,4/1/1993,8936,8143,793,8.9,128584,119474,9110,7.1
Assumption,5/1/1993,9085,8248,837,9.2,129264,120115,9149,7.1
Assumption,6/1/1993,9292,8356,936,10.1,129411,120290,9121,7
Assumption,7/1/1993,9502,8540,962,10.1,129397,120467,8930,6.9
Assumption,8/1/1993,9508,8530,978,10.3,129619,120856,8763,6.8
Assumption,9/1/1993,9214,8284,930,10.1,129268,120554,8714,6.7
Assumption,10/1/1993,8990,8215,775,8.6,129573,120823,8750,6.8
Assumption,11/1/1993,8990,8291,699,7.8,129711,121169,8542,6.6
Assumption,12/1/1993,8993,8313,680,7.6,129941,121464,8477,6.5
Assumption,1/1/1994,9398,8194,1204,12.8,130596,121966,8630,6.6
Assumption,2/1/1994,9272,8245,1027,11.1,130669,122086,8583,6.6
Assumption,3/1/1994,9247,8313,934,10.1,130400,121930,8470,6.5
Assumption,4/1/1994,9099,8286,813,8.9,130621,122290,8331,6.4
Assumption,5/1/1994,9134,8272,862,9.4,130779,122864,7915,6.1
Assumption,6/1/1994,9307,8323,984,10.6,130561,122634,7927,6.1
Assumption,7/1/1994,9258,8452,806,8.7,130652,122706,7946,6.1
Assumption,8/1/1994,9254,8471,783,8.5,131275,123342,7933,6
Assumption,9/1/1994,9119,8409,710,7.8,131421,123687,7734,5.9
Assumption,10/1/1994,9145,8558,587,6.4,131744,124112,7632,5.8
Assumption,11/1/1994,9180,8631,549,6,131891,124516,7375,5.6
Assumption,12/1/1994,9127,8537,590,6.5,131951,124721,7230,5.5
Assumption,1/1/1995,9226,8198,1028,11.1,132038,124663,7375,5.6
Assumption,2/1/1995,9172,8347,825,9,132115,124928,7187,5.4
Assumption,3/1/1995,9166,8377,789,8.6,132108,124955,7153,5.4
Assumption,4/1/1995,9359,8452,907,9.7,132590,124945,7645,5.8
Assumption,5/1/1995,9377,8480,897,9.6,131851,124421,7430,5.6
Assumption,6/1/1995,9474,8585,889,9.4,131949,124522,7427,5.6
Assumption,7/1/1995,9315,8640,675,7.2,132343,124816,7527,5.7
Assumption,8/1/1995,9263,8666,597,6.4,132336,124852,7484,5.7
Assumption,9/1/1995,9110,8553,557,6.1,132611,125133,7478,5.6
Assumption,10/1/1995,8771,8345,426,4.9,132716,125388,7328,5.5
Assumption,11/1/1995,8750,8316,434,5,132614,125188,7426,5.6
Assumption,12/1/1995,8884,8275,609,6.9,132511,125088,7423,5.6
Assumption,1/1/1996,9162,7917,1245,13.6,132616,125125,7491,5.6
Assumption,2/1/1996,8858,8084,774,8.7,132952,125639,7313,5.5
Assumption,3/1/1996,8812,8158,654,7.4,133180,125862,7318,5.5
Assumption,4/1/1996,9046,8399,647,7.2,133409,125994,7415,5.6
Assumption,5/1/1996,9154,8541,613,6.7,133667,126244,7423,5.6
Assumption,6/1/1996,9195,8625,570,6.2,133697,126602,7095,5.3
Assumption,7/1/1996,9467,8941,526,5.6,134284,126947,7337,5.5
Assumption,8/1/1996,9318,8893,425,4.6,134054,127172,6882,5.1
Assumption,9/1/1996,9296,8852,444,4.8,134515,127536,6979,5.2
Assumption,10/1/1996,9325,8845,480,5.1,134921,127890,7031,5.2
Assumption,11/1/1996,9208,8757,451,4.9,135007,127771,7236,5.4
Assumption,12/1/1996,9051,8680,371,4.1,135113,127860,7253,5.4
Assumption,1/1/1997,9257,8462,795,8.6,135456,128298,7158,5.3
Assumption,2/1/1997,9291,8692,599,6.4,135400,128298,7102,5.2
Assumption,3/1/1997,9299,8692,607,6.5,135891,128891,7000,5.2
Assumption,4/1/1997,9487,8970,517,5.4,136016,129143,6873,5.1
Assumption,5/1/1997,9728,9130,598,6.1,136119,129464,6655,4.9
Assumption,6/1/1997,9945,9244,701,7,136211,129412,6799,5
Assumption,7/1/1997,10048,9436,612,6.1,136477,129822,6655,4.9
Assumption,8/1/1997,10411,9856,555,5.3,136618,130010,6608,4.8
Assumption,9/1/1997,10135,9592,543,5.4,136675,130019,6656,4.9
Assumption,10/1/1997,9986,9565,421,4.2,136633,130179,6454,4.7
Assumption,11/1/1997,10006,9639,367,3.7,136961,130653,6308,4.6
Assumption,12/1/1997,10012,9627,385,3.8,137155,130679,6476,4.7
Assumption,1/1/1998,9526,8957,569,6,137095,130726,6368,4.6
Assumption,2/1/1998,9588,9115,473,4.9,137112,130807,6306,4.6
Assumption,3/1/1998,9728,9216,512,5.3,137236,130814,6422,4.7
Assumption,4/1/1998,9643,9230,413,4.3,137150,131209,5941,4.3
Assumption,5/1/1998,9674,9237,437,4.5,137372,131325,6047,4.4
Assumption,6/1/1998,9926,9415,511,5.1,137455,131244,6212,4.5
Assumption,7/1/1998,9932,9474,458,4.6,137588,131329,6259,4.5
Assumption,8/1/1998,9977,9470,507,5.1,137570,131390,6179,4.5
Assumption,9/1/1998,9893,9254,639,6.5,138286,131986,6300,4.6
Assumption,10/1/1998,9575,8978,597,6.2,138279,131999,6280,4.5
Assumption,11/1/1998,9418,8907,511,5.4,138381,132280,6100,4.4
Assumption,12/1/1998,9339,8822,517,5.5,138634,132602,6032,4.4
Assumption,1/1/1999,9444,8739,705,7.5,139003,133027,5976,4.3
Assumption,2/1/1999,9218,8566,652,7.1,138967,132856,6111,4.4
Assumption,3/1/1999,9072,8472,600,6.6,138730,132947,5783,4.2
Assumption,4/1/1999,8710,8155,555,6.4,138959,132955,6004,4.3
Assumption,5/1/1999,8645,8105,540,6.2,139107,133311,5796,4.2
Assumption,6/1/1999,8963,8234,729,8.1,139329,133378,5951,4.3
Assumption,7/1/1999,9117,8426,691,7.6,139439,133414,6025,4.3
Assumption,8/1/1999,9012,8314,698,7.7,139430,133591,5838,4.2
Assumption,9/1/1999,8847,8115,732,8.3,139622,133707,5915,4.2
Assumption,10/1/1999,8838,8233,605,6.8,139771,133993,5778,4.1
Assumption,11/1/1999,8657,8164,493,5.7,140025,134309,5716,4.1
Assumption,12/1/1999,8568,8114,454,5.3,140177,134523,5653,4
Assumption,1/1/2000,9806,9108,698,7.1,142267,136559,5708,4
Assumption,2/1/2000,9647,9039,608,6.3,142456,136598,5858,4.1
Assumption,3/1/2000,9836,9206,630,6.4,142434,136701,5733,4
Assumption,4/1/2000,9724,9203,521,5.4,142751,137270,5481,3.8
Assumption,5/1/2000,9692,9080,612,6.3,142388,136630,5758,4
Assumption,6/1/2000,9857,9162,695,7.1,142591,136940,5651,4
Assumption,7/1/2000,10272,9641,631,6.1,142278,136531,5747,4
Assumption,8/1/2000,10205,9584,621,6.1,142514,136662,5853,4.1
Assumption,9/1/2000,10211,9605,606,5.9,142518,136893,5625,3.9
Assumption,10/1/2000,10000,9440,560,5.6,142622,137088,5534,3.9
Assumption,11/1/2000,10051,9436,615,6.1,142962,137322,5639,3.9
Assumption,12/1/2000,10138,9492,646,6.4,143248,137614,5634,3.9
Assumption,1/1/2001,10419,9621,798,7.7,143800,137778,6023,4.2
Assumption,2/1/2001,10266,9666,600,5.8,143701,137612,6089,4.2
Assumption,3/1/2001,10309,9721,588,5.7,143924,137783,6141,4.3
Assumption,4/1/2001,10457,9892,565,5.4,143569,137299,6271,4.4
Assumption,5/1/2001,10367,9843,524,5.1,143318,137092,6226,4.3
Assumption,6/1/2001,10554,9903,651,6.2,143357,136873,6484,4.5
Assumption,7/1/2001,10481,9906,575,5.5,143654,137071,6583,4.6
Assumption,8/1/2001,10404,9822,582,5.6,143284,136241,7042,4.9
Assumption,9/1/2001,10346,9713,633,6.1,143989,136846,7142,5
Assumption,10/1/2001,10475,9840,635,6.1,144086,136392,7694,5.3
Assumption,11/1/2001,10354,9740,614,5.9,144240,136238,8003,5.5
Assumption,12/1/2001,10291,9681,610,5.9,144305,136047,8258,5.7
Assumption,1/1/2002,10139,9412,727,7.2,143883,135701,8182,5.7
Assumption,2/1/2002,10196,9591,605,5.9,144653,136438,8215,5.7
Assumption,3/1/2002,10243,9589,654,6.4,144481,136177,8304,5.7
Assumption,4/1/2002,10358,9700,658,6.4,144725,136126,8599,5.9
Assumption,5/1/2002,10388,9749,639,6.2,144938,136539,8399,5.8
Assumption,6/1/2002,10636,9908,728,6.8,144808,136415,8393,5.8
Assumption,7/1/2002,10823,10146,677,6.3,144803,136413,8390,5.8
Assumption,8/1/2002,10771,10123,648,6,145009,136705,8304,5.7
Assumption,9/1/2002,10718,10073,645,6,145552,137302,8251,5.7
Assumption,10/1/2002,10827,10230,597,5.5,145314,137008,8307,5.7
Assumption,11/1/2002,10712,10097,615,5.7,145041,136521,8520,5.9
Assumption,12/1/2002,10677,10037,640,6,145066,136426,8640,6
Assumption,1/1/2003,10641,9885,756,7.1,145937,137417,8520,5.8
Assumption,2/1/2003,10536,9855,681,6.5,146100,137482,8618,5.9
Assumption,3/1/2003,10651,9941,710,6.7,146022,137434,8588,5.9
Assumption,4/1/2003,10746,10063,683,6.4,146474,137633,8842,6
Assumption,5/1/2003,10750,10050,700,6.5,146500,137544,8957,6.1
Assumption,6/1/2003,11114,10257,857,7.7,147056,137790,9266,6.3
Assumption,7/1/2003,10671,9891,780,7.3,146485,137474,9011,6.2
Assumption,8/1/2003,10579,9860,719,6.8,146445,137549,8896,6.1
Assumption,9/1/2003,10472,9808,664,6.3,146530,137609,8921,6.1
Assumption,10/1/2003,10657,10054,603,5.7,146716,137984,8732,6
Assumption,11/1/2003,10600,9978,622,5.9,147000,138424,8576,5.8
Assumption,12/1/2003,10449,9824,625,6,146729,138411,8317,5.7
Assumption,1/1/2004,10590,9753,837,7.9,146842,138472,8370,5.7
Assumption,2/1/2004,10449,9750,699,6.7,146709,138542,8167,5.6
Assumption,3/1/2004,10486,9754,732,7,146944,138453,8491,5.8
Assumption,4/1/2004,10629,9749,880,8.3,146850,138680,8170,5.6
Assumption,5/1/2004,10484,9651,833,7.9,147065,138852,8212,5.6
Assumption,6/1/2004,10735,9693,1042,9.7,147460,139174,8286,5.6
Assumption,7/1/2004,10711,9793,918,8.6,147692,139556,8136,5.5
Assumption,8/1/2004,10574,9616,958,9.1,147564,139573,7990,5.4
Assumption,9/1/2004,10407,9501,906,8.7,147415,139487,7927,5.4
Assumption,10/1/2004,10332,9457,875,8.5,147793,139732,8061,5.5
Assumption,11/1/2004,10153,9381,772,7.6,148162,140231,7932,5.4
Assumption,12/1/2004,9996,9259,737,7.4,148059,140125,7934,5.4
Assumption,1/1/2005,9882,8953,929,9.4,148029,140245,7784,5.3
Assumption,2/1/2005,9703,8937,766,7.9,148364,140385,7980,5.4
Assumption,3/1/2005,9697,8913,784,8.1,148391,140654,7737,5.2
Assumption,4/1/2005,9736,8981,755,7.8,148926,141254,7672,5.2
Assumption,5/1/2005,9663,8913,750,7.8,149261,141609,7651,5.1
Assumption,6/1/2005,9780,8915,865,8.8,149238,141714,7524,5
Assumption,7/1/2005,9799,8974,825,8.4,149432,142026,7406,5
Assumption,8/1/2005,9624,8871,753,7.8,149779,142434,7345,4.9
Assumption,9/1/2005,11224,9390,1834,16.3,149954,142401,7553,5
Assumption,10/1/2005,11194,9691,1503,13.4,150001,142548,7453,5
Assumption,11/1/2005,10952,9555,1397,12.8,150065,142499,7566,5
Assumption,12/1/2005,10220,9458,762,7.5,150030,142752,7279,4.9
Assumption,1/1/2006,9946,9328,618,6.2,150214,143150,7064,4.7
Assumption,2/1/2006,9914,9422,492,5,150641,143457,7184,4.8
Assumption,3/1/2006,10075,9593,482,4.8,150813,143741,7072,4.7
Assumption,4/1/2006,10248,9778,470,4.6,150881,143761,7120,4.7
Assumption,5/1/2006,10258,9726,532,5.2,151069,144089,6980,4.6
Assumption,6/1/2006,10432,9778,654,6.3,151354,144353,7001,4.6
Assumption,7/1/2006,10512,9931,581,5.5,151377,144202,7175,4.7
Assumption,8/1/2006,10383,9848,535,5.2,151716,144625,7091,4.7
Assumption,9/1/2006,10452,9929,523,5,151662,144815,6847,4.5
Assumption,10/1/2006,10608,10136,472,4.4,152041,145314,6727,4.4
Assumption,11/1/2006,10521,10058,463,4.4,152406,145534,6872,4.5
Assumption,12/1/2006,10423,9959,464,4.5,152732,145970,6762,4.4
Assumption,1/1/2007,10311,9761,550,5.3,153144,146028,7116,4.6
Assumption,2/1/2007,10339,9879,460,4.4,152983,146057,6927,4.5
Assumption,3/1/2007,10449,10014,435,4.2,153051,146320,6731,4.4
Assumption,4/1/2007,10427,9992,435,4.2,152435,145586,6850,4.5
Assumption,5/1/2007,10379,9916,463,4.5,152670,145903,6766,4.4
Assumption,6/1/2007,10519,9976,543,5.2,153041,146063,6979,4.6
Assumption,7/1/2007,10558,10045,513,4.9,153054,145905,7149,4.7
Assumption,8/1/2007,10497,10024,473,4.5,152749,145682,7067,4.6
Assumption,9/1/2007,10608,10127,481,4.5,153414,146244,7170,4.7
Assumption,10/1/2007,10641,10223,418,3.9,153183,145946,7237,4.7
Assumption,11/1/2007,10664,10244,420,3.9,153835,146595,7240,4.7
Assumption,12/1/2007,10548,10101,447,4.2,153918,146273,7645,5
Assumption,1/1/2008,10521,9983,538,5.1,154063,146378,7685,5
Assumption,2/1/2008,10519,10057,462,4.4,153653,146156,7497,4.9
Assumption,3/1/2008,10685,10179,506,4.7,153908,146086,7822,5.1
Assumption,4/1/2008,10572,10133,439,4.2,153769,146132,7637,5
Assumption,5/1/2008,10479,10009,470,4.5,154303,145908,8395,5.4
Assumption,6/1/2008,10607,10031,576,5.4,154313,145737,8575,5.6
Assumption,7/1/2008,10727,10147,580,5.4,154469,145532,8937,5.8
Assumption,8/1/2008,10643,10071,572,5.4,154641,145203,9438,6.1
Assumption,9/1/2008,10852,9871,981,9,154570,145076,9494,6.1
Assumption,10/1/2008,10743,10093,650,6.1,154876,144802,10074,6.5
Assumption,11/1/2008,10665,10065,600,5.6,154639,144100,10538,6.8
Assumption,12/1/2008,10518,9862,656,6.2,154655,143369,11286,7.3
Assumption,1/1/2009,10482,9689,793,7.6,154210,142152,12058,7.8
Assumption,2/1/2009,10482,9726,756,7.2,154538,141640,12898,8.3
Assumption,3/1/2009,10543,9759,784,7.4,154133,140707,13426,8.7
Assumption,4/1/2009,10576,9793,783,7.4,154509,140656,13853,9
Assumption,5/1/2009,10523,9747,776,7.4,154747,140248,14499,9.4
Assumption,6/1/2009,10705,9803,902,8.4,154716,140009,14707,9.5
Assumption,7/1/2009,10558,9692,866,8.2,154502,139901,14601,9.5
Assumption,8/1/2009,10418,9595,823,7.9,154307,139492,14814,9.6
Assumption,9/1/2009,10340,9502,838,8.1,153827,138818,15009,9.8
Assumption,10/1/2009,10481,9655,826,7.9,153784,138432,15352,10
Assumption,11/1/2009,10540,9684,856,8.1,153878,138659,15219,9.9
Assumption,12/1/2009,10519,9584,935,8.9,153111,138013,15098,9.9
Assumption,1/1/2010,9816,8702,1114,11.3,153484,138438,15046,9.8
Assumption,2/1/2010,9802,8827,975,9.9,153694,138581,15113,9.8
Assumption,3/1/2010,9933,8930,1003,10.1,153954,138751,15202,9.9
Assumption,4/1/2010,9984,9020,964,9.7,154622,139297,15325,9.9
Assumption,5/1/2010,10078,8987,1091,10.8,154091,139241,14849,9.6
Assumption,6/1/2010,10226,9057,1169,11.4,153616,139141,14474,9.4
Assumption,7/1/2010,10382,9210,1172,11.3,153691,139179,14512,9.4
Assumption,8/1/2010,10240,9103,1137,11.1,154086,139438,14648,9.5
Assumption,9/1/2010,10210,9061,1149,11.3,153975,139396,14579,9.5
Assumption,10/1/2010,10061,8983,1078,10.7,153635,139119,14516,9.4
Assumption,11/1/2010,10007,8914,1093,10.9,154125,139044,15081,9.8
Assumption,12/1/2010,9981,8837,1144,11.5,153650,139301,14348,9.3
Assumption,1/1/2011,9993,8670,1323,13.2,153263,139250,14013,9.1
Assumption,2/1/2011,9969,8747,1222,12.3,153214,139394,13820,9
Assumption,3/1/2011,9965,8777,1188,11.9,153376,139639,13737,9
Assumption,4/1/2011,9933,8829,1104,11.1,153543,139586,13957,9.1
Assumption,5/1/2011,10001,8866,1135,11.3,153479,139624,13855,9
Assumption,6/1/2011,10150,8892,1258,12.4,153346,139384,13962,9.1
Assumption,7/1/2011,10189,9000,1189,11.7,153288,139524,13763,9
Assumption,8/1/2011,10052,8926,1126,11.2,153760,139942,13818,9
Assumption,9/1/2011,10040,8931,1109,11,154131,140183,13948,9
Assumption,10/1/2011,9960,8905,1055,10.6,153961,140368,13594,8.8
Assumption,11/1/2011,9892,8921,971,9.8,154128,140826,13302,8.6
Assumption,12/1/2011,9886,8866,1020,10.3,153995,140902,13093,8.5
Assumption,1/1/2012,9870,8720,1150,11.7,154381,141584,12797,8.3
Assumption,2/1/2012,9889,8860,1029,10.4,154671,141858,12813,8.3
Assumption,3/1/2012,9883,8906,977,9.9,154749,142036,12713,8.2
Assumption,4/1/2012,9914,9031,883,8.9,154545,141899,12646,8.2
Assumption,5/1/2012,9957,9045,912,9.2,154866,142206,12660,8.2
Assumption,6/1/2012,10194,9142,1052,10.3,155083,142391,12692,8.2
Assumption,7/1/2012,10199,9201,998,9.8,154948,142292,12656,8.2
Assumption,8/1/2012,10023,9116,907,9,154763,142291,12471,8.1
Assumption,9/1/2012,10072,9219,853,8.5,155160,143044,12115,7.8
Assumption,10/1/2012,10038,9247,791,7.9,155554,143431,12124,7.8
Assumption,11/1/2012,9941,9237,704,7.1,155338,143333,12005,7.7
Assumption,12/1/2012,9953,9173,780,7.8,155628,143330,12298,7.9
Assumption,1/1/2013,9893,8976,917,9.3,155763,143292,12471,8
Assumption,2/1/2013,9881,9037,844,8.5,155312,143362,11950,7.7
Assumption,3/1/2013,9865,9052,813,8.2,155005,143316,11689,7.5
Assumption,4/1/2013,9925,9146,779,7.8,155394,143635,11760,7.6
Assumption,5/1/2013,9943,9136,807,8.1,155536,143882,11654,7.5
Assumption,6/1/2013,10119,9226,893,8.8,155749,143999,11751,7.5
Assumption,7/1/2013,10074,9253,821,8.1,155599,144264,11335,7.3
Assumption,8/1/2013,9926,9141,785,7.9,155605,144326,11279,7.2
Assumption,9/1/2013,9903,9135,768,7.8,155687,144418,11270,7.2
Assumption,10/1/2013,9797,9089,708,7.2,154673,143537,11136,7.2
Assumption,11/1/2013,9819,9145,674,6.9,155265,144479,10787,6.9
Assumption,12/1/2013,9766,9123,643,6.6,155182,144778,10404,6.7
Assumption,1/1/2014,9719,9022,697,7.2,155352,145150,10202,6.6
Assumption,2/1/2014,9699,9050,649,6.7,155483,145134,10349,6.7
Assumption,3/1/2014,9817,9130,687,7,156028,145648,10380,6.7
Assumption,4/1/2014,9776,9131,645,6.6,155369,145667,9702,6.2
Assumption,5/1/2014,9898,9184,714,7.2,155684,145825,9859,6.3
Assumption,6/1/2014,10150,9324,826,8.1,155707,146247,9460,6.1
Assumption,7/1/2014,10273,9442,831,8.1,156007,146399,9608,6.2
Assumption,8/1/2014,10144,9303,841,8.3,156130,146530,9599,6.1
Assumption,9/1/2014,10205,9386,819,8,156040,146778,9262,5.9
Assumption,10/1/2014,10165,9413,752,7.4,156417,147427,8990,5.7
Assumption,11/1/2014,10129,9330,799,7.9,156494,147404,9090,5.8
Assumption,12/1/2014,10091,9293,798,7.9,156332,147615,8717,5.6
Assumption,1/1/2015,9905,9014,891,9,157030,148145,8885,5.7
Assumption,2/1/2015,9962,9158,804,8.1,156644,148045,8599,5.5
Assumption,3/1/2015,9871,9103,768,7.8,156643,148128,8515,5.4
Assumption,4/1/2015,9777,9033,744,7.6,157060,148511,8550,5.4
Assumption,5/1/2015,9813,9026,787,8,157651,148817,8834,5.6
Assumption,6/1/2015,9904,9106,798,8.1,157062,148816,8247,5.3
Assumption,7/1/2015,9894,9117,777,7.9,156997,148830,8167,5.2
Assumption,8/1/2015,9612,8895,717,7.5,157172,149181,7992,5.1
Assumption,9/1/2015,9605,8858,747,7.8,156733,148826,7907,5
Assumption,10/1/2015,9550,8847,703,7.4,157167,149246,7922,5
Assumption,11/1/2015,9554,8856,698,7.3,157463,149463,8000,5.1
Assumption,12/1/2015,9557,8870,687,7.2,158035,150128,7907,5
Assumption,1/1/2016,9273,8482,791,8.5,158280,150653,7627,4.8
Assumption,2/1/2016,9282,8533,749,8.1,158640,150939,7702,4.9
Assumption,3/1/2016,9314,8568,746,8,159179,151218,7961,5
Assumption,4/1/2016,9164,8443,721,7.9,159141,151074,8067,5.1
Assumption,5/1/2016,9184,8435,749,8.2,158784,151132,7652,4.8
Assumption,6/1/2016,9377,8510,867,9.2,158967,151223,7744,4.9
Assumption,7/1/2016,9480,8617,863,9.1,159194,151554,7641,4.8
Assumption,8/1/2016,9132,8321,811,8.9,159562,151779,7784,4.9
Assumption,9/1/2016,9164,8340,824,9,159714,151761,7953,5
Assumption,10/1/2016,9107,8372,735,8.1,159605,151793,7811,4.9
Assumption,11/1/2016,9008,8332,676,7.5,159506,151954,7553,4.7
Assumption,12/1/2016,8952,8250,702,7.8,159678,152157,7521,4.7
Assumption,1/1/2017,8892,8108,784,8.8,159620,152152,7468,4.7
Assumption,2/1/2017,8944,8219,725,8.1,159859,152480,7379,4.6
Assumption,3/1/2017,9000,8323,677,7.5,160137,153065,7073,4.4
Assumption,4/1/2017,8977,8293,684,7.6,160345,153255,7089,4.4
Assumption,5/1/2017,8963,8319,644,7.2,160068,153069,7000,4.4
Assumption,6/1/2017,9070,8364,706,7.8,160192,153318,6873,4.3
Assumption,7/1/2017,9017,8337,680,7.5,160462,153569,6892,4.3
Assumption,8/1/2017,8832,8165,667,7.6,160586,153503,7082,4.4
Assumption,9/1/2017,8878,8242,636,7.2,161140,154286,6854,4.3
Assumption,10/1/2017,8851,8299,552,6.2,160309,153609,6700,4.2
Assumption,11/1/2017,8859,8307,552,6.2,160579,153805,6774,4.2
Assumption,12/1/2017,8873,8315,558,6.3,160535,153904,6632,4.1
Assumption,1/1/2018,8909,8280,629,7.1,160914,154425,6489,4
Assumption,2/1/2018,8949,8355,594,6.6,161778,155197,6581,4.1
Assumption,3/1/2018,9080,8492,588,6.5,161686,155214,6472,4
Assumption,4/1/2018,8988,8426,562,6.3,161771,155312,6459,4
Assumption,5/1/2018,9001,8433,568,6.3,161848,155652,6196,3.8
Assumption,6/1/2018,9104,8410,694,7.6,162210,155762,6447,4
Assumption,7/1/2018,9004,8355,649,7.2,162341,156146,6195,3.8
Assumption,8/1/2018,8806,8209,597,6.8,161660,155504,6156,3.8
Assumption,9/1/2018,8840,8258,582,6.6,162087,156015,6073,3.7
Assumption,10/1/2018,8952,8409,543,6.1,162602,156391,6211,3.8
Assumption,11/1/2018,8946,8433,513,5.7,162836,156721,6115,3.8
Assumption,12/1/2018,8899,8348,551,6.2,163206,156817,6389,3.9
Assumption,1/1/2019,8829,8222,607,6.9,162963,156487,6475,4
Assumption,2/1/2019,8750,8237,513,5.9,162999,156863,6136,3.8
Assumption,3/1/2019,8790,8307,483,5.5,162904,156701,6202,3.8
Assumption,4/1/2019,8751,8313,438,5,162586,156625,5961,3.7
Assumption,5/1/2019,8819,8349,470,5.3,162751,156821,5930,3.6
Assumption,6/1/2019,8934,8363,571,6.4,163168,157232,5935,3.6
Assumption,7/1/2019,8947,8378,569,6.4,163590,157529,6061,3.7
Assumption,8/1/2019,8898,8349,549,6.2,163774,157829,5945,3.6
Assumption,9/1/2019,8911,8407,504,5.7,164092,158339,5753,3.5
Assumption,10/1/2019,9058,8533,525,5.8,164416,158545,5871,3.6
Assumption,11/1/2019,8966,8475,491,5.5,164496,158629,5868,3.6
Assumption,12/1/2019,8844,8371,473,5.3,164699,158845,5853,3.6
Assumption,1/1/2020,8569,8017,552,6.4,164377,158508,5869,3.6
Assumption,2/1/2020,8590,8069,521,6.1,164467,158714,5753,3.5
Assumption,3/1/2020,8876,7999,877,9.9,162559,155353,7206,4.4
Assumption,4/1/2020,8477,7203,1274,15,156269,133185,23084,14.8
Assumption,5/1/2020,8537,7322,1215,14.2,158101,137173,20929,13.2
Assumption,6/1/2020,8745,7543,1202,13.7,159994,142342,17652,11
Assumption,7/1/2020,8736,7587,1149,13.2,160132,143779,16352,10.2
Assumption,8/1/2020,8704,7747,957,11,160706,147245,13461,8.4
Assumption,9/1/2020,8811,7847,964,10.9,160174,147620,12554,7.8
Assumption,10/1/2020,8981,8124,857,9.5,161003,149931,11072,6.9
Assumption,11/1/2020,8771,8018,753,8.6,160629,149934,10694,6.7
Assumption,12/1/2020,8748,7999,749,8.6,160745,149975,10770,6.7
Assumption,1/1/2021,8879,8118,761,8.6,160088,149852,10236,6.4
Assumption,2/1/2021,8921,8176,745,8.4,160184,150189,9995,6.2
Assumption,3/1/2021,8866,8176,690,7.8,160400,150644,9756,6.1
Assumption,4/1/2021,8908,8207,701,7.9,160843,151081,9762,6.1
Assumption,5/1/2021,8861,8163,698,7.9,160800,151535,9266,5.8
Assumption,6/1/2021,8935,8140,795,8.9,161197,151734,9462,5.9
Assumption,7/1/2021,8831,8127,704,8,161504,152773,8731,5.4
Assumption,8/1/2021,8659,8055,604,7,161527,153250,8276,5.1
Assumption,9/1/2021,8787,8213,574,6.5,161495,153843,7652,4.7
Assumption,10/1/2021,8724,8246,478,5.5,161754,154475,7279,4.5
Assumption,11/1/2021,8677,8259,418,4.8,162281,155530,6751,4.2
Assumption,12/1/2021,8611,8234,377,4.4,162497,156099,6398,3.9
Assumption,1/1/2022,8598,8127,471,5.5,163627,157115,6512,4
Assumption,2/1/2022,8692,8264,428,4.9,163899,157598,6301,3.8
Assumption,3/1/2022,8737,8338,399,4.6,164220,158206,6014,3.7
Assumption,4/1/2022,8786,8418,368,4.2,163893,157891,6002,3.7
Assumption,5/1/2022,8751,8363,388,4.4,164362,158378,5983,3.6
Assumption,6/1/2022,8855,8373,482,5.4,164046,158094,5951,3.6
Assumption,7/1/2022,8793,8357,436,5,164026,158258,5768,3.5
Assumption,8/1/2022,8643,8217,426,4.9,164654,158735,5919,3.6
Assumption,9/1/2022,8705,8304,401,4.6,164602,158810,5792,3.5
Assumption,10/1/2022,8697,8345,352,4,164648,158684,5964,3.6
Assumption,11/1/2022,8657,8326,331,3.8,164450,158507,5943,3.6
Assumption,12/1/2022,8647,8304,343,4,165025,159259,5766,3.5
Assumption,1/1/2023,8630,8231,399,4.6,165964,160217,5747,3.5
Assumption,2/1/2023,8599,8216,383,4.5,166358,160395,5962,3.6
Assumption,3/1/2023,8708,8329,379,4.4,166651,160812,5839,3.5
Assumption,4/1/2023,8702,8368,334,3.8,166725,160974,5751,3.4
Assumption,5/1/2023,8732,8339,393,4.5,166886,160796,6089,3.6
Assumption,6/1/2023,8843,8409,434,4.9,166937,160979,5958,3.6
Assumption,7/1/2023,8799,8421,378,4.3,167103,161183,5920,3.5
Assumption,8/1/2023,8763,8367,396,4.5,167759,161475,6284,3.7
Assumption,9/1/2023,8809,8412,397,4.5,167767,161442,6326,3.8
Assumption,10/1/2023,8876,8494,382,4.3,167690,161211,6479,3.9
Assumption,11/1/2023,8883,8527,356,4,168140,161886,6254,3.7
Assumption,12/1/2023,8833,8453,380,4.3,167439,161124,6315,3.8
Assumption,1/1/2024,8816,8393,423,4.8,167339,161190,6149,3.7
Assumption,2/1/2024,8749,8359,390,4.5,167475,161013,6462,3.9
Assumption,3/1/2024,8789,8419,370,4.2,167922,161425,6497,3.9
Assumption,4/1/2024,8748,8428,320,3.7,167988,161495,6492,3.9
Assumption,5/1/2024,8739,8368,371,4.2,167799,161164,6635,4
Assumption,6/1/2024,8915,8459,456,5.1,168005,161155,6849,4.1
Assumption,7/1/2024,8939,8473,466,5.2,168315,161219,7097,4.2
Assumption,8/1/2024,8862,8375,487,5.5,168496,161425,7071,4.2
Assumption,9/1/2024,8914,8448,466,5.2,168703,161802,6901,4.1
Assumption,10/1/2024,8982,8526,456,5.1,168428,161456,6972,4.1
Assumption,11/1/2024,8923,8453,470,5.3,168304,161183,7121,4.2
Assumption,12/1/2024,8885,8433,452,5.1,168547,161661,6886,4.1
Assumption,1/1/2025,9263,8785,478,5.2,170744,163895,6849,4
Assumption,2/1/2025,9290,8856,434,4.7,170359,163307,7052,4.1
Avoyelles,1/1/1990,13866,12263,1603,11.6,125833,119081,6752,5.4
Avoyelles,2/1/1990,13658,12205,1453,10.6,125710,119059,6651,5.3
Avoyelles,3/1/1990,13802,12474,1328,9.6,125801,119203,6598,5.2
Avoyelles,4/1/1990,13958,12688,1270,9.1,125649,118852,6797,5.4
Avoyelles,5/1/1990,14252,12941,1311,9.2,125893,119151,6742,5.4
Avoyelles,6/1/1990,14307,12833,1474,10.3,125573,118983,6590,5.2
Avoyelles,7/1/1990,14672,13154,1518,10.3,125732,118810,6922,5.5
Avoyelles,8/1/1990,15090,13571,1519,10.1,125990,118802,7188,5.7
Avoyelles,9/1/1990,15235,13896,1339,8.8,125892,118524,7368,5.9
Avoyelles,10/1/1990,14791,13495,1296,8.8,125995,118536,7459,5.9
Avoyelles,11/1/1990,14640,13295,1345,9.2,126070,118306,7764,6.2
Avoyelles,12/1/1990,14278,12737,1541,10.8,126142,118241,7901,6.3
Avoyelles,1/1/1991,14250,11818,2432,17.1,125955,117940,8015,6.4
Avoyelles,2/1/1991,14030,11937,2093,14.9,126020,117755,8265,6.6
Avoyelles,3/1/1991,14118,12159,1959,13.9,126238,117652,8586,6.8
Avoyelles,4/1/1991,14229,12213,2016,14.2,126548,118109,8439,6.7
Avoyelles,5/1/1991,14233,12077,2156,15.1,126176,117440,8736,6.9
Avoyelles,6/1/1991,14447,12205,2242,15.5,126331,117639,8692,6.9
Avoyelles,7/1/1991,14507,12668,1839,12.7,126154,117568,8586,6.8
Avoyelles,8/1/1991,14315,12494,1821,12.7,126150,117484,8666,6.9
Avoyelles,9/1/1991,14548,13070,1478,10.2,126650,117928,8722,6.9
Avoyelles,10/1/1991,14616,13313,1303,8.9,126642,117800,8842,7
Avoyelles,11/1/1991,14506,13209,1297,8.9,126701,117770,8931,7
Avoyelles,12/1/1991,13860,12309,1551,11.2,126664,117466,9198,7.3
Avoyelles,1/1/1992,14520,12207,2313,15.9,127261,117978,9283,7.3
Avoyelles,2/1/1992,14264,12239,2025,14.2,127207,117753,9454,7.4
Avoyelles,3/1/1992,14395,12408,1987,13.8,127604,118144,9460,7.4
Avoyelles,4/1/1992,14153,12458,1695,12,127841,118426,9415,7.4
Avoyelles,5/1/1992,14058,12456,1602,11.4,128119,118375,9744,7.6
Avoyelles,6/1/1992,14673,12747,1926,13.1,128459,118419,10040,7.8
Avoyelles,7/1/1992,15017,13257,1760,11.7,128563,118713,9850,7.7
Avoyelles,8/1/1992,14648,12987,1661,11.3,128613,118826,9787,7.6
Avoyelles,9/1/1992,15148,13695,1453,9.6,128501,118720,9781,7.6
Avoyelles,10/1/1992,14940,13687,1253,8.4,128026,118628,9398,7.3
Avoyelles,11/1/1992,14822,13608,1214,8.2,128441,118876,9565,7.4
Avoyelles,12/1/1992,14073,12613,1460,10.4,128554,118997,9557,7.4
Avoyelles,1/1/1993,14316,12504,1812,12.7,128400,119075,9325,7.3
Avoyelles,2/1/1993,14107,12639,1468,10.4,128458,119275,9183,7.1
Avoyelles,3/1/1993,14137,12719,1418,10,128598,119542,9056,7
Avoyelles,4/1/1993,14370,12901,1469,10.2,128584,119474,9110,7.1
Avoyelles,5/1/1993,14410,13024,1386,9.6,129264,120115,9149,7.1
Avoyelles,6/1/1993,14882,13272,1610,10.8,129411,120290,9121,7
Avoyelles,7/1/1993,14791,13229,1562,10.6,129397,120467,8930,6.9
Avoyelles,8/1/1993,14589,13141,1448,9.9,129619,120856,8763,6.8
Avoyelles,9/1/1993,14787,13496,1291,8.7,129268,120554,8714,6.7
Avoyelles,10/1/1993,15002,13697,1305,8.7,129573,120823,8750,6.8
Avoyelles,11/1/1993,14937,13645,1292,8.6,129711,121169,8542,6.6
Avoyelles,12/1/1993,14601,13033,1568,10.7,129941,121464,8477,6.5
Avoyelles,1/1/1994,14427,12382,2045,14.2,130596,121966,8630,6.6
Avoyelles,2/1/1994,14338,12515,1823,12.7,130669,122086,8583,6.6
Avoyelles,3/1/1994,14560,12752,1808,12.4,130400,121930,8470,6.5
Avoyelles,4/1/1994,15048,13153,1895,12.6,130621,122290,8331,6.4
Avoyelles,5/1/1994,15097,13475,1622,10.7,130779,122864,7915,6.1
Avoyelles,6/1/1994,16396,14653,1743,10.6,130561,122634,7927,6.1
Avoyelles,7/1/1994,17309,15543,1766,10.2,130652,122706,7946,6.1
Avoyelles,8/1/1994,17456,15753,1703,9.8,131275,123342,7933,6
Avoyelles,9/1/1994,17346,15861,1485,8.6,131421,123687,7734,5.9
Avoyelles,10/1/1994,17344,15891,1453,8.4,131744,124112,7632,5.8
Avoyelles,11/1/1994,17145,15797,1348,7.9,131891,124516,7375,5.6
Avoyelles,12/1/1994,16666,15244,1422,8.5,131951,124721,7230,5.5
Avoyelles,1/1/1995,16529,14718,1811,11,132038,124663,7375,5.6
Avoyelles,2/1/1995,16191,14567,1624,10,132115,124928,7187,5.4
Avoyelles,3/1/1995,16315,14629,1686,10.3,132108,124955,7153,5.4
Avoyelles,4/1/1995,16262,14703,1559,9.6,132590,124945,7645,5.8
Avoyelles,5/1/1995,15803,14462,1341,8.5,131851,124421,7430,5.6
Avoyelles,6/1/1995,16350,14904,1446,8.8,131949,124522,7427,5.6
Avoyelles,7/1/1995,16286,14973,1313,8.1,132343,124816,7527,5.7
Avoyelles,8/1/1995,16169,14969,1200,7.4,132336,124852,7484,5.7
Avoyelles,9/1/1995,16232,15155,1077,6.6,132611,125133,7478,5.6
Avoyelles,10/1/1995,16198,15173,1025,6.3,132716,125388,7328,5.5
Avoyelles,11/1/1995,15832,14785,1047,6.6,132614,125188,7426,5.6
Avoyelles,12/1/1995,15523,14474,1049,6.8,132511,125088,7423,5.6
Avoyelles,1/1/1996,15735,14131,1604,10.2,132616,125125,7491,5.6
Avoyelles,2/1/1996,15672,14299,1373,8.8,132952,125639,7313,5.5
Avoyelles,3/1/1996,15823,14524,1299,8.2,133180,125862,7318,5.5
Avoyelles,4/1/1996,16071,14703,1368,8.5,133409,125994,7415,5.6
Avoyelles,5/1/1996,16073,14682,1391,8.7,133667,126244,7423,5.6
Avoyelles,6/1/1996,16600,15017,1583,9.5,133697,126602,7095,5.3
Avoyelles,7/1/1996,16383,14817,1566,9.6,134284,126947,7337,5.5
Avoyelles,8/1/1996,16462,15040,1422,8.6,134054,127172,6882,5.1
Avoyelles,9/1/1996,16492,15219,1273,7.7,134515,127536,6979,5.2
Avoyelles,10/1/1996,16148,14954,1194,7.4,134921,127890,7031,5.2
Avoyelles,11/1/1996,15884,14789,1095,6.9,135007,127771,7236,5.4
Avoyelles,12/1/1996,15493,14222,1271,8.2,135113,127860,7253,5.4
Avoyelles,1/1/1997,15766,14222,1544,9.8,135456,128298,7158,5.3
Avoyelles,2/1/1997,15722,14410,1312,8.3,135400,128298,7102,5.2
Avoyelles,3/1/1997,16462,15094,1368,8.3,135891,128891,7000,5.2
Avoyelles,4/1/1997,16312,15073,1239,7.6,136016,129143,6873,5.1
Avoyelles,5/1/1997,16290,15014,1276,7.8,136119,129464,6655,4.9
Avoyelles,6/1/1997,16782,15290,1492,8.9,136211,129412,6799,5
Avoyelles,7/1/1997,16839,15520,1319,7.8,136477,129822,6655,4.9
Avoyelles,8/1/1997,16602,15425,1177,7.1,136618,130010,6608,4.8
Avoyelles,9/1/1997,16623,15537,1086,6.5,136675,130019,6656,4.9
Avoyelles,10/1/1997,15936,14984,952,6,136633,130179,6454,4.7
Avoyelles,11/1/1997,15879,14947,932,5.9,136961,130653,6308,4.6
Avoyelles,12/1/1997,15590,14502,1088,7,137155,130679,6476,4.7
Avoyelles,1/1/1998,15747,14312,1435,9.1,137095,130726,6368,4.6
Avoyelles,2/1/1998,15592,14481,1111,7.1,137112,130807,6306,4.6
Avoyelles,3/1/1998,15871,14670,1201,7.6,137236,130814,6422,4.7
Avoyelles,4/1/1998,15725,14621,1104,7,137150,131209,5941,4.3
Avoyelles,5/1/1998,15839,14726,1113,7,137372,131325,6047,4.4
Avoyelles,6/1/1998,16156,14930,1226,7.6,137455,131244,6212,4.5
Avoyelles,7/1/1998,15907,14757,1150,7.2,137588,131329,6259,4.5
Avoyelles,8/1/1998,15862,14692,1170,7.4,137570,131390,6179,4.5
Avoyelles,9/1/1998,15913,14844,1069,6.7,138286,131986,6300,4.6
Avoyelles,10/1/1998,15768,14901,867,5.5,138279,131999,6280,4.5
Avoyelles,11/1/1998,15647,14792,855,5.5,138381,132280,6100,4.4
Avoyelles,12/1/1998,15462,14458,1004,6.5,138634,132602,6032,4.4
Avoyelles,1/1/1999,15407,14204,1203,7.8,139003,133027,5976,4.3
Avoyelles,2/1/1999,15352,14399,953,6.2,138967,132856,6111,4.4
Avoyelles,3/1/1999,15557,14689,868,5.6,138730,132947,5783,4.2
Avoyelles,4/1/1999,15646,14822,824,5.3,138959,132955,6004,4.3
Avoyelles,5/1/1999,15633,14812,821,5.3,139107,133311,5796,4.2
Avoyelles,6/1/1999,15960,14932,1028,6.4,139329,133378,5951,4.3
Avoyelles,7/1/1999,16432,15447,985,6,139439,133414,6025,4.3
Avoyelles,8/1/1999,16480,15532,948,5.8,139430,133591,5838,4.2
Avoyelles,9/1/1999,16488,15647,841,5.1,139622,133707,5915,4.2
Avoyelles,10/1/1999,16278,15519,759,4.7,139771,133993,5778,4.1
Avoyelles,11/1/1999,16017,15324,693,4.3,140025,134309,5716,4.1
Avoyelles,12/1/1999,15819,15027,792,5,140177,134523,5653,4
Avoyelles,1/1/2000,15398,14433,965,6.3,142267,136559,5708,4
Avoyelles,2/1/2000,15314,14458,856,5.6,142456,136598,5858,4.1
Avoyelles,3/1/2000,15577,14645,932,6,142434,136701,5733,4
Avoyelles,4/1/2000,15546,14746,800,5.1,142751,137270,5481,3.8
Avoyelles,5/1/2000,15517,14625,892,5.7,142388,136630,5758,4
Avoyelles,6/1/2000,15799,14685,1114,7.1,142591,136940,5651,4
Avoyelles,7/1/2000,15770,14736,1034,6.6,142278,136531,5747,4
Avoyelles,8/1/2000,15731,14712,1019,6.5,142514,136662,5853,4.1
Avoyelles,9/1/2000,15683,14711,972,6.2,142518,136893,5625,3.9
Avoyelles,10/1/2000,15886,14952,934,5.9,142622,137088,5534,3.9
Avoyelles,11/1/2000,15684,14680,1004,6.4,142962,137322,5639,3.9
Avoyelles,12/1/2000,15812,14711,1101,7,143248,137614,5634,3.9
Avoyelles,1/1/2001,15820,14494,1326,8.4,143800,137778,6023,4.2
Avoyelles,2/1/2001,15641,14582,1059,6.8,143701,137612,6089,4.2
Avoyelles,3/1/2001,15846,14685,1161,7.3,143924,137783,6141,4.3
Avoyelles,4/1/2001,15585,14524,1061,6.8,143569,137299,6271,4.4
Avoyelles,5/1/2001,15500,14440,1060,6.8,143318,137092,6226,4.3
Avoyelles,6/1/2001,15865,14549,1316,8.3,143357,136873,6484,4.5
Avoyelles,7/1/2001,15874,14768,1106,7,143654,137071,6583,4.6
Avoyelles,8/1/2001,15806,14668,1138,7.2,143284,136241,7042,4.9
Avoyelles,9/1/2001,15856,14784,1072,6.8,143989,136846,7142,5
Avoyelles,10/1/2001,16017,14962,1055,6.6,144086,136392,7694,5.3
Avoyelles,11/1/2001,15750,14687,1063,6.7,144240,136238,8003,5.5
Avoyelles,12/1/2001,15744,14596,1148,7.3,144305,136047,8258,5.7
Avoyelles,1/1/2002,15598,14345,1253,8,143883,135701,8182,5.7
Avoyelles,2/1/2002,15563,14473,1090,7,144653,136438,8215,5.7
Avoyelles,3/1/2002,15687,14597,1090,6.9,144481,136177,8304,5.7
Avoyelles,4/1/2002,15488,14417,1071,6.9,144725,136126,8599,5.9
Avoyelles,5/1/2002,15457,14406,1051,6.8,144938,136539,8399,5.8
Avoyelles,6/1/2002,15849,14567,1282,8.1,144808,136415,8393,5.8
Avoyelles,7/1/2002,15970,14830,1140,7.1,144803,136413,8390,5.8
Avoyelles,8/1/2002,15993,14875,1118,7,145009,136705,8304,5.7
Avoyelles,9/1/2002,15978,14921,1057,6.6,145552,137302,8251,5.7
Avoyelles,10/1/2002,16090,15064,1026,6.4,145314,137008,8307,5.7
Avoyelles,11/1/2002,15912,14849,1063,6.7,145041,136521,8520,5.9
Avoyelles,12/1/2002,15876,14729,1147,7.2,145066,136426,8640,6
Avoyelles,1/1/2003,15859,14559,1300,8.2,145937,137417,8520,5.8
Avoyelles,2/1/2003,15793,14617,1176,7.4,146100,137482,8618,5.9
Avoyelles,3/1/2003,15964,14703,1261,7.9,146022,137434,8588,5.9
Avoyelles,4/1/2003,15817,14640,1177,7.4,146474,137633,8842,6
Avoyelles,5/1/2003,15831,14614,1217,7.7,146500,137544,8957,6.1
Avoyelles,6/1/2003,16382,14704,1678,10.2,147056,137790,9266,6.3
Avoyelles,7/1/2003,15978,14442,1536,9.6,146485,137474,9011,6.2
Avoyelles,8/1/2003,15911,14499,1412,8.9,146445,137549,8896,6.1
Avoyelles,9/1/2003,16041,14629,1412,8.8,146530,137609,8921,6.1
Avoyelles,10/1/2003,15864,14555,1309,8.3,146716,137984,8732,6
Avoyelles,11/1/2003,15655,14439,1216,7.8,147000,138424,8576,5.8
Avoyelles,12/1/2003,15319,14094,1225,8,146729,138411,8317,5.7
Avoyelles,1/1/2004,15545,14081,1464,9.4,146842,138472,8370,5.7
Avoyelles,2/1/2004,15374,14119,1255,8.2,146709,138542,8167,5.6
Avoyelles,3/1/2004,15404,14104,1300,8.4,146944,138453,8491,5.8
Avoyelles,4/1/2004,15705,14516,1189,7.6,146850,138680,8170,5.6
Avoyelles,5/1/2004,15656,14459,1197,7.6,147065,138852,8212,5.6
Avoyelles,6/1/2004,15833,14398,1435,9.1,147460,139174,8286,5.6
Avoyelles,7/1/2004,15924,14599,1325,8.3,147692,139556,8136,5.5
Avoyelles,8/1/2004,15769,14577,1192,7.6,147564,139573,7990,5.4
Avoyelles,9/1/2004,15726,14607,1119,7.1,147415,139487,7927,5.4
Avoyelles,10/1/2004,15897,14840,1057,6.6,147793,139732,8061,5.5
Avoyelles,11/1/2004,15667,14644,1023,6.5,148162,140231,7932,5.4
Avoyelles,12/1/2004,15534,14490,1044,6.7,148059,140125,7934,5.4
Avoyelles,1/1/2005,15449,14247,1202,7.8,148029,140245,7784,5.3
Avoyelles,2/1/2005,15197,14134,1063,7,148364,140385,7980,5.4
Avoyelles,3/1/2005,15245,14241,1004,6.6,148391,140654,7737,5.2
Avoyelles,4/1/2005,15467,14477,990,6.4,148926,141254,7672,5.2
Avoyelles,5/1/2005,15373,14360,1013,6.6,149261,141609,7651,5.1
Avoyelles,6/1/2005,15856,14581,1275,8,149238,141714,7524,5
Avoyelles,7/1/2005,15741,14577,1164,7.4,149432,142026,7406,5
Avoyelles,8/1/2005,15515,14472,1043,6.7,149779,142434,7345,4.9
Avoyelles,9/1/2005,17713,15451,2262,12.8,149954,142401,7553,5
Avoyelles,10/1/2005,18073,16100,1973,10.9,150001,142548,7453,5
Avoyelles,11/1/2005,17853,15916,1937,10.8,150065,142499,7566,5
Avoyelles,12/1/2005,16750,15724,1026,6.1,150030,142752,7279,4.9
Avoyelles,1/1/2006,16189,15316,873,5.4,150214,143150,7064,4.7
Avoyelles,2/1/2006,15989,15310,679,4.2,150641,143457,7184,4.8
Avoyelles,3/1/2006,16113,15430,683,4.2,150813,143741,7072,4.7
Avoyelles,4/1/2006,16149,15475,674,4.2,150881,143761,7120,4.7
Avoyelles,5/1/2006,16065,15328,737,4.6,151069,144089,6980,4.6
Avoyelles,6/1/2006,16348,15410,938,5.7,151354,144353,7001,4.6
Avoyelles,7/1/2006,16415,15604,811,4.9,151377,144202,7175,4.7
Avoyelles,8/1/2006,16156,15373,783,4.8,151716,144625,7091,4.7
Avoyelles,9/1/2006,16374,15627,747,4.6,151662,144815,6847,4.5
Avoyelles,10/1/2006,16235,15517,718,4.4,152041,145314,6727,4.4
Avoyelles,11/1/2006,16052,15313,739,4.6,152406,145534,6872,4.5
Avoyelles,12/1/2006,15923,15196,727,4.6,152732,145970,6762,4.4
Avoyelles,1/1/2007,15843,14962,881,5.6,153144,146028,7116,4.6
Avoyelles,2/1/2007,15710,14968,742,4.7,152983,146057,6927,4.5
Avoyelles,3/1/2007,15932,15219,713,4.5,153051,146320,6731,4.4
Avoyelles,4/1/2007,16096,15365,731,4.5,152435,145586,6850,4.5
Avoyelles,5/1/2007,15950,15160,790,5,152670,145903,6766,4.4
Avoyelles,6/1/2007,16210,15231,979,6,153041,146063,6979,4.6
Avoyelles,7/1/2007,16036,15087,949,5.9,153054,145905,7149,4.7
Avoyelles,8/1/2007,15942,15085,857,5.4,152749,145682,7067,4.6
Avoyelles,9/1/2007,16344,15570,774,4.7,153414,146244,7170,4.7
Avoyelles,10/1/2007,16125,15477,648,4,153183,145946,7237,4.7
Avoyelles,11/1/2007,16136,15440,696,4.3,153835,146595,7240,4.7
Avoyelles,12/1/2007,16178,15410,768,4.7,153918,146273,7645,5
Avoyelles,1/1/2008,16245,15337,908,5.6,154063,146378,7685,5
Avoyelles,2/1/2008,16128,15371,757,4.7,153653,146156,7497,4.9
Avoyelles,3/1/2008,16377,15558,819,5,153908,146086,7822,5.1
Avoyelles,4/1/2008,16344,15622,722,4.4,153769,146132,7637,5
Avoyelles,5/1/2008,16336,15518,818,5,154303,145908,8395,5.4
Avoyelles,6/1/2008,16627,15553,1074,6.5,154313,145737,8575,5.6
Avoyelles,7/1/2008,16719,15634,1085,6.5,154469,145532,8937,5.8
Avoyelles,8/1/2008,16626,15545,1081,6.5,154641,145203,9438,6.1
Avoyelles,9/1/2008,16519,15567,952,5.8,154570,145076,9494,6.1
Avoyelles,10/1/2008,16463,15478,985,6,154876,144802,10074,6.5
Avoyelles,11/1/2008,16403,15423,980,6,154639,144100,10538,6.8
Avoyelles,12/1/2008,16127,15067,1060,6.6,154655,143369,11286,7.3
Avoyelles,1/1/2009,16108,14906,1202,7.5,154210,142152,12058,7.8
Avoyelles,2/1/2009,16116,14980,1136,7,154538,141640,12898,8.3
Avoyelles,3/1/2009,16214,15098,1116,6.9,154133,140707,13426,8.7
Avoyelles,4/1/2009,16473,15346,1127,6.8,154509,140656,13853,9
Avoyelles,5/1/2009,16502,15309,1193,7.2,154747,140248,14499,9.4
Avoyelles,6/1/2009,16932,15510,1422,8.4,154716,140009,14707,9.5
Avoyelles,7/1/2009,17042,15734,1308,7.7,154502,139901,14601,9.5
Avoyelles,8/1/2009,16767,15498,1269,7.6,154307,139492,14814,9.6
Avoyelles,9/1/2009,16765,15540,1225,7.3,153827,138818,15009,9.8
Avoyelles,10/1/2009,16647,15441,1206,7.2,153784,138432,15352,10
Avoyelles,11/1/2009,16581,15424,1157,7,153878,138659,15219,9.9
Avoyelles,12/1/2009,16363,15129,1234,7.5,153111,138013,15098,9.9
Avoyelles,1/1/2010,16422,15088,1334,8.1,153484,138438,15046,9.8
Avoyelles,2/1/2010,16564,15362,1202,7.3,153694,138581,15113,9.8
Avoyelles,3/1/2010,16723,15514,1209,7.2,153954,138751,15202,9.9
Avoyelles,4/1/2010,17102,15926,1176,6.9,154622,139297,15325,9.9
Avoyelles,5/1/2010,17073,15804,1269,7.4,154091,139241,14849,9.6
Avoyelles,6/1/2010,17301,15866,1435,8.3,153616,139141,14474,9.4
Avoyelles,7/1/2010,17270,15792,1478,8.6,153691,139179,14512,9.4
Avoyelles,8/1/2010,17098,15640,1458,8.5,154086,139438,14648,9.5
Avoyelles,9/1/2010,16919,15550,1369,8.1,153975,139396,14579,9.5
Avoyelles,10/1/2010,16899,15583,1316,7.8,153635,139119,14516,9.4
Avoyelles,11/1/2010,16762,15452,1310,7.8,154125,139044,15081,9.8
Avoyelles,12/1/2010,16592,15262,1330,8,153650,139301,14348,9.3
Avoyelles,1/1/2011,16323,14851,1472,9,153263,139250,14013,9.1
Avoyelles,2/1/2011,16320,15010,1310,8,153214,139394,13820,9
Avoyelles,3/1/2011,16433,15129,1304,7.9,153376,139639,13737,9
Avoyelles,4/1/2011,16929,15684,1245,7.4,153543,139586,13957,9.1
Avoyelles,5/1/2011,16892,15575,1317,7.8,153479,139624,13855,9
Avoyelles,6/1/2011,17166,15658,1508,8.8,153346,139384,13962,9.1
Avoyelles,7/1/2011,16970,15554,1416,8.3,153288,139524,13763,9
Avoyelles,8/1/2011,16916,15580,1336,7.9,153760,139942,13818,9
Avoyelles,9/1/2011,16708,15413,1295,7.8,154131,140183,13948,9
Avoyelles,10/1/2011,16715,15492,1223,7.3,153961,140368,13594,8.8
Avoyelles,11/1/2011,16687,15503,1184,7.1,154128,140826,13302,8.6
Avoyelles,12/1/2011,16545,15331,1214,7.3,153995,140902,13093,8.5
Avoyelles,1/1/2012,16047,14693,1354,8.4,154381,141584,12797,8.3
Avoyelles,2/1/2012,16115,14886,1229,7.6,154671,141858,12813,8.3
Avoyelles,3/1/2012,16062,14894,1168,7.3,154749,142036,12713,8.2
Avoyelles,4/1/2012,16414,15313,1101,6.7,154545,141899,12646,8.2
Avoyelles,5/1/2012,16479,15301,1178,7.1,154866,142206,12660,8.2
Avoyelles,6/1/2012,16814,15413,1401,8.3,155083,142391,12692,8.2
Avoyelles,7/1/2012,17034,15672,1362,8,154948,142292,12656,8.2
Avoyelles,8/1/2012,16595,15407,1188,7.2,154763,142291,12471,8.1
Avoyelles,9/1/2012,16451,15387,1064,6.5,155160,143044,12115,7.8
Avoyelles,10/1/2012,16625,15579,1046,6.3,155554,143431,12124,7.8
Avoyelles,11/1/2012,16419,15455,964,5.9,155338,143333,12005,7.7
Avoyelles,12/1/2012,16429,15316,1113,6.8,155628,143330,12298,7.9
Avoyelles,1/1/2013,15870,14579,1291,8.1,155763,143292,12471,8
Avoyelles,2/1/2013,15852,14724,1128,7.1,155312,143362,11950,7.7
Avoyelles,3/1/2013,15802,14714,1088,6.9,155005,143316,11689,7.5
Avoyelles,4/1/2013,16005,14939,1066,6.7,155394,143635,11760,7.6
Avoyelles,5/1/2013,16138,14974,1164,7.2,155536,143882,11654,7.5
Avoyelles,6/1/2013,16348,14961,1387,8.5,155749,143999,11751,7.5
Avoyelles,7/1/2013,16617,15344,1273,7.7,155599,144264,11335,7.3
Avoyelles,8/1/2013,16162,14974,1188,7.4,155605,144326,11279,7.2
Avoyelles,9/1/2013,16036,14924,1112,6.9,155687,144418,11270,7.2
Avoyelles,10/1/2013,15728,14678,1050,6.7,154673,143537,11136,7.2
Avoyelles,11/1/2013,15726,14734,992,6.3,155265,144479,10787,6.9
Avoyelles,12/1/2013,15710,14762,948,6,155182,144778,10404,6.7
Avoyelles,1/1/2014,15599,14597,1002,6.4,155352,145150,10202,6.6
Avoyelles,2/1/2014,15628,14688,940,6,155483,145134,10349,6.7
Avoyelles,3/1/2014,15810,14843,967,6.1,156028,145648,10380,6.7
Avoyelles,4/1/2014,15863,14957,906,5.7,155369,145667,9702,6.2
Avoyelles,5/1/2014,15819,14773,1046,6.6,155684,145825,9859,6.3
Avoyelles,6/1/2014,16201,14933,1268,7.8,155707,146247,9460,6.1
Avoyelles,7/1/2014,16430,15099,1331,8.1,156007,146399,9608,6.2
Avoyelles,8/1/2014,16317,15018,1299,8,156130,146530,9599,6.1
Avoyelles,9/1/2014,16232,15017,1215,7.5,156040,146778,9262,5.9
Avoyelles,10/1/2014,16229,15057,1172,7.2,156417,147427,8990,5.7
Avoyelles,11/1/2014,16207,14958,1249,7.7,156494,147404,9090,5.8
Avoyelles,12/1/2014,16174,14954,1220,7.5,156332,147615,8717,5.6
Avoyelles,1/1/2015,16139,14824,1315,8.1,157030,148145,8885,5.7
Avoyelles,2/1/2015,16121,14928,1193,7.4,156644,148045,8599,5.5
Avoyelles,3/1/2015,16018,14824,1194,7.5,156643,148128,8515,5.4
Avoyelles,4/1/2015,15864,14712,1152,7.3,157060,148511,8550,5.4
Avoyelles,5/1/2015,16083,14844,1239,7.7,157651,148817,8834,5.6
Avoyelles,6/1/2015,16284,14934,1350,8.3,157062,148816,8247,5.3
Avoyelles,7/1/2015,16008,14712,1296,8.1,156997,148830,8167,5.2
Avoyelles,8/1/2015,15846,14653,1193,7.5,157172,149181,7992,5.1
Avoyelles,9/1/2015,15660,14548,1112,7.1,156733,148826,7907,5
Avoyelles,10/1/2015,15465,14420,1045,6.8,157167,149246,7922,5
Avoyelles,11/1/2015,15516,14468,1048,6.8,157463,149463,8000,5.1
Avoyelles,12/1/2015,15551,14516,1035,6.7,158035,150128,7907,5
Avoyelles,1/1/2016,15538,14401,1137,7.3,158280,150653,7627,4.8
Avoyelles,2/1/2016,15513,14487,1026,6.6,158640,150939,7702,4.9
Avoyelles,3/1/2016,15775,14689,1086,6.9,159179,151218,7961,5
Avoyelles,4/1/2016,15745,14696,1049,6.7,159141,151074,8067,5.1
Avoyelles,5/1/2016,15879,14794,1085,6.8,158784,151132,7652,4.8
Avoyelles,6/1/2016,16246,14956,1290,7.9,158967,151223,7744,4.9
Avoyelles,7/1/2016,15995,14730,1265,7.9,159194,151554,7641,4.8
Avoyelles,8/1/2016,15792,14619,1173,7.4,159562,151779,7784,4.9
Avoyelles,9/1/2016,15571,14447,1124,7.2,159714,151761,7953,5
Avoyelles,10/1/2016,15414,14406,1008,6.5,159605,151793,7811,4.9
Avoyelles,11/1/2016,15368,14411,957,6.2,159506,151954,7553,4.7
Avoyelles,12/1/2016,15298,14264,1034,6.8,159678,152157,7521,4.7
Avoyelles,1/1/2017,15793,14673,1120,7.1,159620,152152,7468,4.7
Avoyelles,2/1/2017,15613,14609,1004,6.4,159859,152480,7379,4.6
Avoyelles,3/1/2017,15933,14962,971,6.1,160137,153065,7073,4.4
Avoyelles,4/1/2017,15880,14936,944,5.9,160345,153255,7089,4.4
Avoyelles,5/1/2017,15765,14845,920,5.8,160068,153069,7000,4.4
Avoyelles,6/1/2017,15927,14793,1134,7.1,160192,153318,6873,4.3
Avoyelles,7/1/2017,15809,14713,1096,6.9,160462,153569,6892,4.3
Avoyelles,8/1/2017,15568,14525,1043,6.7,160586,153503,7082,4.4
Avoyelles,9/1/2017,15402,14499,903,5.9,161140,154286,6854,4.3
Avoyelles,10/1/2017,15208,14444,764,5,160309,153609,6700,4.2
Avoyelles,11/1/2017,15149,14364,785,5.2,160579,153805,6774,4.2
Avoyelles,12/1/2017,15102,14335,767,5.1,160535,153904,6632,4.1
Avoyelles,1/1/2018,15245,14373,872,5.7,160914,154425,6489,4
Avoyelles,2/1/2018,15234,14439,795,5.2,161778,155197,6581,4.1
Avoyelles,3/1/2018,15449,14624,825,5.3,161686,155214,6472,4
Avoyelles,4/1/2018,15425,14613,812,5.3,161771,155312,6459,4
Avoyelles,5/1/2018,15420,14593,827,5.4,161848,155652,6196,3.8
Avoyelles,6/1/2018,15688,14578,1110,7.1,162210,155762,6447,4
Avoyelles,7/1/2018,15654,14639,1015,6.5,162341,156146,6195,3.8
Avoyelles,8/1/2018,15363,14439,924,6,161660,155504,6156,3.8
Avoyelles,9/1/2018,15045,14219,826,5.5,162087,156015,6073,3.7
Avoyelles,10/1/2018,15060,14276,784,5.2,162602,156391,6211,3.8
Avoyelles,11/1/2018,15015,14273,742,4.9,162836,156721,6115,3.8
Avoyelles,12/1/2018,14975,14189,786,5.2,163206,156817,6389,3.9
Avoyelles,1/1/2019,14948,14032,916,6.1,162963,156487,6475,4
Avoyelles,2/1/2019,14928,14184,744,5,162999,156863,6136,3.8
Avoyelles,3/1/2019,15074,14376,698,4.6,162904,156701,6202,3.8
Avoyelles,4/1/2019,15092,14445,647,4.3,162586,156625,5961,3.7
Avoyelles,5/1/2019,15116,14383,733,4.8,162751,156821,5930,3.6
Avoyelles,6/1/2019,15353,14349,1004,6.5,163168,157232,5935,3.6
Avoyelles,7/1/2019,15335,14304,1031,6.7,163590,157529,6061,3.7
Avoyelles,8/1/2019,15398,14403,995,6.5,163774,157829,5945,3.6
Avoyelles,9/1/2019,15315,14478,837,5.5,164092,158339,5753,3.5
Avoyelles,10/1/2019,15184,14326,858,5.7,164416,158545,5871,3.6
Avoyelles,11/1/2019,15022,14181,841,5.6,164496,158629,5868,3.6
Avoyelles,12/1/2019,15003,14158,845,5.6,164699,158845,5853,3.6
Avoyelles,1/1/2020,14870,13964,906,6.1,164377,158508,5869,3.6
Avoyelles,2/1/2020,14762,14053,709,4.8,164467,158714,5753,3.5
Avoyelles,3/1/2020,15180,13928,1252,8.2,162559,155353,7206,4.4
Avoyelles,4/1/2020,14168,12322,1846,13,156269,133185,23084,14.8
Avoyelles,5/1/2020,14754,12971,1783,12.1,158101,137173,20929,13.2
Avoyelles,6/1/2020,14956,13426,1530,10.2,159994,142342,17652,11
Avoyelles,7/1/2020,14942,13482,1460,9.8,160132,143779,16352,10.2
Avoyelles,8/1/2020,14893,13632,1261,8.5,160706,147245,13461,8.4
Avoyelles,9/1/2020,14852,13621,1231,8.3,160174,147620,12554,7.8
Avoyelles,10/1/2020,15099,14045,1054,7,161003,149931,11072,6.9
Avoyelles,11/1/2020,14712,13757,955,6.5,160629,149934,10694,6.7
Avoyelles,12/1/2020,14735,13749,986,6.7,160745,149975,10770,6.7
Avoyelles,1/1/2021,14599,13574,1025,7,160088,149852,10236,6.4
Avoyelles,2/1/2021,14508,13593,915,6.3,160184,150189,9995,6.2
Avoyelles,3/1/2021,14717,13855,862,5.9,160400,150644,9756,6.1
Avoyelles,4/1/2021,14889,14058,831,5.6,160843,151081,9762,6.1
Avoyelles,5/1/2021,14752,13901,851,5.8,160800,151535,9266,5.8
Avoyelles,6/1/2021,14955,13965,990,6.6,161197,151734,9462,5.9
Avoyelles,7/1/2021,14798,13877,921,6.2,161504,152773,8731,5.4
Avoyelles,8/1/2021,14546,13731,815,5.6,161527,153250,8276,5.1
Avoyelles,9/1/2021,14792,14110,682,4.6,161495,153843,7652,4.7
Avoyelles,10/1/2021,14326,13730,596,4.2,161754,154475,7279,4.5
Avoyelles,11/1/2021,14184,13650,534,3.8,162281,155530,6751,4.2
Avoyelles,12/1/2021,14138,13632,506,3.6,162497,156099,6398,3.9
Avoyelles,1/1/2022,14195,13564,631,4.4,163627,157115,6512,4
Avoyelles,2/1/2022,14241,13682,559,3.9,163899,157598,6301,3.8
Avoyelles,3/1/2022,14367,13833,534,3.7,164220,158206,6014,3.7
Avoyelles,4/1/2022,14427,13912,515,3.6,163893,157891,6002,3.7
Avoyelles,5/1/2022,14455,13889,566,3.9,164362,158378,5983,3.6
Avoyelles,6/1/2022,14731,13934,797,5.4,164046,158094,5951,3.6
Avoyelles,7/1/2022,14617,13876,741,5.1,164026,158258,5768,3.5
Avoyelles,8/1/2022,14275,13588,687,4.8,164654,158735,5919,3.6
Avoyelles,9/1/2022,14299,13729,570,4,164602,158810,5792,3.5
Avoyelles,10/1/2022,14108,13598,510,3.6,164648,158684,5964,3.6
Avoyelles,11/1/2022,14041,13536,505,3.6,164450,158507,5943,3.6
Avoyelles,12/1/2022,14158,13627,531,3.8,165025,159259,5766,3.5
Avoyelles,1/1/2023,14123,13513,610,4.3,165964,160217,5747,3.5
Avoyelles,2/1/2023,14121,13555,566,4,166358,160395,5962,3.6
Avoyelles,3/1/2023,14295,13754,541,3.8,166651,160812,5839,3.5
Avoyelles,4/1/2023,14425,13927,498,3.5,166725,160974,5751,3.4
Avoyelles,5/1/2023,14433,13843,590,4.1,166886,160796,6089,3.6
Avoyelles,6/1/2023,14849,14092,757,5.1,166937,160979,5958,3.6
Avoyelles,7/1/2023,14642,13982,660,4.5,167103,161183,5920,3.5
Avoyelles,8/1/2023,14550,13883,667,4.6,167759,161475,6284,3.7
Avoyelles,9/1/2023,14549,13911,638,4.4,167767,161442,6326,3.8
Avoyelles,10/1/2023,14499,13873,626,4.3,167690,161211,6479,3.9
Avoyelles,11/1/2023,14464,13869,595,4.1,168140,161886,6254,3.7
Avoyelles,12/1/2023,14448,13802,646,4.5,167439,161124,6315,3.8
Avoyelles,1/1/2024,14412,13680,732,5.1,167339,161190,6149,3.7
Avoyelles,2/1/2024,14271,13614,657,4.6,167475,161013,6462,3.9
Avoyelles,3/1/2024,14290,13642,648,4.5,167922,161425,6497,3.9
Avoyelles,4/1/2024,14344,13746,598,4.2,167988,161495,6492,3.9
Avoyelles,5/1/2024,14255,13633,622,4.4,167799,161164,6635,4
Avoyelles,6/1/2024,14809,13948,861,5.8,168005,161155,6849,4.1
Avoyelles,7/1/2024,14755,13930,825,5.6,168315,161219,7097,4.2
Avoyelles,8/1/2024,14543,13792,751,5.2,168496,161425,7071,4.2
Avoyelles,9/1/2024,14626,13914,712,4.9,168703,161802,6901,4.1
Avoyelles,10/1/2024,14544,13818,726,5,168428,161456,6972,4.1
Avoyelles,11/1/2024,14362,13652,710,4.9,168304,161183,7121,4.2
Avoyelles,12/1/2024,14332,13662,670,4.7,168547,161661,6886,4.1
Avoyelles,1/1/2025,14150,13452,698,4.9,170744,163895,6849,4
Avoyelles,2/1/2025,14057,13408,649,4.6,170359,163307,7052,4.1
Beauregard,1/1/1990,11144,10487,657,5.9,125833,119081,6752,5.4
Beauregard,2/1/1990,11041,10419,622,5.6,125710,119059,6651,5.3
Beauregard,3/1/1990,11269,10641,628,5.6,125801,119203,6598,5.2
Beauregard,4/1/1990,12277,11650,627,5.1,125649,118852,6797,5.4
Beauregard,5/1/1990,11685,10995,690,5.9,125893,119151,6742,5.4
Beauregard,6/1/1990,11524,10714,810,7,125573,118983,6590,5.2
Beauregard,7/1/1990,11709,10954,755,6.4,125732,118810,6922,5.5
Beauregard,8/1/1990,11559,10783,776,6.7,125990,118802,7188,5.7
Beauregard,9/1/1990,11632,10816,816,7,125892,118524,7368,5.9
Beauregard,10/1/1990,11237,10474,763,6.8,125995,118536,7459,5.9
Beauregard,11/1/1990,11246,10470,776,6.9,126070,118306,7764,6.2
Beauregard,12/1/1990,11227,10475,752,6.7,126142,118241,7901,6.3
Beauregard,1/1/1991,11074,10260,814,7.4,125955,117940,8015,6.4
Beauregard,2/1/1991,11061,10269,792,7.2,126020,117755,8265,6.6
Beauregard,3/1/1991,10937,10225,712,6.5,126238,117652,8586,6.8
Beauregard,4/1/1991,11040,10295,745,6.7,126548,118109,8439,6.7
Beauregard,5/1/1991,11004,10207,797,7.2,126176,117440,8736,6.9
Beauregard,6/1/1991,11127,10245,882,7.9,126331,117639,8692,6.9
Beauregard,7/1/1991,11768,10867,901,7.7,126154,117568,8586,6.8
Beauregard,8/1/1991,11650,10707,943,8.1,126150,117484,8666,6.9
Beauregard,9/1/1991,11528,10614,914,7.9,126650,117928,8722,6.9
Beauregard,10/1/1991,11625,10755,870,7.5,126642,117800,8842,7
Beauregard,11/1/1991,11619,10841,778,6.7,126701,117770,8931,7
Beauregard,12/1/1991,11567,10783,784,6.8,126664,117466,9198,7.3
Beauregard,1/1/1992,11935,10900,1035,8.7,127261,117978,9283,7.3
Beauregard,2/1/1992,11793,10796,997,8.5,127207,117753,9454,7.4
Beauregard,3/1/1992,11894,10852,1042,8.8,127604,118144,9460,7.4
Beauregard,4/1/1992,11941,10897,1044,8.7,127841,118426,9415,7.4
Beauregard,5/1/1992,11984,10882,1102,9.2,128119,118375,9744,7.6
Beauregard,6/1/1992,12508,11171,1337,10.7,128459,118419,10040,7.8
Beauregard,7/1/1992,12502,11407,1095,8.8,128563,118713,9850,7.7
Beauregard,8/1/1992,12273,11228,1045,8.5,128613,118826,9787,7.6
Beauregard,9/1/1992,12341,11311,1030,8.3,128501,118720,9781,7.6
Beauregard,10/1/1992,12343,11319,1024,8.3,128026,118628,9398,7.3
Beauregard,11/1/1992,12250,11299,951,7.8,128441,118876,9565,7.4
Beauregard,12/1/1992,11986,11082,904,7.5,128554,118997,9557,7.4
Beauregard,1/1/1993,12375,11278,1097,8.9,128400,119075,9325,7.3
Beauregard,2/1/1993,12291,11277,1014,8.2,128458,119275,9183,7.1
Beauregard,3/1/1993,12305,11322,983,8,128598,119542,9056,7
Beauregard,4/1/1993,12363,11421,942,7.6,128584,119474,9110,7.1
Beauregard,5/1/1993,13066,12177,889,6.8,129264,120115,9149,7.1
Beauregard,6/1/1993,12817,11676,1141,8.9,129411,120290,9121,7
Beauregard,7/1/1993,12544,11554,990,7.9,129397,120467,8930,6.9
Beauregard,8/1/1993,12398,11443,955,7.7,129619,120856,8763,6.8
Beauregard,9/1/1993,12444,11526,918,7.4,129268,120554,8714,6.7
Beauregard,10/1/1993,12760,11751,1009,7.9,129573,120823,8750,6.8
Beauregard,11/1/1993,12718,11754,964,7.6,129711,121169,8542,6.6
Beauregard,12/1/1993,12596,11687,909,7.2,129941,121464,8477,6.5
Beauregard,1/1/1994,12662,11553,1109,8.8,130596,121966,8630,6.6
Beauregard,2/1/1994,12700,11610,1090,8.6,130669,122086,8583,6.6
Beauregard,3/1/1994,12705,11577,1128,8.9,130400,121930,8470,6.5
Beauregard,4/1/1994,12699,11521,1178,9.3,130621,122290,8331,6.4
Beauregard,5/1/1994,12946,11796,1150,8.9,130779,122864,7915,6.1
Beauregard,6/1/1994,13093,11869,1224,9.3,130561,122634,7927,6.1
Beauregard,7/1/1994,13079,11970,1109,8.5,130652,122706,7946,6.1
Beauregard,8/1/1994,13187,12055,1132,8.6,131275,123342,7933,6
Beauregard,9/1/1994,13248,12174,1074,8.1,131421,123687,7734,5.9
Beauregard,10/1/1994,13122,12053,1069,8.1,131744,124112,7632,5.8
Beauregard,11/1/1994,13026,12050,976,7.5,131891,124516,7375,5.6
Beauregard,12/1/1994,12589,11729,860,6.8,131951,124721,7230,5.5
Beauregard,1/1/1995,12641,11671,970,7.7,132038,124663,7375,5.6
Beauregard,2/1/1995,12722,11846,876,6.9,132115,124928,7187,5.4
Beauregard,3/1/1995,12777,11918,859,6.7,132108,124955,7153,5.4
Beauregard,4/1/1995,12794,11827,967,7.6,132590,124945,7645,5.8
Beauregard,5/1/1995,12640,11776,864,6.8,131851,124421,7430,5.6
Beauregard,6/1/1995,12866,11898,968,7.5,131949,124522,7427,5.6
Beauregard,7/1/1995,12853,11924,929,7.2,132343,124816,7527,5.7
Beauregard,8/1/1995,12612,11704,908,7.2,132336,124852,7484,5.7
Beauregard,9/1/1995,12688,11776,912,7.2,132611,125133,7478,5.6
Beauregard,10/1/1995,12312,11536,776,6.3,132716,125388,7328,5.5
Beauregard,11/1/1995,12147,11364,783,6.4,132614,125188,7426,5.6
Beauregard,12/1/1995,12195,11385,810,6.6,132511,125088,7423,5.6
Beauregard,1/1/1996,12303,11398,905,7.4,132616,125125,7491,5.6
Beauregard,2/1/1996,12110,11394,716,5.9,132952,125639,7313,5.5
Beauregard,3/1/1996,12238,11524,714,5.8,133180,125862,7318,5.5
Beauregard,4/1/1996,12461,11617,844,6.8,133409,125994,7415,5.6
Beauregard,5/1/1996,12542,11539,1003,8,133667,126244,7423,5.6
Beauregard,6/1/1996,12743,11681,1062,8.3,133697,126602,7095,5.3
Beauregard,7/1/1996,12883,11983,900,7,134284,126947,7337,5.5
Beauregard,8/1/1996,12767,11882,885,6.9,134054,127172,6882,5.1
Beauregard,9/1/1996,13014,12077,937,7.2,134515,127536,6979,5.2
Beauregard,10/1/1996,12928,11931,997,7.7,134921,127890,7031,5.2
Beauregard,11/1/1996,12698,11770,928,7.3,135007,127771,7236,5.4
Beauregard,12/1/1996,12560,11633,927,7.4,135113,127860,7253,5.4
Beauregard,1/1/1997,12484,11555,929,7.4,135456,128298,7158,5.3
Beauregard,2/1/1997,12341,11522,819,6.6,135400,128298,7102,5.2
Beauregard,3/1/1997,12482,11591,891,7.1,135891,128891,7000,5.2
Beauregard,4/1/1997,12480,11632,848,6.8,136016,129143,6873,5.1
Beauregard,5/1/1997,12347,11543,804,6.5,136119,129464,6655,4.9
Beauregard,6/1/1997,12382,11426,956,7.7,136211,129412,6799,5
Beauregard,7/1/1997,12181,11318,863,7.1,136477,129822,6655,4.9
Beauregard,8/1/1997,12171,11394,777,6.4,136618,130010,6608,4.8
Beauregard,9/1/1997,12084,11239,845,7,136675,130019,6656,4.9
Beauregard,10/1/1997,12087,11304,783,6.5,136633,130179,6454,4.7
Beauregard,11/1/1997,11827,11096,731,6.2,136961,130653,6308,4.6
Beauregard,12/1/1997,11814,11105,709,6,137155,130679,6476,4.7
Beauregard,1/1/1998,11980,11128,852,7.1,137095,130726,6368,4.6
Beauregard,2/1/1998,11769,11100,669,5.7,137112,130807,6306,4.6
Beauregard,3/1/1998,12016,11277,739,6.2,137236,130814,6422,4.7
Beauregard,4/1/1998,12174,11313,861,7.1,137150,131209,5941,4.3
Beauregard,5/1/1998,12007,11287,720,6,137372,131325,6047,4.4
Beauregard,6/1/1998,12181,11285,896,7.4,137455,131244,6212,4.5
Beauregard,7/1/1998,12129,11240,889,7.3,137588,131329,6259,4.5
Beauregard,8/1/1998,11986,11082,904,7.5,137570,131390,6179,4.5
Beauregard,9/1/1998,12112,11185,927,7.7,138286,131986,6300,4.6
Beauregard,10/1/1998,12220,11329,891,7.3,138279,131999,6280,4.5
Beauregard,11/1/1998,12102,11310,792,6.5,138381,132280,6100,4.4
Beauregard,12/1/1998,12100,11354,746,6.2,138634,132602,6032,4.4
Beauregard,1/1/1999,12548,11628,920,7.3,139003,133027,5976,4.3
Beauregard,2/1/1999,12328,11562,766,6.2,138967,132856,6111,4.4
Beauregard,3/1/1999,12338,11616,722,5.9,138730,132947,5783,4.2
Beauregard,4/1/1999,12587,11831,756,6,138959,132955,6004,4.3
Beauregard,5/1/1999,12611,11863,748,5.9,139107,133311,5796,4.2
Beauregard,6/1/1999,12635,11661,974,7.7,139329,133378,5951,4.3
Beauregard,7/1/1999,12306,11390,916,7.4,139439,133414,6025,4.3
Beauregard,8/1/1999,12205,11334,871,7.1,139430,133591,5838,4.2
Beauregard,9/1/1999,12330,11472,858,7,139622,133707,5915,4.2
Beauregard,10/1/1999,12171,11369,802,6.6,139771,133993,5778,4.1
Beauregard,11/1/1999,12070,11388,682,5.7,140025,134309,5716,4.1
Beauregard,12/1/1999,11983,11367,616,5.1,140177,134523,5653,4
Beauregard,1/1/2000,13773,13042,731,5.3,142267,136559,5708,4
Beauregard,2/1/2000,13660,13028,632,4.6,142456,136598,5858,4.1
Beauregard,3/1/2000,13904,13221,683,4.9,142434,136701,5733,4
Beauregard,4/1/2000,13876,13272,604,4.4,142751,137270,5481,3.8
Beauregard,5/1/2000,13875,13173,702,5.1,142388,136630,5758,4
Beauregard,6/1/2000,13922,13078,844,6.1,142591,136940,5651,4
Beauregard,7/1/2000,13783,13013,770,5.6,142278,136531,5747,4
Beauregard,8/1/2000,13660,12892,768,5.6,142514,136662,5853,4.1
Beauregard,9/1/2000,14069,13314,755,5.4,142518,136893,5625,3.9
Beauregard,10/1/2000,14237,13512,725,5.1,142622,137088,5534,3.9
Beauregard,11/1/2000,14391,13682,709,4.9,142962,137322,5639,3.9
Beauregard,12/1/2000,14285,13587,698,4.9,143248,137614,5634,3.9
Beauregard,1/1/2001,13900,12992,908,6.5,143800,137778,6023,4.2
Beauregard,2/1/2001,13757,13002,755,5.5,143701,137612,6089,4.2
Beauregard,3/1/2001,13916,13124,792,5.7,143924,137783,6141,4.3
Beauregard,4/1/2001,13804,13026,778,5.6,143569,137299,6271,4.4
Beauregard,5/1/2001,13814,12997,817,5.9,143318,137092,6226,4.3
Beauregard,6/1/2001,14734,13807,927,6.3,143357,136873,6484,4.5
Beauregard,7/1/2001,14089,13200,889,6.3,143654,137071,6583,4.6
Beauregard,8/1/2001,13915,13023,892,6.4,143284,136241,7042,4.9
Beauregard,9/1/2001,13896,12966,930,6.7,143989,136846,7142,5
Beauregard,10/1/2001,14064,13149,915,6.5,144086,136392,7694,5.3
Beauregard,11/1/2001,13982,13092,890,6.4,144240,136238,8003,5.5
Beauregard,12/1/2001,13916,13044,872,6.3,144305,136047,8258,5.7
Beauregard,1/1/2002,13979,13081,898,6.4,143883,135701,8182,5.7
Beauregard,2/1/2002,13817,13026,791,5.7,144653,136438,8215,5.7
Beauregard,3/1/2002,13830,12984,846,6.1,144481,136177,8304,5.7
Beauregard,4/1/2002,13915,13114,801,5.8,144725,136126,8599,5.9
Beauregard,5/1/2002,13851,12941,910,6.6,144938,136539,8399,5.8
Beauregard,6/1/2002,13960,12937,1023,7.3,144808,136415,8393,5.8
Beauregard,7/1/2002,13912,12966,946,6.8,144803,136413,8390,5.8
Beauregard,8/1/2002,13939,12987,952,6.8,145009,136705,8304,5.7
Beauregard,9/1/2002,13927,12985,942,6.8,145552,137302,8251,5.7
Beauregard,10/1/2002,14130,13295,835,5.9,145314,137008,8307,5.7
Beauregard,11/1/2002,14154,13244,910,6.4,145041,136521,8520,5.9
Beauregard,12/1/2002,14103,13157,946,6.7,145066,136426,8640,6
Beauregard,1/1/2003,14285,13195,1090,7.6,145937,137417,8520,5.8
Beauregard,2/1/2003,14042,13043,999,7.1,146100,137482,8618,5.9
Beauregard,3/1/2003,14197,13123,1074,7.6,146022,137434,8588,5.9
Beauregard,4/1/2003,14323,13325,998,7,146474,137633,8842,6
Beauregard,5/1/2003,14706,13696,1010,6.9,146500,137544,8957,6.1
Beauregard,6/1/2003,14573,13309,1264,8.7,147056,137790,9266,6.3
Beauregard,7/1/2003,14229,13079,1150,8.1,146485,137474,9011,6.2
Beauregard,8/1/2003,14192,13137,1055,7.4,146445,137549,8896,6.1
Beauregard,9/1/2003,14205,13224,981,6.9,146530,137609,8921,6.1
Beauregard,10/1/2003,14396,13481,915,6.4,146716,137984,8732,6
Beauregard,11/1/2003,14293,13435,858,6,147000,138424,8576,5.8
Beauregard,12/1/2003,14055,13223,832,5.9,146729,138411,8317,5.7
Beauregard,1/1/2004,14160,13187,973,6.9,146842,138472,8370,5.7
Beauregard,2/1/2004,13962,13105,857,6.1,146709,138542,8167,5.6
Beauregard,3/1/2004,13715,12823,892,6.5,146944,138453,8491,5.8
Beauregard,4/1/2004,13898,13005,893,6.4,146850,138680,8170,5.6
Beauregard,5/1/2004,13931,13012,919,6.6,147065,138852,8212,5.6
Beauregard,6/1/2004,14089,13000,1089,7.7,147460,139174,8286,5.6
Beauregard,7/1/2004,13934,12958,976,7,147692,139556,8136,5.5
Beauregard,8/1/2004,13894,13052,842,6.1,147564,139573,7990,5.4
Beauregard,9/1/2004,13895,13044,851,6.1,147415,139487,7927,5.4
Beauregard,10/1/2004,14156,13344,812,5.7,147793,139732,8061,5.5
Beauregard,11/1/2004,14026,13220,806,5.7,148162,140231,7932,5.4
Beauregard,12/1/2004,14014,13239,775,5.5,148059,140125,7934,5.4
Beauregard,1/1/2005,14058,13181,877,6.2,148029,140245,7784,5.3
Beauregard,2/1/2005,13710,12916,794,5.8,148364,140385,7980,5.4
Beauregard,3/1/2005,13626,12862,764,5.6,148391,140654,7737,5.2
Beauregard,4/1/2005,13874,13111,763,5.5,148926,141254,7672,5.2
Beauregard,5/1/2005,13918,13113,805,5.8,149261,141609,7651,5.1
Beauregard,6/1/2005,14144,13197,947,6.7,149238,141714,7524,5
Beauregard,7/1/2005,14104,13143,961,6.8,149432,142026,7406,5
Beauregard,8/1/2005,13817,12999,818,5.9,149779,142434,7345,4.9
Beauregard,9/1/2005,15257,13964,1293,8.5,149954,142401,7553,5
Beauregard,10/1/2005,16243,14105,2138,13.2,150001,142548,7453,5
Beauregard,11/1/2005,15959,13906,2053,12.9,150065,142499,7566,5
Beauregard,12/1/2005,14546,13765,781,5.4,150030,142752,7279,4.9
Beauregard,1/1/2006,14513,13838,675,4.7,150214,143150,7064,4.7
Beauregard,2/1/2006,14377,13884,493,3.4,150641,143457,7184,4.8
Beauregard,3/1/2006,14524,14016,508,3.5,150813,143741,7072,4.7
Beauregard,4/1/2006,14686,14181,505,3.4,150881,143761,7120,4.7
Beauregard,5/1/2006,14665,14102,563,3.8,151069,144089,6980,4.6
Beauregard,6/1/2006,14835,14128,707,4.8,151354,144353,7001,4.6
Beauregard,7/1/2006,14701,14010,691,4.7,151377,144202,7175,4.7
Beauregard,8/1/2006,14518,13876,642,4.4,151716,144625,7091,4.7
Beauregard,9/1/2006,14758,14105,653,4.4,151662,144815,6847,4.5
Beauregard,10/1/2006,14875,14282,593,4,152041,145314,6727,4.4
Beauregard,11/1/2006,14724,14097,627,4.3,152406,145534,6872,4.5
Beauregard,12/1/2006,14442,13810,632,4.4,152732,145970,6762,4.4
Beauregard,1/1/2007,14583,13846,737,5.1,153144,146028,7116,4.6
Beauregard,2/1/2007,14508,13853,655,4.5,152983,146057,6927,4.5
Beauregard,3/1/2007,14465,13880,585,4,153051,146320,6731,4.4
Beauregard,4/1/2007,14175,13578,597,4.2,152435,145586,6850,4.5
Beauregard,5/1/2007,14117,13478,639,4.5,152670,145903,6766,4.4
Beauregard,6/1/2007,14069,13304,765,5.4,153041,146063,6979,4.6
Beauregard,7/1/2007,14141,13391,750,5.3,153054,145905,7149,4.7
Beauregard,8/1/2007,14084,13416,668,4.7,152749,145682,7067,4.6
Beauregard,9/1/2007,14325,13588,737,5.1,153414,146244,7170,4.7
Beauregard,10/1/2007,14390,13830,560,3.9,153183,145946,7237,4.7
Beauregard,11/1/2007,14511,13852,659,4.5,153835,146595,7240,4.7
Beauregard,12/1/2007,14410,13664,746,5.2,153918,146273,7645,5
Beauregard,1/1/2008,14485,13714,771,5.3,154063,146378,7685,5
Beauregard,2/1/2008,14387,13758,629,4.4,153653,146156,7497,4.9
Beauregard,3/1/2008,14579,13922,657,4.5,153908,146086,7822,5.1
Beauregard,4/1/2008,14639,14024,615,4.2,153769,146132,7637,5
Beauregard,5/1/2008,14791,14120,671,4.5,154303,145908,8395,5.4
Beauregard,6/1/2008,14776,13941,835,5.7,154313,145737,8575,5.6
Beauregard,7/1/2008,14580,13694,886,6.1,154469,145532,8937,5.8
Beauregard,8/1/2008,14571,13748,823,5.6,154641,145203,9438,6.1
Beauregard,9/1/2008,14724,13927,797,5.4,154570,145076,9494,6.1
Beauregard,10/1/2008,14737,13926,811,5.5,154876,144802,10074,6.5
Beauregard,11/1/2008,14601,13827,774,5.3,154639,144100,10538,6.8
Beauregard,12/1/2008,14173,13382,791,5.6,154655,143369,11286,7.3
Beauregard,1/1/2009,14276,13324,952,6.7,154210,142152,12058,7.8
Beauregard,2/1/2009,14161,13138,1023,7.2,154538,141640,12898,8.3
Beauregard,3/1/2009,14548,13316,1232,8.5,154133,140707,13426,8.7
Beauregard,4/1/2009,14885,13686,1199,8.1,154509,140656,13853,9
Beauregard,5/1/2009,14583,13429,1154,7.9,154747,140248,14499,9.4
Beauregard,6/1/2009,14790,13494,1296,8.8,154716,140009,14707,9.5
Beauregard,7/1/2009,14600,13347,1253,8.6,154502,139901,14601,9.5
Beauregard,8/1/2009,14248,13101,1147,8.1,154307,139492,14814,9.6
Beauregard,9/1/2009,14340,13233,1107,7.7,153827,138818,15009,9.8
Beauregard,10/1/2009,14335,13282,1053,7.3,153784,138432,15352,10
Beauregard,11/1/2009,14451,13487,964,6.7,153878,138659,15219,9.9
Beauregard,12/1/2009,14565,13484,1081,7.4,153111,138013,15098,9.9
Beauregard,1/1/2010,14517,13378,1139,7.8,153484,138438,15046,9.8
Beauregard,2/1/2010,14479,13504,975,6.7,153694,138581,15113,9.8
Beauregard,3/1/2010,14753,13744,1009,6.8,153954,138751,15202,9.9
Beauregard,4/1/2010,14835,13842,993,6.7,154622,139297,15325,9.9
Beauregard,5/1/2010,14796,13769,1027,6.9,154091,139241,14849,9.6
Beauregard,6/1/2010,14762,13607,1155,7.8,153616,139141,14474,9.4
Beauregard,7/1/2010,14720,13581,1139,7.7,153691,139179,14512,9.4
Beauregard,8/1/2010,14805,13608,1197,8.1,154086,139438,14648,9.5
Beauregard,9/1/2010,14724,13612,1112,7.6,153975,139396,14579,9.5
Beauregard,10/1/2010,14551,13474,1077,7.4,153635,139119,14516,9.4
Beauregard,11/1/2010,14327,13265,1062,7.4,154125,139044,15081,9.8
Beauregard,12/1/2010,14072,12993,1079,7.7,153650,139301,14348,9.3
Beauregard,1/1/2011,14209,13035,1174,8.3,153263,139250,14013,9.1
Beauregard,2/1/2011,14211,13204,1007,7.1,153214,139394,13820,9
Beauregard,3/1/2011,14288,13275,1013,7.1,153376,139639,13737,9
Beauregard,4/1/2011,14291,13250,1041,7.3,153543,139586,13957,9.1
Beauregard,5/1/2011,14424,13359,1065,7.4,153479,139624,13855,9
Beauregard,6/1/2011,14486,13255,1231,8.5,153346,139384,13962,9.1
Beauregard,7/1/2011,14358,13167,1191,8.3,153288,139524,13763,9
Beauregard,8/1/2011,14255,13163,1092,7.7,153760,139942,13818,9
Beauregard,9/1/2011,14256,13063,1193,8.4,154131,140183,13948,9
Beauregard,10/1/2011,14510,13346,1164,8,153961,140368,13594,8.8
Beauregard,11/1/2011,14427,13427,1000,6.9,154128,140826,13302,8.6
Beauregard,12/1/2011,14337,13271,1066,7.4,153995,140902,13093,8.5
Beauregard,1/1/2012,14301,13154,1147,8,154381,141584,12797,8.3
Beauregard,2/1/2012,14263,13231,1032,7.2,154671,141858,12813,8.3
Beauregard,3/1/2012,14438,13420,1018,7.1,154749,142036,12713,8.2
Beauregard,4/1/2012,14497,13475,1022,7,154545,141899,12646,8.2
Beauregard,5/1/2012,14595,13548,1047,7.2,154866,142206,12660,8.2
Beauregard,6/1/2012,14827,13599,1228,8.3,155083,142391,12692,8.2
Beauregard,7/1/2012,14670,13542,1128,7.7,154948,142292,12656,8.2
Beauregard,8/1/2012,14455,13425,1030,7.1,154763,142291,12471,8.1
Beauregard,9/1/2012,14378,13414,964,6.7,155160,143044,12115,7.8
Beauregard,10/1/2012,14596,13657,939,6.4,155554,143431,12124,7.8
Beauregard,11/1/2012,14559,13699,860,5.9,155338,143333,12005,7.7
Beauregard,12/1/2012,14329,13324,1005,7,155628,143330,12298,7.9
Beauregard,1/1/2013,14411,13270,1141,7.9,155763,143292,12471,8
Beauregard,2/1/2013,14314,13358,956,6.7,155312,143362,11950,7.7
Beauregard,3/1/2013,14360,13401,959,6.7,155005,143316,11689,7.5
Beauregard,4/1/2013,14491,13465,1026,7.1,155394,143635,11760,7.6
Beauregard,5/1/2013,14648,13614,1034,7.1,155536,143882,11654,7.5
Beauregard,6/1/2013,14740,13563,1177,8,155749,143999,11751,7.5
Beauregard,7/1/2013,14629,13444,1185,8.1,155599,144264,11335,7.3
Beauregard,8/1/2013,14370,13348,1022,7.1,155605,144326,11279,7.2
Beauregard,9/1/2013,14330,13293,1037,7.2,155687,144418,11270,7.2
Beauregard,10/1/2013,14448,13443,1005,7,154673,143537,11136,7.2
Beauregard,11/1/2013,14451,13596,855,5.9,155265,144479,10787,6.9
Beauregard,12/1/2013,14143,13332,811,5.7,155182,144778,10404,6.7
Beauregard,1/1/2014,14137,13264,873,6.2,155352,145150,10202,6.6
Beauregard,2/1/2014,14067,13224,843,6,155483,145134,10349,6.7
Beauregard,3/1/2014,14292,13441,851,6,156028,145648,10380,6.7
Beauregard,4/1/2014,14543,13734,809,5.6,155369,145667,9702,6.2
Beauregard,5/1/2014,14591,13647,944,6.5,155684,145825,9859,6.3
Beauregard,6/1/2014,14720,13692,1028,7,155707,146247,9460,6.1
Beauregard,7/1/2014,15028,13885,1143,7.6,156007,146399,9608,6.2
Beauregard,8/1/2014,14950,13882,1068,7.1,156130,146530,9599,6.1
Beauregard,9/1/2014,15082,14020,1062,7,156040,146778,9262,5.9
Beauregard,10/1/2014,15220,14164,1056,6.9,156417,147427,8990,5.7
Beauregard,11/1/2014,15031,13975,1056,7,156494,147404,9090,5.8
Beauregard,12/1/2014,14945,13943,1002,6.7,156332,147615,8717,5.6
Beauregard,1/1/2015,15010,13931,1079,7.2,157030,148145,8885,5.7
Beauregard,2/1/2015,15012,14047,965,6.4,156644,148045,8599,5.5
Beauregard,3/1/2015,15060,14100,960,6.4,156643,148128,8515,5.4
Beauregard,4/1/2015,15381,14400,981,6.4,157060,148511,8550,5.4
Beauregard,5/1/2015,15439,14408,1031,6.7,157651,148817,8834,5.6
Beauregard,6/1/2015,15369,14342,1027,6.7,157062,148816,8247,5.3
Beauregard,7/1/2015,15238,14226,1012,6.6,156997,148830,8167,5.2
Beauregard,8/1/2015,15157,14214,943,6.2,157172,149181,7992,5.1
Beauregard,9/1/2015,14945,14045,900,6,156733,148826,7907,5
Beauregard,10/1/2015,15155,14306,849,5.6,157167,149246,7922,5
Beauregard,11/1/2015,15040,14231,809,5.4,157463,149463,8000,5.1
Beauregard,12/1/2015,14595,13765,830,5.7,158035,150128,7907,5
Beauregard,1/1/2016,14979,14045,934,6.2,158280,150653,7627,4.8
Beauregard,2/1/2016,14956,14089,867,5.8,158640,150939,7702,4.9
Beauregard,3/1/2016,14996,14125,871,5.8,159179,151218,7961,5
Beauregard,4/1/2016,15291,14440,851,5.6,159141,151074,8067,5.1
Beauregard,5/1/2016,15273,14405,868,5.7,158784,151132,7652,4.8
Beauregard,6/1/2016,15365,14315,1050,6.8,158967,151223,7744,4.9
Beauregard,7/1/2016,15260,14238,1022,6.7,159194,151554,7641,4.8
Beauregard,8/1/2016,15053,14101,952,6.3,159562,151779,7784,4.9
Beauregard,9/1/2016,14948,14015,933,6.2,159714,151761,7953,5
Beauregard,10/1/2016,15012,14181,831,5.5,159605,151793,7811,4.9
Beauregard,11/1/2016,14981,14148,833,5.6,159506,151954,7553,4.7
Beauregard,12/1/2016,14604,13732,872,6,159678,152157,7521,4.7
Beauregard,1/1/2017,14575,13606,969,6.6,159620,152152,7468,4.7
Beauregard,2/1/2017,14505,13699,806,5.6,159859,152480,7379,4.6
Beauregard,3/1/2017,14604,13832,772,5.3,160137,153065,7073,4.4
Beauregard,4/1/2017,14918,14131,787,5.3,160345,153255,7089,4.4
Beauregard,5/1/2017,14891,14089,802,5.4,160068,153069,7000,4.4
Beauregard,6/1/2017,14962,14123,839,5.6,160192,153318,6873,4.3
Beauregard,7/1/2017,14801,13941,860,5.8,160462,153569,6892,4.3
Beauregard,8/1/2017,14631,13817,814,5.6,160586,153503,7082,4.4
Beauregard,9/1/2017,14558,13772,786,5.4,161140,154286,6854,4.3
Beauregard,10/1/2017,14611,13970,641,4.4,160309,153609,6700,4.2
Beauregard,11/1/2017,14561,13894,667,4.6,160579,153805,6774,4.2
Beauregard,12/1/2017,14199,13549,650,4.6,160535,153904,6632,4.1
Beauregard,1/1/2018,14414,13643,771,5.3,160914,154425,6489,4
Beauregard,2/1/2018,14408,13717,691,4.8,161778,155197,6581,4.1
Beauregard,3/1/2018,14490,13800,690,4.8,161686,155214,6472,4
Beauregard,4/1/2018,14850,14125,725,4.9,161771,155312,6459,4
Beauregard,5/1/2018,14884,14131,753,5.1,161848,155652,6196,3.8
Beauregard,6/1/2018,14962,13957,1005,6.7,162210,155762,6447,4
Beauregard,7/1/2018,14700,13818,882,6,162341,156146,6195,3.8
Beauregard,8/1/2018,14473,13675,798,5.5,161660,155504,6156,3.8
Beauregard,9/1/2018,14305,13571,734,5.1,162087,156015,6073,3.7
Beauregard,10/1/2018,14619,13887,732,5,162602,156391,6211,3.8
Beauregard,11/1/2018,14513,13840,673,4.6,162836,156721,6115,3.8
Beauregard,12/1/2018,14220,13485,735,5.2,163206,156817,6389,3.9
Beauregard,1/1/2019,14344,13535,809,5.6,162963,156487,6475,4
Beauregard,2/1/2019,14423,13747,676,4.7,162999,156863,6136,3.8
Beauregard,3/1/2019,14405,13755,650,4.5,162904,156701,6202,3.8
Beauregard,4/1/2019,14587,13997,590,4,162586,156625,5961,3.7
Beauregard,5/1/2019,14675,13993,682,4.6,162751,156821,5930,3.6
Beauregard,6/1/2019,14716,13874,842,5.7,163168,157232,5935,3.6
Beauregard,7/1/2019,14649,13809,840,5.7,163590,157529,6061,3.7
Beauregard,8/1/2019,14765,13953,812,5.5,163774,157829,5945,3.6
Beauregard,9/1/2019,14725,13998,727,4.9,164092,158339,5753,3.5
Beauregard,10/1/2019,14982,14235,747,5,164416,158545,5871,3.6
Beauregard,11/1/2019,14755,14036,719,4.9,164496,158629,5868,3.6
Beauregard,12/1/2019,14282,13574,708,5,164699,158845,5853,3.6
Beauregard,1/1/2020,14521,13726,795,5.5,164377,158508,5869,3.6
Beauregard,2/1/2020,14490,13842,648,4.5,164467,158714,5753,3.5
Beauregard,3/1/2020,14732,13571,1161,7.9,162559,155353,7206,4.4
Beauregard,4/1/2020,13922,12660,1262,9.1,156269,133185,23084,14.8
Beauregard,5/1/2020,14214,12969,1245,8.8,158101,137173,20929,13.2
Beauregard,6/1/2020,14345,13133,1212,8.4,159994,142342,17652,11
Beauregard,7/1/2020,14412,13215,1197,8.3,160132,143779,16352,10.2
Beauregard,8/1/2020,14346,13383,963,6.7,160706,147245,13461,8.4
Beauregard,9/1/2020,13979,12745,1234,8.8,160174,147620,12554,7.8
Beauregard,10/1/2020,14315,13428,887,6.2,161003,149931,11072,6.9
Beauregard,11/1/2020,14299,13536,763,5.3,160629,149934,10694,6.7
Beauregard,12/1/2020,13939,13154,785,5.6,160745,149975,10770,6.7
Beauregard,1/1/2021,14009,13204,805,5.7,160088,149852,10236,6.4
Beauregard,2/1/2021,14240,13521,719,5,160184,150189,9995,6.2
Beauregard,3/1/2021,14382,13675,707,4.9,160400,150644,9756,6.1
Beauregard,4/1/2021,14512,13859,653,4.5,160843,151081,9762,6.1
Beauregard,5/1/2021,14361,13688,673,4.7,160800,151535,9266,5.8
Beauregard,6/1/2021,14652,13876,776,5.3,161197,151734,9462,5.9
Beauregard,7/1/2021,14556,13881,675,4.6,161504,152773,8731,5.4
Beauregard,8/1/2021,14438,13839,599,4.1,161527,153250,8276,5.1
Beauregard,9/1/2021,14735,14214,521,3.5,161495,153843,7652,4.7
Beauregard,10/1/2021,14680,14193,487,3.3,161754,154475,7279,4.5
Beauregard,11/1/2021,14624,14197,427,2.9,162281,155530,6751,4.2
Beauregard,12/1/2021,14232,13812,420,3,162497,156099,6398,3.9
Beauregard,1/1/2022,14503,13971,532,3.7,163627,157115,6512,4
Beauregard,2/1/2022,14572,14088,484,3.3,163899,157598,6301,3.8
Beauregard,3/1/2022,14617,14149,468,3.2,164220,158206,6014,3.7
Beauregard,4/1/2022,14609,14172,437,3,163893,157891,6002,3.7
Beauregard,5/1/2022,14515,14065,450,3.1,164362,158378,5983,3.6
Beauregard,6/1/2022,14567,13932,635,4.4,164046,158094,5951,3.6
Beauregard,7/1/2022,14687,14135,552,3.8,164026,158258,5768,3.5
Beauregard,8/1/2022,14583,14077,506,3.5,164654,158735,5919,3.6
Beauregard,9/1/2022,14509,14027,482,3.3,164602,158810,5792,3.5
Beauregard,10/1/2022,14412,13943,469,3.3,164648,158684,5964,3.6
Beauregard,11/1/2022,14381,13951,430,3,164450,158507,5943,3.6
Beauregard,12/1/2022,14199,13718,481,3.4,165025,159259,5766,3.5
Beauregard,1/1/2023,14384,13825,559,3.9,165964,160217,5747,3.5
Beauregard,2/1/2023,14372,13860,512,3.6,166358,160395,5962,3.6
Beauregard,3/1/2023,14519,14067,452,3.1,166651,160812,5839,3.5
Beauregard,4/1/2023,14572,14137,435,3,166725,160974,5751,3.4
Beauregard,5/1/2023,14442,13946,496,3.4,166886,160796,6089,3.6
Beauregard,6/1/2023,14526,13936,590,4.1,166937,160979,5958,3.6
Beauregard,7/1/2023,14610,14081,529,3.6,167103,161183,5920,3.5
Beauregard,8/1/2023,14487,13976,511,3.5,167759,161475,6284,3.7
Beauregard,9/1/2023,14564,14006,558,3.8,167767,161442,6326,3.8
Beauregard,10/1/2023,14655,14118,537,3.7,167690,161211,6479,3.9
Beauregard,11/1/2023,14758,14201,557,3.8,168140,161886,6254,3.7
Beauregard,12/1/2023,14356,13786,570,4,167439,161124,6315,3.8
Beauregard,1/1/2024,14575,13921,654,4.5,167339,161190,6149,3.7
Beauregard,2/1/2024,14552,13948,604,4.2,167475,161013,6462,3.9
Beauregard,3/1/2024,14846,14294,552,3.7,167922,161425,6497,3.9
Beauregard,4/1/2024,14860,14398,462,3.1,167988,161495,6492,3.9
Beauregard,5/1/2024,14746,14230,516,3.5,167799,161164,6635,4
Beauregard,6/1/2024,14771,14091,680,4.6,168005,161155,6849,4.1
Beauregard,7/1/2024,14896,14249,647,4.3,168315,161219,7097,4.2
Beauregard,8/1/2024,14855,14184,671,4.5,168496,161425,7071,4.2
Beauregard,9/1/2024,14693,14029,664,4.5,168703,161802,6901,4.1
Beauregard,10/1/2024,14889,14219,670,4.5,168428,161456,6972,4.1
Beauregard,11/1/2024,14805,14150,655,4.4,168304,161183,7121,4.2
Beauregard,12/1/2024,14416,13773,643,4.5,168547,161661,6886,4.1
Beauregard,1/1/2025,14200,13550,650,4.6,170744,163895,6849,4
Beauregard,2/1/2025,14269,13636,633,4.4,170359,163307,7052,4.1
Bienville,1/1/1990,5879,5329,550,9.4,125833,119081,6752,5.4
Bienville,2/1/1990,5761,5318,443,7.7,125710,119059,6651,5.3
Bienville,3/1/1990,5800,5407,393,6.8,125801,119203,6598,5.2
Bienville,4/1/1990,5841,5445,396,6.8,125649,118852,6797,5.4
Bienville,5/1/1990,5855,5484,371,6.3,125893,119151,6742,5.4
Bienville,6/1/1990,6016,5548,468,7.8,125573,118983,6590,5.2
Bienville,7/1/1990,6059,5645,414,6.8,125732,118810,6922,5.5
Bienville,8/1/1990,6115,5683,432,7.1,125990,118802,7188,5.7
Bienville,9/1/1990,6064,5636,428,7.1,125892,118524,7368,5.9
Bienville,10/1/1990,5933,5560,373,6.3,125995,118536,7459,5.9
Bienville,11/1/1990,6004,5589,415,6.9,126070,118306,7764,6.2
Bienville,12/1/1990,6000,5549,451,7.5,126142,118241,7901,6.3
Bienville,1/1/1991,6083,5420,663,10.9,125955,117940,8015,6.4
Bienville,2/1/1991,5998,5475,523,8.7,126020,117755,8265,6.6
Bienville,3/1/1991,6105,5513,592,9.7,126238,117652,8586,6.8
Bienville,4/1/1991,6176,5572,604,9.8,126548,118109,8439,6.7
Bienville,5/1/1991,6152,5526,626,10.2,126176,117440,8736,6.9
Bienville,6/1/1991,6332,5695,637,10.1,126331,117639,8692,6.9
Bienville,7/1/1991,6197,5703,494,8,126154,117568,8586,6.8
Bienville,8/1/1991,6258,5687,571,9.1,126150,117484,8666,6.9
Bienville,9/1/1991,6098,5580,518,8.5,126650,117928,8722,6.9
Bienville,10/1/1991,6153,5687,466,7.6,126642,117800,8842,7
Bienville,11/1/1991,6119,5714,405,6.6,126701,117770,8931,7
Bienville,12/1/1991,6099,5640,459,7.5,126664,117466,9198,7.3
Bienville,1/1/1992,6321,5799,522,8.3,127261,117978,9283,7.3
Bienville,2/1/1992,6314,5848,466,7.4,127207,117753,9454,7.4
Bienville,3/1/1992,6327,5845,482,7.6,127604,118144,9460,7.4
Bienville,4/1/1992,6396,5934,462,7.2,127841,118426,9415,7.4
Bienville,5/1/1992,6405,5920,485,7.6,128119,118375,9744,7.6
Bienville,6/1/1992,6491,5908,583,9,128459,118419,10040,7.8
Bienville,7/1/1992,6783,6266,517,7.6,128563,118713,9850,7.7
Bienville,8/1/1992,6660,6154,506,7.6,128613,118826,9787,7.6
Bienville,9/1/1992,6566,6082,484,7.4,128501,118720,9781,7.6
Bienville,10/1/1992,6438,5999,439,6.8,128026,118628,9398,7.3
Bienville,11/1/1992,6416,5980,436,6.8,128441,118876,9565,7.4
Bienville,12/1/1992,6205,5815,390,6.3,128554,118997,9557,7.4
Bienville,1/1/1993,6193,5724,469,7.6,128400,119075,9325,7.3
Bienville,2/1/1993,6160,5752,408,6.6,128458,119275,9183,7.1
Bienville,3/1/1993,6221,5798,423,6.8,128598,119542,9056,7
Bienville,4/1/1993,6220,5781,439,7.1,128584,119474,9110,7.1
Bienville,5/1/1993,6158,5754,404,6.6,129264,120115,9149,7.1
Bienville,6/1/1993,6225,5726,499,8,129411,120290,9121,7
Bienville,7/1/1993,6314,5903,411,6.5,129397,120467,8930,6.9
Bienville,8/1/1993,6256,5803,453,7.2,129619,120856,8763,6.8
Bienville,9/1/1993,6175,5763,412,6.7,129268,120554,8714,6.7
Bienville,10/1/1993,6275,5884,391,6.2,129573,120823,8750,6.8
Bienville,11/1/1993,6303,5943,360,5.7,129711,121169,8542,6.6
Bienville,12/1/1993,6234,5854,380,6.1,129941,121464,8477,6.5
Bienville,1/1/1994,6141,5630,511,8.3,130596,121966,8630,6.6
Bienville,2/1/1994,6127,5677,450,7.3,130669,122086,8583,6.6
Bienville,3/1/1994,6101,5680,421,6.9,130400,121930,8470,6.5
Bienville,4/1/1994,6204,5720,484,7.8,130621,122290,8331,6.4
Bienville,5/1/1994,6164,5713,451,7.3,130779,122864,7915,6.1
Bienville,6/1/1994,6325,5764,561,8.9,130561,122634,7927,6.1
Bienville,7/1/1994,6439,5919,520,8.1,130652,122706,7946,6.1
Bienville,8/1/1994,6518,5971,547,8.4,131275,123342,7933,6
Bienville,9/1/1994,6530,5991,539,8.3,131421,123687,7734,5.9
Bienville,10/1/1994,6731,6155,576,8.6,131744,124112,7632,5.8
Bienville,11/1/1994,6667,6133,534,8,131891,124516,7375,5.6
Bienville,12/1/1994,6549,6037,512,7.8,131951,124721,7230,5.5
Bienville,1/1/1995,6400,5779,621,9.7,132038,124663,7375,5.6
Bienville,2/1/1995,6373,5835,538,8.4,132115,124928,7187,5.4
Bienville,3/1/1995,6418,5832,586,9.1,132108,124955,7153,5.4
Bienville,4/1/1995,6356,5669,687,10.8,132590,124945,7645,5.8
Bienville,5/1/1995,6099,5523,576,9.4,131851,124421,7430,5.6
Bienville,6/1/1995,6274,5670,604,9.6,131949,124522,7427,5.6
Bienville,7/1/1995,6323,5793,530,8.4,132343,124816,7527,5.7
Bienville,8/1/1995,6290,5727,563,9,132336,124852,7484,5.7
Bienville,9/1/1995,6255,5671,584,9.3,132611,125133,7478,5.6
Bienville,10/1/1995,6312,5775,537,8.5,132716,125388,7328,5.5
Bienville,11/1/1995,6201,5671,530,8.5,132614,125188,7426,5.6
Bienville,12/1/1995,6109,5594,515,8.4,132511,125088,7423,5.6
Bienville,1/1/1996,6147,5540,607,9.9,132616,125125,7491,5.6
Bienville,2/1/1996,6094,5566,528,8.7,132952,125639,7313,5.5
Bienville,3/1/1996,6235,5597,638,10.2,133180,125862,7318,5.5
Bienville,4/1/1996,6113,5549,564,9.2,133409,125994,7415,5.6
Bienville,5/1/1996,6130,5571,559,9.1,133667,126244,7423,5.6
Bienville,6/1/1996,6238,5646,592,9.5,133697,126602,7095,5.3
Bienville,7/1/1996,6167,5605,562,9.1,134284,126947,7337,5.5
Bienville,8/1/1996,6069,5542,527,8.7,134054,127172,6882,5.1
Bienville,9/1/1996,6026,5438,588,9.8,134515,127536,6979,5.2
Bienville,10/1/1996,5849,5211,638,10.9,134921,127890,7031,5.2
Bienville,11/1/1996,5181,4508,673,13,135007,127771,7236,5.4
Bienville,12/1/1996,5508,4511,997,18.1,135113,127860,7253,5.4
Bienville,1/1/1997,5538,4360,1178,21.3,135456,128298,7158,5.3
Bienville,2/1/1997,5378,4394,984,18.3,135400,128298,7102,5.2
Bienville,3/1/1997,5544,4386,1158,20.9,135891,128891,7000,5.2
Bienville,4/1/1997,5545,4480,1065,19.2,136016,129143,6873,5.1
Bienville,5/1/1997,5616,4496,1120,19.9,136119,129464,6655,4.9
Bienville,6/1/1997,5810,4553,1257,21.6,136211,129412,6799,5
Bienville,7/1/1997,5680,4589,1091,19.2,136477,129822,6655,4.9
Bienville,8/1/1997,5598,4614,984,17.6,136618,130010,6608,4.8
Bienville,9/1/1997,5611,4676,935,16.7,136675,130019,6656,4.9
Bienville,10/1/1997,5458,4648,810,14.8,136633,130179,6454,4.7
Bienville,11/1/1997,5432,4679,753,13.9,136961,130653,6308,4.6
Bienville,12/1/1997,5336,4676,660,12.4,137155,130679,6476,4.7
Bienville,1/1/1998,5415,4654,761,14.1,137095,130726,6368,4.6
Bienville,2/1/1998,5334,4724,610,11.4,137112,130807,6306,4.6
Bienville,3/1/1998,5381,4729,652,12.1,137236,130814,6422,4.7
Bienville,4/1/1998,5345,4753,592,11.1,137150,131209,5941,4.3
Bienville,5/1/1998,5465,4891,574,10.5,137372,131325,6047,4.4
Bienville,6/1/1998,5833,5218,615,10.5,137455,131244,6212,4.5
Bienville,7/1/1998,5552,5012,540,9.7,137588,131329,6259,4.5
Bienville,8/1/1998,5619,5037,582,10.4,137570,131390,6179,4.5
Bienville,9/1/1998,5512,4977,535,9.7,138286,131986,6300,4.6
Bienville,10/1/1998,5515,5052,463,8.4,138279,131999,6280,4.5
Bienville,11/1/1998,5495,5084,411,7.5,138381,132280,6100,4.4
Bienville,12/1/1998,5410,5022,388,7.2,138634,132602,6032,4.4
Bienville,1/1/1999,5407,4953,454,8.4,139003,133027,5976,4.3
Bienville,2/1/1999,5315,4927,388,7.3,138967,132856,6111,4.4
Bienville,3/1/1999,5287,4923,364,6.9,138730,132947,5783,4.2
Bienville,4/1/1999,5194,4842,352,6.8,138959,132955,6004,4.3
Bienville,5/1/1999,5301,4983,318,6,139107,133311,5796,4.2
Bienville,6/1/1999,5592,5238,354,6.3,139329,133378,5951,4.3
Bienville,7/1/1999,5600,5275,325,5.8,139439,133414,6025,4.3
Bienville,8/1/1999,5627,5282,345,6.1,139430,133591,5838,4.2
Bienville,9/1/1999,5518,5180,338,6.1,139622,133707,5915,4.2
Bienville,10/1/1999,5606,5281,325,5.8,139771,133993,5778,4.1
Bienville,11/1/1999,5613,5300,313,5.6,140025,134309,5716,4.1
Bienville,12/1/1999,5499,5191,308,5.6,140177,134523,5653,4
Bienville,1/1/2000,5918,5567,351,5.9,142267,136559,5708,4
Bienville,2/1/2000,5832,5531,301,5.2,142456,136598,5858,4.1
Bienville,3/1/2000,5855,5532,323,5.5,142434,136701,5733,4
Bienville,4/1/2000,5868,5580,288,4.9,142751,137270,5481,3.8
Bienville,5/1/2000,5862,5530,332,5.7,142388,136630,5758,4
Bienville,6/1/2000,5966,5539,427,7.2,142591,136940,5651,4
Bienville,7/1/2000,5906,5559,347,5.9,142278,136531,5747,4
Bienville,8/1/2000,5800,5424,376,6.5,142514,136662,5853,4.1
Bienville,9/1/2000,5897,5311,586,9.9,142518,136893,5625,3.9
Bienville,10/1/2000,6062,5567,495,8.2,142622,137088,5534,3.9
Bienville,11/1/2000,5960,5556,404,6.8,142962,137322,5639,3.9
Bienville,12/1/2000,5976,5581,395,6.6,143248,137614,5634,3.9
Bienville,1/1/2001,5965,5438,527,8.8,143800,137778,6023,4.2
Bienville,2/1/2001,5944,5485,459,7.7,143701,137612,6089,4.2
Bienville,3/1/2001,5967,5450,517,8.7,143924,137783,6141,4.3
Bienville,4/1/2001,5878,5419,459,7.8,143569,137299,6271,4.4
Bienville,5/1/2001,5835,5396,439,7.5,143318,137092,6226,4.3
Bienville,6/1/2001,5907,5403,504,8.5,143357,136873,6484,4.5
Bienville,7/1/2001,5929,5475,454,7.7,143654,137071,6583,4.6
Bienville,8/1/2001,5885,5412,473,8,143284,136241,7042,4.9
Bienville,9/1/2001,5943,5463,480,8.1,143989,136846,7142,5
Bienville,10/1/2001,5913,5447,466,7.9,144086,136392,7694,5.3
Bienville,11/1/2001,5899,5421,478,8.1,144240,136238,8003,5.5
Bienville,12/1/2001,5877,5356,521,8.9,144305,136047,8258,5.7
Bienville,1/1/2002,5953,5356,597,10,143883,135701,8182,5.7
Bienville,2/1/2002,5874,5407,467,8,144653,136438,8215,5.7
Bienville,3/1/2002,5939,5408,531,8.9,144481,136177,8304,5.7
Bienville,4/1/2002,5910,5401,509,8.6,144725,136126,8599,5.9
Bienville,5/1/2002,5917,5418,499,8.4,144938,136539,8399,5.8
Bienville,6/1/2002,5995,5442,553,9.2,144808,136415,8393,5.8
Bienville,7/1/2002,6038,5546,492,8.1,144803,136413,8390,5.8
Bienville,8/1/2002,6066,5543,523,8.6,145009,136705,8304,5.7
Bienville,9/1/2002,6052,5566,486,8,145552,137302,8251,5.7
Bienville,10/1/2002,6002,5550,452,7.5,145314,137008,8307,5.7
Bienville,11/1/2002,5957,5491,466,7.8,145041,136521,8520,5.9
Bienville,12/1/2002,5920,5452,468,7.9,145066,136426,8640,6
Bienville,1/1/2003,6052,5507,545,9,145937,137417,8520,5.8
Bienville,2/1/2003,5968,5456,512,8.6,146100,137482,8618,5.9
Bienville,3/1/2003,6036,5474,562,9.3,146022,137434,8588,5.9
Bienville,4/1/2003,6012,5479,533,8.9,146474,137633,8842,6
Bienville,5/1/2003,5988,5462,526,8.8,146500,137544,8957,6.1
Bienville,6/1/2003,6191,5561,630,10.2,147056,137790,9266,6.3
Bienville,7/1/2003,6113,5563,550,9,146485,137474,9011,6.2
Bienville,8/1/2003,6018,5504,514,8.5,146445,137549,8896,6.1
Bienville,9/1/2003,5952,5464,488,8.2,146530,137609,8921,6.1
Bienville,10/1/2003,6072,5617,455,7.5,146716,137984,8732,6
Bienville,11/1/2003,6026,5576,450,7.5,147000,138424,8576,5.8
Bienville,12/1/2003,5939,5482,457,7.7,146729,138411,8317,5.7
Bienville,1/1/2004,6022,5473,549,9.1,146842,138472,8370,5.7
Bienville,2/1/2004,5913,5436,477,8.1,146709,138542,8167,5.6
Bienville,3/1/2004,5940,5437,503,8.5,146944,138453,8491,5.8
Bienville,4/1/2004,5917,5439,478,8.1,146850,138680,8170,5.6
Bienville,5/1/2004,5947,5453,494,8.3,147065,138852,8212,5.6
Bienville,6/1/2004,6068,5494,574,9.5,147460,139174,8286,5.6
Bienville,7/1/2004,6110,5596,514,8.4,147692,139556,8136,5.5
Bienville,8/1/2004,6099,5624,475,7.8,147564,139573,7990,5.4
Bienville,9/1/2004,6116,5646,470,7.7,147415,139487,7927,5.4
Bienville,10/1/2004,6275,5821,454,7.2,147793,139732,8061,5.5
Bienville,11/1/2004,6286,5846,440,7,148162,140231,7932,5.4
Bienville,12/1/2004,6282,5843,439,7,148059,140125,7934,5.4
Bienville,1/1/2005,6152,5662,490,8,148029,140245,7784,5.3
Bienville,2/1/2005,6056,5614,442,7.3,148364,140385,7980,5.4
Bienville,3/1/2005,6057,5634,423,7,148391,140654,7737,5.2
Bienville,4/1/2005,6159,5720,439,7.1,148926,141254,7672,5.2
Bienville,5/1/2005,6196,5743,453,7.3,149261,141609,7651,5.1
Bienville,6/1/2005,6264,5772,492,7.9,149238,141714,7524,5
Bienville,7/1/2005,6288,5820,468,7.4,149432,142026,7406,5
Bienville,8/1/2005,6181,5732,449,7.3,149779,142434,7345,4.9
Bienville,9/1/2005,6615,6126,489,7.4,149954,142401,7553,5
Bienville,10/1/2005,6711,6255,456,6.8,150001,142548,7453,5
Bienville,11/1/2005,6626,6165,461,7,150065,142499,7566,5
Bienville,12/1/2005,6404,6056,348,5.4,150030,142752,7279,4.9
Bienville,1/1/2006,6381,6070,311,4.9,150214,143150,7064,4.7
Bienville,2/1/2006,6271,6026,245,3.9,150641,143457,7184,4.8
Bienville,3/1/2006,6330,6068,262,4.1,150813,143741,7072,4.7
Bienville,4/1/2006,6350,6090,260,4.1,150881,143761,7120,4.7
Bienville,5/1/2006,6319,6041,278,4.4,151069,144089,6980,4.6
Bienville,6/1/2006,6435,6091,344,5.3,151354,144353,7001,4.6
Bienville,7/1/2006,6472,6157,315,4.9,151377,144202,7175,4.7
Bienville,8/1/2006,6346,6041,305,4.8,151716,144625,7091,4.7
Bienville,9/1/2006,6393,6073,320,5,151662,144815,6847,4.5
Bienville,10/1/2006,6497,6180,317,4.9,152041,145314,6727,4.4
Bienville,11/1/2006,6495,6179,316,4.9,152406,145534,6872,4.5
Bienville,12/1/2006,6450,6143,307,4.8,152732,145970,6762,4.4
Bienville,1/1/2007,6493,6126,367,5.7,153144,146028,7116,4.6
Bienville,2/1/2007,6504,6164,340,5.2,152983,146057,6927,4.5
Bienville,3/1/2007,6585,6257,328,5,153051,146320,6731,4.4
Bienville,4/1/2007,6551,6214,337,5.1,152435,145586,6850,4.5
Bienville,5/1/2007,6525,6179,346,5.3,152670,145903,6766,4.4
Bienville,6/1/2007,6569,6170,399,6.1,153041,146063,6979,4.6
Bienville,7/1/2007,6622,6234,388,5.9,153054,145905,7149,4.7
Bienville,8/1/2007,6656,6298,358,5.4,152749,145682,7067,4.6
Bienville,9/1/2007,6744,6407,337,5,153414,146244,7170,4.7
Bienville,10/1/2007,6647,6335,312,4.7,153183,145946,7237,4.7
Bienville,11/1/2007,6661,6350,311,4.7,153835,146595,7240,4.7
Bienville,12/1/2007,6579,6239,340,5.2,153918,146273,7645,5
Bienville,1/1/2008,6142,5770,372,6.1,154063,146378,7685,5
Bienville,2/1/2008,6091,5773,318,5.2,153653,146156,7497,4.9
Bienville,3/1/2008,6213,5876,337,5.4,153908,146086,7822,5.1
Bienville,4/1/2008,6131,5830,301,4.9,153769,146132,7637,5
Bienville,5/1/2008,6109,5771,338,5.5,154303,145908,8395,5.4
Bienville,6/1/2008,6178,5773,405,6.6,154313,145737,8575,5.6
Bienville,7/1/2008,6218,5813,405,6.5,154469,145532,8937,5.8
Bienville,8/1/2008,6211,5811,400,6.4,154641,145203,9438,6.1
Bienville,9/1/2008,6279,5920,359,5.7,154570,145076,9494,6.1
Bienville,10/1/2008,6136,5740,396,6.5,154876,144802,10074,6.5
Bienville,11/1/2008,6164,5750,414,6.7,154639,144100,10538,6.8
Bienville,12/1/2008,6028,5556,472,7.8,154655,143369,11286,7.3
Bienville,1/1/2009,6171,5579,592,9.6,154210,142152,12058,7.8
Bienville,2/1/2009,6216,5638,578,9.3,154538,141640,12898,8.3
Bienville,3/1/2009,6238,5651,587,9.4,154133,140707,13426,8.7
Bienville,4/1/2009,6245,5652,593,9.5,154509,140656,13853,9
Bienville,5/1/2009,6281,5708,573,9.1,154747,140248,14499,9.4
Bienville,6/1/2009,6485,5791,694,10.7,154716,140009,14707,9.5
Bienville,7/1/2009,6559,5876,683,10.4,154502,139901,14601,9.5
Bienville,8/1/2009,6347,5743,604,9.5,154307,139492,14814,9.6
Bienville,9/1/2009,6358,5764,594,9.3,153827,138818,15009,9.8
Bienville,10/1/2009,6297,5730,567,9,153784,138432,15352,10
Bienville,11/1/2009,6261,5738,523,8.4,153878,138659,15219,9.9
Bienville,12/1/2009,6235,5707,528,8.5,153111,138013,15098,9.9
Bienville,1/1/2010,5643,5059,584,10.3,153484,138438,15046,9.8
Bienville,2/1/2010,5734,5190,544,9.5,153694,138581,15113,9.8
Bienville,3/1/2010,5792,5252,540,9.3,153954,138751,15202,9.9
Bienville,4/1/2010,5904,5389,515,8.7,154622,139297,15325,9.9
Bienville,5/1/2010,5958,5413,545,9.1,154091,139241,14849,9.6
Bienville,6/1/2010,6065,5482,583,9.6,153616,139141,14474,9.4
Bienville,7/1/2010,6175,5586,589,9.5,153691,139179,14512,9.4
Bienville,8/1/2010,6032,5457,575,9.5,154086,139438,14648,9.5
Bienville,9/1/2010,5928,5367,561,9.5,153975,139396,14579,9.5
Bienville,10/1/2010,6012,5464,548,9.1,153635,139119,14516,9.4
Bienville,11/1/2010,5935,5386,549,9.3,154125,139044,15081,9.8
Bienville,12/1/2010,5864,5319,545,9.3,153650,139301,14348,9.3
Bienville,1/1/2011,5764,5159,605,10.5,153263,139250,14013,9.1
Bienville,2/1/2011,5767,5205,562,9.7,153214,139394,13820,9
Bienville,3/1/2011,5792,5233,559,9.7,153376,139639,13737,9
Bienville,4/1/2011,5843,5312,531,9.1,153543,139586,13957,9.1
Bienville,5/1/2011,5854,5312,542,9.3,153479,139624,13855,9
Bienville,6/1/2011,5962,5345,617,10.3,153346,139384,13962,9.1
Bienville,7/1/2011,6039,5453,586,9.7,153288,139524,13763,9
Bienville,8/1/2011,5963,5385,578,9.7,153760,139942,13818,9
Bienville,9/1/2011,5923,5341,582,9.8,154131,140183,13948,9
Bienville,10/1/2011,5925,5390,535,9,153961,140368,13594,8.8
Bienville,11/1/2011,5909,5382,527,8.9,154128,140826,13302,8.6
Bienville,12/1/2011,5867,5334,533,9.1,153995,140902,13093,8.5
Bienville,1/1/2012,5872,5312,560,9.5,154381,141584,12797,8.3
Bienville,2/1/2012,5849,5338,511,8.7,154671,141858,12813,8.3
Bienville,3/1/2012,5881,5372,509,8.7,154749,142036,12713,8.2
Bienville,4/1/2012,5877,5393,484,8.2,154545,141899,12646,8.2
Bienville,5/1/2012,5927,5412,515,8.7,154866,142206,12660,8.2
Bienville,6/1/2012,5979,5398,581,9.7,155083,142391,12692,8.2
Bienville,7/1/2012,6227,5667,560,9,154948,142292,12656,8.2
Bienville,8/1/2012,6097,5582,515,8.4,154763,142291,12471,8.1
Bienville,9/1/2012,6179,5702,477,7.7,155160,143044,12115,7.8
Bienville,10/1/2012,5967,5492,475,8,155554,143431,12124,7.8
Bienville,11/1/2012,5958,5506,452,7.6,155338,143333,12005,7.7
Bienville,12/1/2012,5965,5463,502,8.4,155628,143330,12298,7.9
Bienville,1/1/2013,5939,5384,555,9.3,155763,143292,12471,8
Bienville,2/1/2013,5940,5423,517,8.7,155312,143362,11950,7.7
Bienville,3/1/2013,5950,5439,511,8.6,155005,143316,11689,7.5
Bienville,4/1/2013,5921,5435,486,8.2,155394,143635,11760,7.6
Bienville,5/1/2013,5998,5489,509,8.5,155536,143882,11654,7.5
Bienville,6/1/2013,6086,5526,560,9.2,155749,143999,11751,7.5
Bienville,7/1/2013,6099,5587,512,8.4,155599,144264,11335,7.3
Bienville,8/1/2013,6003,5527,476,7.9,155605,144326,11279,7.2
Bienville,9/1/2013,5927,5438,489,8.3,155687,144418,11270,7.2
Bienville,10/1/2013,5826,5361,465,8,154673,143537,11136,7.2
Bienville,11/1/2013,5844,5412,432,7.4,155265,144479,10787,6.9
Bienville,12/1/2013,5778,5379,399,6.9,155182,144778,10404,6.7
Bienville,1/1/2014,5802,5374,428,7.4,155352,145150,10202,6.6
Bienville,2/1/2014,5828,5411,417,7.2,155483,145134,10349,6.7
Bienville,3/1/2014,5824,5398,426,7.3,156028,145648,10380,6.7
Bienville,4/1/2014,5791,5391,400,6.9,155369,145667,9702,6.2
Bienville,5/1/2014,5845,5406,439,7.5,155684,145825,9859,6.3
Bienville,6/1/2014,5931,5457,474,8,155707,146247,9460,6.1
Bienville,7/1/2014,5994,5492,502,8.4,156007,146399,9608,6.2
Bienville,8/1/2014,5960,5463,497,8.3,156130,146530,9599,6.1
Bienville,9/1/2014,5986,5499,487,8.1,156040,146778,9262,5.9
Bienville,10/1/2014,5962,5476,486,8.2,156417,147427,8990,5.7
Bienville,11/1/2014,5925,5451,474,8,156494,147404,9090,5.8
Bienville,12/1/2014,5922,5460,462,7.8,156332,147615,8717,5.6
Bienville,1/1/2015,5782,5275,507,8.8,157030,148145,8885,5.7
Bienville,2/1/2015,5753,5256,497,8.6,156644,148045,8599,5.5
Bienville,3/1/2015,5799,5279,520,9,156643,148128,8515,5.4
Bienville,4/1/2015,5794,5289,505,8.7,157060,148511,8550,5.4
Bienville,5/1/2015,5822,5324,498,8.6,157651,148817,8834,5.6
Bienville,6/1/2015,5904,5384,520,8.8,157062,148816,8247,5.3
Bienville,7/1/2015,5907,5394,513,8.7,156997,148830,8167,5.2
Bienville,8/1/2015,5752,5307,445,7.7,157172,149181,7992,5.1
Bienville,9/1/2015,5707,5279,428,7.5,156733,148826,7907,5
Bienville,10/1/2015,5701,5259,442,7.8,157167,149246,7922,5
Bienville,11/1/2015,5684,5263,421,7.4,157463,149463,8000,5.1
Bienville,12/1/2015,5670,5260,410,7.2,158035,150128,7907,5
Bienville,1/1/2016,5648,5211,437,7.7,158280,150653,7627,4.8
Bienville,2/1/2016,5645,5224,421,7.5,158640,150939,7702,4.9
Bienville,3/1/2016,5701,5260,441,7.7,159179,151218,7961,5
Bienville,4/1/2016,5710,5276,434,7.6,159141,151074,8067,5.1
Bienville,5/1/2016,5682,5242,440,7.7,158784,151132,7652,4.8
Bienville,6/1/2016,5791,5306,485,8.4,158967,151223,7744,4.9
Bienville,7/1/2016,5822,5357,465,8,159194,151554,7641,4.8
Bienville,8/1/2016,5662,5230,432,7.6,159562,151779,7784,4.9
Bienville,9/1/2016,5673,5229,444,7.8,159714,151761,7953,5
Bienville,10/1/2016,5534,5131,403,7.3,159605,151793,7811,4.9
Bienville,11/1/2016,5577,5206,371,6.7,159506,151954,7553,4.7
Bienville,12/1/2016,5502,5129,373,6.8,159678,152157,7521,4.7
Bienville,1/1/2017,5565,5166,399,7.2,159620,152152,7468,4.7
Bienville,2/1/2017,5605,5243,362,6.5,159859,152480,7379,4.6
Bienville,3/1/2017,5635,5292,343,6.1,160137,153065,7073,4.4
Bienville,4/1/2017,5637,5287,350,6.2,160345,153255,7089,4.4
Bienville,5/1/2017,5613,5285,328,5.8,160068,153069,7000,4.4
Bienville,6/1/2017,5692,5327,365,6.4,160192,153318,6873,4.3
Bienville,7/1/2017,5768,5398,370,6.4,160462,153569,6892,4.3
Bienville,8/1/2017,5646,5312,334,5.9,160586,153503,7082,4.4
Bienville,9/1/2017,5668,5342,326,5.8,161140,154286,6854,4.3
Bienville,10/1/2017,5527,5241,286,5.2,160309,153609,6700,4.2
Bienville,11/1/2017,5569,5279,290,5.2,160579,153805,6774,4.2
Bienville,12/1/2017,5589,5304,285,5.1,160535,153904,6632,4.1
Bienville,1/1/2018,5560,5259,301,5.4,160914,154425,6489,4
Bienville,2/1/2018,5616,5314,302,5.4,161778,155197,6581,4.1
Bienville,3/1/2018,5652,5351,301,5.3,161686,155214,6472,4
Bienville,4/1/2018,5694,5388,306,5.4,161771,155312,6459,4
Bienville,5/1/2018,5664,5353,311,5.5,161848,155652,6196,3.8
Bienville,6/1/2018,5790,5404,386,6.7,162210,155762,6447,4
Bienville,7/1/2018,5760,5394,366,6.4,162341,156146,6195,3.8
Bienville,8/1/2018,5708,5342,366,6.4,161660,155504,6156,3.8
Bienville,9/1/2018,5563,5221,342,6.1,162087,156015,6073,3.7
Bienville,10/1/2018,5558,5236,322,5.8,162602,156391,6211,3.8
Bienville,11/1/2018,5531,5245,286,5.2,162836,156721,6115,3.8
Bienville,12/1/2018,5522,5216,306,5.5,163206,156817,6389,3.9
Bienville,1/1/2019,5468,5115,353,6.5,162963,156487,6475,4
Bienville,2/1/2019,5470,5156,314,5.7,162999,156863,6136,3.8
Bienville,3/1/2019,5490,5200,290,5.3,162904,156701,6202,3.8
Bienville,4/1/2019,5418,5151,267,4.9,162586,156625,5961,3.7
Bienville,5/1/2019,5498,5203,295,5.4,162751,156821,5930,3.6
Bienville,6/1/2019,5592,5252,340,6.1,163168,157232,5935,3.6
Bienville,7/1/2019,5626,5283,343,6.1,163590,157529,6061,3.7
Bienville,8/1/2019,5595,5280,315,5.6,163774,157829,5945,3.6
Bienville,9/1/2019,5524,5218,306,5.5,164092,158339,5753,3.5
Bienville,10/1/2019,5503,5196,307,5.6,164416,158545,5871,3.6
Bienville,11/1/2019,5457,5147,310,5.7,164496,158629,5868,3.6
Bienville,12/1/2019,5393,5087,306,5.7,164699,158845,5853,3.6
Bienville,1/1/2020,5339,5025,314,5.9,164377,158508,5869,3.6
Bienville,2/1/2020,5345,5060,285,5.3,164467,158714,5753,3.5
Bienville,3/1/2020,5457,4968,489,9,162559,155353,7206,4.4
Bienville,4/1/2020,5004,4587,417,8.3,156269,133185,23084,14.8
Bienville,5/1/2020,5171,4666,505,9.8,158101,137173,20929,13.2
Bienville,6/1/2020,5335,4810,525,9.8,159994,142342,17652,11
Bienville,7/1/2020,5396,4862,534,9.9,160132,143779,16352,10.2
Bienville,8/1/2020,5406,4936,470,8.7,160706,147245,13461,8.4
Bienville,9/1/2020,5452,4953,499,9.2,160174,147620,12554,7.8
Bienville,10/1/2020,5460,5051,409,7.5,161003,149931,11072,6.9
Bienville,11/1/2020,5328,4964,364,6.8,160629,149934,10694,6.7
Bienville,12/1/2020,5363,4982,381,7.1,160745,149975,10770,6.7
Bienville,1/1/2021,5272,4885,387,7.3,160088,149852,10236,6.4
Bienville,2/1/2021,5240,4868,372,7.1,160184,150189,9995,6.2
Bienville,3/1/2021,5223,4885,338,6.5,160400,150644,9756,6.1
Bienville,4/1/2021,5185,4852,333,6.4,160843,151081,9762,6.1
Bienville,5/1/2021,5133,4788,345,6.7,160800,151535,9266,5.8
Bienville,6/1/2021,5227,4833,394,7.5,161197,151734,9462,5.9
Bienville,7/1/2021,5222,4888,334,6.4,161504,152773,8731,5.4
Bienville,8/1/2021,5132,4842,290,5.7,161527,153250,8276,5.1
Bienville,9/1/2021,5243,4996,247,4.7,161495,153843,7652,4.7
Bienville,10/1/2021,5147,4925,222,4.3,161754,154475,7279,4.5
Bienville,11/1/2021,5099,4895,204,4,162281,155530,6751,4.2
Bienville,12/1/2021,5086,4901,185,3.6,162497,156099,6398,3.9
Bienville,1/1/2022,5201,4960,241,4.6,163627,157115,6512,4
Bienville,2/1/2022,5215,4999,216,4.1,163899,157598,6301,3.8
Bienville,3/1/2022,5237,5034,203,3.9,164220,158206,6014,3.7
Bienville,4/1/2022,5229,5035,194,3.7,163893,157891,6002,3.7
Bienville,5/1/2022,5168,4955,213,4.1,164362,158378,5983,3.6
Bienville,6/1/2022,5188,4926,262,5.1,164046,158094,5951,3.6
Bienville,7/1/2022,5198,4957,241,4.6,164026,158258,5768,3.5
Bienville,8/1/2022,5134,4908,226,4.4,164654,158735,5919,3.6
Bienville,9/1/2022,5097,4887,210,4.1,164602,158810,5792,3.5
Bienville,10/1/2022,5081,4885,196,3.9,164648,158684,5964,3.6
Bienville,11/1/2022,5074,4879,195,3.8,164450,158507,5943,3.6
Bienville,12/1/2022,5086,4886,200,3.9,165025,159259,5766,3.5
Bienville,1/1/2023,5071,4838,233,4.6,165964,160217,5747,3.5
Bienville,2/1/2023,5104,4876,228,4.5,166358,160395,5962,3.6
Bienville,3/1/2023,5122,4902,220,4.3,166651,160812,5839,3.5
Bienville,4/1/2023,5112,4923,189,3.7,166725,160974,5751,3.4
Bienville,5/1/2023,5045,4832,213,4.2,166886,160796,6089,3.6
Bienville,6/1/2023,5125,4882,243,4.7,166937,160979,5958,3.6
Bienville,7/1/2023,5157,4953,204,4,167103,161183,5920,3.5
Bienville,8/1/2023,5094,4867,227,4.5,167759,161475,6284,3.7
Bienville,9/1/2023,5070,4841,229,4.5,167767,161442,6326,3.8
Bienville,10/1/2023,5056,4826,230,4.5,167690,161211,6479,3.9
Bienville,11/1/2023,5063,4845,218,4.3,168140,161886,6254,3.7
Bienville,12/1/2023,5060,4826,234,4.6,167439,161124,6315,3.8
Bienville,1/1/2024,5088,4810,278,5.5,167339,161190,6149,3.7
Bienville,2/1/2024,5046,4774,272,5.4,167475,161013,6462,3.9
Bienville,3/1/2024,5063,4795,268,5.3,167922,161425,6497,3.9
Bienville,4/1/2024,5049,4811,238,4.7,167988,161495,6492,3.9
Bienville,5/1/2024,4979,4749,230,4.6,167799,161164,6635,4
Bienville,6/1/2024,5136,4847,289,5.6,168005,161155,6849,4.1
Bienville,7/1/2024,5171,4886,285,5.5,168315,161219,7097,4.2
Bienville,8/1/2024,5087,4804,283,5.6,168496,161425,7071,4.2
Bienville,9/1/2024,5249,4973,276,5.3,168703,161802,6901,4.1
Bienville,10/1/2024,5203,4924,279,5.4,168428,161456,6972,4.1
Bienville,11/1/2024,5166,4890,276,5.3,168304,161183,7121,4.2
Bienville,12/1/2024,5152,4901,251,4.9,168547,161661,6886,4.1
Bienville,1/1/2025,4509,4252,257,5.7,170744,163895,6849,4
Bienville,2/1/2025,4440,4199,241,5.4,170359,163307,7052,4.1
Bossier,1/1/1990,38754,36067,2687,6.9,125833,119081,6752,5.4
Bossier,2/1/1990,39073,36879,2194,5.6,125710,119059,6651,5.3
Bossier,3/1/1990,39412,37241,2171,5.5,125801,119203,6598,5.2
Bossier,4/1/1990,39561,37295,2266,5.7,125649,118852,6797,5.4
Bossier,5/1/1990,39430,37406,2024,5.1,125893,119151,6742,5.4
Bossier,6/1/1990,40269,37864,2405,6,125573,118983,6590,5.2
Bossier,7/1/1990,40234,37976,2258,5.6,125732,118810,6922,5.5
Bossier,8/1/1990,40177,37675,2502,6.2,125990,118802,7188,5.7
Bossier,9/1/1990,40459,37793,2666,6.6,125892,118524,7368,5.9
Bossier,10/1/1990,40434,37783,2651,6.6,125995,118536,7459,5.9
Bossier,11/1/1990,40110,37663,2447,6.1,126070,118306,7764,6.2
Bossier,12/1/1990,40367,37453,2914,7.2,126142,118241,7901,6.3
Bossier,1/1/1991,40274,37406,2868,7.1,125955,117940,8015,6.4
Bossier,2/1/1991,39621,36982,2639,6.7,126020,117755,8265,6.6
Bossier,3/1/1991,39874,36958,2916,7.3,126238,117652,8586,6.8
Bossier,4/1/1991,40157,37552,2605,6.5,126548,118109,8439,6.7
Bossier,5/1/1991,39902,37429,2473,6.2,126176,117440,8736,6.9
Bossier,6/1/1991,40967,38302,2665,6.5,126331,117639,8692,6.9
Bossier,7/1/1991,40656,38284,2372,5.8,126154,117568,8586,6.8
Bossier,8/1/1991,40326,37878,2448,6.1,126150,117484,8666,6.9
Bossier,9/1/1991,40444,38055,2389,5.9,126650,117928,8722,6.9
Bossier,10/1/1991,40565,38068,2497,6.2,126642,117800,8842,7
Bossier,11/1/1991,39994,37637,2357,5.9,126701,117770,8931,7
Bossier,12/1/1991,40228,37424,2804,7,126664,117466,9198,7.3
Bossier,1/1/1992,40167,37155,3012,7.5,127261,117978,9283,7.3
Bossier,2/1/1992,39765,36871,2894,7.3,127207,117753,9454,7.4
Bossier,3/1/1992,40421,37748,2673,6.6,127604,118144,9460,7.4
Bossier,4/1/1992,40118,37777,2341,5.8,127841,118426,9415,7.4
Bossier,5/1/1992,40186,37915,2271,5.7,128119,118375,9744,7.6
Bossier,6/1/1992,41287,38499,2788,6.8,128459,118419,10040,7.8
Bossier,7/1/1992,41616,39275,2341,5.6,128563,118713,9850,7.7
Bossier,8/1/1992,41564,39131,2433,5.9,128613,118826,9787,7.6
Bossier,9/1/1992,41633,39242,2391,5.7,128501,118720,9781,7.6
Bossier,10/1/1992,41383,39118,2265,5.5,128026,118628,9398,7.3
Bossier,11/1/1992,41307,39304,2003,4.8,128441,118876,9565,7.4
Bossier,12/1/1992,40527,38403,2124,5.2,128554,118997,9557,7.4
Bossier,1/1/1993,40390,37880,2510,6.2,128400,119075,9325,7.3
Bossier,2/1/1993,40493,38177,2316,5.7,128458,119275,9183,7.1
Bossier,3/1/1993,40540,38258,2282,5.6,128598,119542,9056,7
Bossier,4/1/1993,40561,38266,2295,5.7,128584,119474,9110,7.1
Bossier,5/1/1993,40614,38335,2279,5.6,129264,120115,9149,7.1
Bossier,6/1/1993,41262,38661,2601,6.3,129411,120290,9121,7
Bossier,7/1/1993,41357,38987,2370,5.7,129397,120467,8930,6.9
Bossier,8/1/1993,41267,38928,2339,5.7,129619,120856,8763,6.8
Bossier,9/1/1993,40868,38445,2423,5.9,129268,120554,8714,6.7
Bossier,10/1/1993,41021,38523,2498,6.1,129573,120823,8750,6.8
Bossier,11/1/1993,41150,38662,2488,6,129711,121169,8542,6.6
Bossier,12/1/1993,41067,38356,2711,6.6,129941,121464,8477,6.5
Bossier,1/1/1994,41635,38423,3212,7.7,130596,121966,8630,6.6
Bossier,2/1/1994,41492,38694,2798,6.7,130669,122086,8583,6.6
Bossier,3/1/1994,41445,38717,2728,6.6,130400,121930,8470,6.5
Bossier,4/1/1994,41976,39360,2616,6.2,130621,122290,8331,6.4
Bossier,5/1/1994,41869,39570,2299,5.5,130779,122864,7915,6.1
Bossier,6/1/1994,42899,40210,2689,6.3,130561,122634,7927,6.1
Bossier,7/1/1994,42995,40499,2496,5.8,130652,122706,7946,6.1
Bossier,8/1/1994,43213,40717,2496,5.8,131275,123342,7933,6
Bossier,9/1/1994,43025,40393,2632,6.1,131421,123687,7734,5.9
Bossier,10/1/1994,42971,40306,2665,6.2,131744,124112,7632,5.8
Bossier,11/1/1994,42662,40162,2500,5.9,131891,124516,7375,5.6
Bossier,12/1/1994,42210,39802,2408,5.7,131951,124721,7230,5.5
Bossier,1/1/1995,42414,39554,2860,6.7,132038,124663,7375,5.6
Bossier,2/1/1995,42444,39938,2506,5.9,132115,124928,7187,5.4
Bossier,3/1/1995,42822,40315,2507,5.9,132108,124955,7153,5.4
Bossier,4/1/1995,43096,40626,2470,5.7,132590,124945,7645,5.8
Bossier,5/1/1995,42668,40396,2272,5.3,131851,124421,7430,5.6
Bossier,6/1/1995,43544,41015,2529,5.8,131949,124522,7427,5.6
Bossier,7/1/1995,43655,41279,2376,5.4,132343,124816,7527,5.7
Bossier,8/1/1995,43145,40858,2287,5.3,132336,124852,7484,5.7
Bossier,9/1/1995,42917,40534,2383,5.6,132611,125133,7478,5.6
Bossier,10/1/1995,43429,40924,2505,5.8,132716,125388,7328,5.5
Bossier,11/1/1995,43343,40904,2439,5.6,132614,125188,7426,5.6
Bossier,12/1/1995,43035,40721,2314,5.4,132511,125088,7423,5.6
Bossier,1/1/1996,43508,40719,2789,6.4,132616,125125,7491,5.6
Bossier,2/1/1996,43520,41122,2398,5.5,132952,125639,7313,5.5
Bossier,3/1/1996,43569,40916,2653,6.1,133180,125862,7318,5.5
Bossier,4/1/1996,43928,41531,2397,5.5,133409,125994,7415,5.6
Bossier,5/1/1996,44118,41667,2451,5.6,133667,126244,7423,5.6
Bossier,6/1/1996,44965,42164,2801,6.2,133697,126602,7095,5.3
Bossier,7/1/1996,45330,42586,2744,6.1,134284,126947,7337,5.5
Bossier,8/1/1996,45005,42283,2722,6,134054,127172,6882,5.1
Bossier,9/1/1996,45093,42318,2775,6.2,134515,127536,6979,5.2
Bossier,10/1/1996,45334,42660,2674,5.9,134921,127890,7031,5.2
Bossier,11/1/1996,45245,42721,2524,5.6,135007,127771,7236,5.4
Bossier,12/1/1996,45124,42593,2531,5.6,135113,127860,7253,5.4
Bossier,1/1/1997,45059,42154,2905,6.4,135456,128298,7158,5.3
Bossier,2/1/1997,44507,42086,2421,5.4,135400,128298,7102,5.2
Bossier,3/1/1997,45005,42437,2568,5.7,135891,128891,7000,5.2
Bossier,4/1/1997,44944,42481,2463,5.5,136016,129143,6873,5.1
Bossier,5/1/1997,44678,41882,2796,6.3,136119,129464,6655,4.9
Bossier,6/1/1997,46095,42928,3167,6.9,136211,129412,6799,5
Bossier,7/1/1997,46145,43404,2741,5.9,136477,129822,6655,4.9
Bossier,8/1/1997,45904,43014,2890,6.3,136618,130010,6608,4.8
Bossier,9/1/1997,45296,42646,2650,5.9,136675,130019,6656,4.9
Bossier,10/1/1997,45227,42757,2470,5.5,136633,130179,6454,4.7
Bossier,11/1/1997,45373,43169,2204,4.9,136961,130653,6308,4.6
Bossier,12/1/1997,45085,42825,2260,5,137155,130679,6476,4.7
Bossier,1/1/1998,44495,41922,2573,5.8,137095,130726,6368,4.6
Bossier,2/1/1998,44270,42100,2170,4.9,137112,130807,6306,4.6
Bossier,3/1/1998,44912,42526,2386,5.3,137236,130814,6422,4.7
Bossier,4/1/1998,45192,43025,2167,4.8,137150,131209,5941,4.3
Bossier,5/1/1998,45112,42823,2289,5.1,137372,131325,6047,4.4
Bossier,6/1/1998,46002,42850,3152,6.9,137455,131244,6212,4.5
Bossier,7/1/1998,46050,43045,3005,6.5,137588,131329,6259,4.5
Bossier,8/1/1998,45850,43342,2508,5.5,137570,131390,6179,4.5
Bossier,9/1/1998,45465,43152,2313,5.1,138286,131986,6300,4.6
Bossier,10/1/1998,45095,42912,2183,4.8,138279,131999,6280,4.5
Bossier,11/1/1998,44780,42830,1950,4.4,138381,132280,6100,4.4
Bossier,12/1/1998,44350,42560,1790,4,138634,132602,6032,4.4
Bossier,1/1/1999,44961,42776,2185,4.9,139003,133027,5976,4.3
Bossier,2/1/1999,44784,42898,1886,4.2,138967,132856,6111,4.4
Bossier,3/1/1999,45116,43295,1821,4,138730,132947,5783,4.2
Bossier,4/1/1999,45328,43551,1777,3.9,138959,132955,6004,4.3
Bossier,5/1/1999,45143,43421,1722,3.8,139107,133311,5796,4.2
Bossier,6/1/1999,46128,43945,2183,4.7,139329,133378,5951,4.3
Bossier,7/1/1999,46315,44250,2065,4.5,139439,133414,6025,4.3
Bossier,8/1/1999,45846,43891,1955,4.3,139430,133591,5838,4.2
Bossier,9/1/1999,45603,43514,2089,4.6,139622,133707,5915,4.2
Bossier,10/1/1999,45843,43881,1962,4.3,139771,133993,5778,4.1
Bossier,11/1/1999,45525,43802,1723,3.8,140025,134309,5716,4.1
Bossier,12/1/1999,45258,43576,1682,3.7,140177,134523,5653,4
Bossier,1/1/2000,46812,44483,2329,5,142267,136559,5708,4
Bossier,2/1/2000,46648,44584,2064,4.4,142456,136598,5858,4.1
Bossier,3/1/2000,46988,44853,2135,4.5,142434,136701,5733,4
Bossier,4/1/2000,46722,44794,1928,4.1,142751,137270,5481,3.8
Bossier,5/1/2000,46401,44236,2165,4.7,142388,136630,5758,4
Bossier,6/1/2000,47102,44627,2475,5.3,142591,136940,5651,4
Bossier,7/1/2000,47376,45132,2244,4.7,142278,136531,5747,4
Bossier,8/1/2000,47232,44943,2289,4.8,142514,136662,5853,4.1
Bossier,9/1/2000,46754,44493,2261,4.8,142518,136893,5625,3.9
Bossier,10/1/2000,47168,45012,2156,4.6,142622,137088,5534,3.9
Bossier,11/1/2000,46849,44790,2059,4.4,142962,137322,5639,3.9
Bossier,12/1/2000,46679,44683,1996,4.3,143248,137614,5634,3.9
Bossier,1/1/2001,47665,45083,2582,5.4,143800,137778,6023,4.2
Bossier,2/1/2001,47395,45281,2114,4.5,143701,137612,6089,4.2
Bossier,3/1/2001,47665,45300,2365,5,143924,137783,6141,4.3
Bossier,4/1/2001,47445,45257,2188,4.6,143569,137299,6271,4.4
Bossier,5/1/2001,46948,44757,2191,4.7,143318,137092,6226,4.3
Bossier,6/1/2001,47930,45237,2693,5.6,143357,136873,6484,4.5
Bossier,7/1/2001,47842,45416,2426,5.1,143654,137071,6583,4.6
Bossier,8/1/2001,47219,44832,2387,5.1,143284,136241,7042,4.9
Bossier,9/1/2001,46913,44410,2503,5.3,143989,136846,7142,5
Bossier,10/1/2001,47004,44410,2594,5.5,144086,136392,7694,5.3
Bossier,11/1/2001,46677,44066,2611,5.6,144240,136238,8003,5.5
Bossier,12/1/2001,46361,43754,2607,5.6,144305,136047,8258,5.7
Bossier,1/1/2002,46566,43394,3172,6.8,143883,135701,8182,5.7
Bossier,2/1/2002,46675,43984,2691,5.8,144653,136438,8215,5.7
Bossier,3/1/2002,46598,43954,2644,5.7,144481,136177,8304,5.7
Bossier,4/1/2002,46771,44168,2603,5.6,144725,136126,8599,5.9
Bossier,5/1/2002,46589,43915,2674,5.7,144938,136539,8399,5.8
Bossier,6/1/2002,47423,44347,3076,6.5,144808,136415,8393,5.8
Bossier,7/1/2002,47559,44766,2793,5.9,144803,136413,8390,5.8
Bossier,8/1/2002,47390,44652,2738,5.8,145009,136705,8304,5.7
Bossier,9/1/2002,47309,44526,2783,5.9,145552,137302,8251,5.7
Bossier,10/1/2002,47135,44410,2725,5.8,145314,137008,8307,5.7
Bossier,11/1/2002,46791,44041,2750,5.9,145041,136521,8520,5.9
Bossier,12/1/2002,46614,43828,2786,6,145066,136426,8640,6
Bossier,1/1/2003,46762,43570,3192,6.8,145937,137417,8520,5.8
Bossier,2/1/2003,46733,43822,2911,6.2,146100,137482,8618,5.9
Bossier,3/1/2003,47025,43989,3036,6.5,146022,137434,8588,5.9
Bossier,4/1/2003,47140,44180,2960,6.3,146474,137633,8842,6
Bossier,5/1/2003,47349,44262,3087,6.5,146500,137544,8957,6.1
Bossier,6/1/2003,48439,44834,3605,7.4,147056,137790,9266,6.3
Bossier,7/1/2003,48522,45245,3277,6.8,146485,137474,9011,6.2
Bossier,8/1/2003,48062,45062,3000,6.2,146445,137549,8896,6.1
Bossier,9/1/2003,47631,44785,2846,6,146530,137609,8921,6.1
Bossier,10/1/2003,47708,45060,2648,5.6,146716,137984,8732,6
Bossier,11/1/2003,47757,45336,2421,5.1,147000,138424,8576,5.8
Bossier,12/1/2003,47854,45447,2407,5,146729,138411,8317,5.7
Bossier,1/1/2004,47997,45042,2955,6.2,146842,138472,8370,5.7
Bossier,2/1/2004,47773,45216,2557,5.4,146709,138542,8167,5.6
Bossier,3/1/2004,48040,45339,2701,5.6,146944,138453,8491,5.8
Bossier,4/1/2004,48391,45913,2478,5.1,146850,138680,8170,5.6
Bossier,5/1/2004,48337,45851,2486,5.1,147065,138852,8212,5.6
Bossier,6/1/2004,49472,46511,2961,6,147460,139174,8286,5.6
Bossier,7/1/2004,49842,47155,2687,5.4,147692,139556,8136,5.5
Bossier,8/1/2004,49222,46892,2330,4.7,147564,139573,7990,5.4
Bossier,9/1/2004,49185,46747,2438,5,147415,139487,7927,5.4
Bossier,10/1/2004,49432,46927,2505,5.1,147793,139732,8061,5.5
Bossier,11/1/2004,49431,46997,2434,4.9,148162,140231,7932,5.4
Bossier,12/1/2004,49423,47077,2346,4.7,148059,140125,7934,5.4
Bossier,1/1/2005,49783,47099,2684,5.4,148029,140245,7784,5.3
Bossier,2/1/2005,49713,47224,2489,5,148364,140385,7980,5.4
Bossier,3/1/2005,49879,47495,2384,4.8,148391,140654,7737,5.2
Bossier,4/1/2005,50155,47908,2247,4.5,148926,141254,7672,5.2
Bossier,5/1/2005,50242,47842,2400,4.8,149261,141609,7651,5.1
Bossier,6/1/2005,50946,48069,2877,5.6,149238,141714,7524,5
Bossier,7/1/2005,50899,48226,2673,5.3,149432,142026,7406,5
Bossier,8/1/2005,50625,48250,2375,4.7,149779,142434,7345,4.9
Bossier,9/1/2005,55275,51396,3879,7,149954,142401,7553,5
Bossier,10/1/2005,55732,52239,3493,6.3,150001,142548,7453,5
Bossier,11/1/2005,55568,52042,3526,6.3,150065,142499,7566,5
Bossier,12/1/2005,53779,51538,2241,4.2,150030,142752,7279,4.9
Bossier,1/1/2006,53215,51288,1927,3.6,150214,143150,7064,4.7
Bossier,2/1/2006,52898,51333,1565,3,150641,143457,7184,4.8
Bossier,3/1/2006,52858,51243,1615,3.1,150813,143741,7072,4.7
Bossier,4/1/2006,52488,50888,1600,3,150881,143761,7120,4.7
Bossier,5/1/2006,52804,51011,1793,3.4,151069,144089,6980,4.6
Bossier,6/1/2006,53751,51544,2207,4.1,151354,144353,7001,4.6
Bossier,7/1/2006,53421,51432,1989,3.7,151377,144202,7175,4.7
Bossier,8/1/2006,52777,50891,1886,3.6,151716,144625,7091,4.7
Bossier,9/1/2006,52139,50257,1882,3.6,151662,144815,6847,4.5
Bossier,10/1/2006,52264,50360,1904,3.6,152041,145314,6727,4.4
Bossier,11/1/2006,52230,50302,1928,3.7,152406,145534,6872,4.5
Bossier,12/1/2006,51875,50046,1829,3.5,152732,145970,6762,4.4
Bossier,1/1/2007,52403,49916,2487,4.7,153144,146028,7116,4.6
Bossier,2/1/2007,52159,50266,1893,3.6,152983,146057,6927,4.5
Bossier,3/1/2007,52677,50782,1895,3.6,153051,146320,6731,4.4
Bossier,4/1/2007,52954,51037,1917,3.6,152435,145586,6850,4.5
Bossier,5/1/2007,52989,50860,2129,4,152670,145903,6766,4.4
Bossier,6/1/2007,53918,51427,2491,4.6,153041,146063,6979,4.6
Bossier,7/1/2007,54343,51961,2382,4.4,153054,145905,7149,4.7
Bossier,8/1/2007,53736,51580,2156,4,152749,145682,7067,4.6
Bossier,9/1/2007,53374,51229,2145,4,153414,146244,7170,4.7
Bossier,10/1/2007,53012,51155,1857,3.5,153183,145946,7237,4.7
Bossier,11/1/2007,53456,51623,1833,3.4,153835,146595,7240,4.7
Bossier,12/1/2007,53440,51537,1903,3.6,153918,146273,7645,5
Bossier,1/1/2008,53381,51267,2114,4,154063,146378,7685,5
Bossier,2/1/2008,53388,51543,1845,3.5,153653,146156,7497,4.9
Bossier,3/1/2008,53866,51782,2084,3.9,153908,146086,7822,5.1
Bossier,4/1/2008,53976,52165,1811,3.4,153769,146132,7637,5
Bossier,5/1/2008,54055,51938,2117,3.9,154303,145908,8395,5.4
Bossier,6/1/2008,55239,52611,2628,4.8,154313,145737,8575,5.6
Bossier,7/1/2008,55729,53174,2555,4.6,154469,145532,8937,5.8
Bossier,8/1/2008,56357,53841,2516,4.5,154641,145203,9438,6.1
Bossier,9/1/2008,56303,54035,2268,4,154570,145076,9494,6.1
Bossier,10/1/2008,54653,52078,2575,4.7,154876,144802,10074,6.5
Bossier,11/1/2008,54358,51747,2611,4.8,154639,144100,10538,6.8
Bossier,12/1/2008,54122,51379,2743,5.1,154655,143369,11286,7.3
Bossier,1/1/2009,54194,50810,3384,6.2,154210,142152,12058,7.8
Bossier,2/1/2009,53924,50714,3210,6,154538,141640,12898,8.3
Bossier,3/1/2009,54060,50915,3145,5.8,154133,140707,13426,8.7
Bossier,4/1/2009,54547,51566,2981,5.5,154509,140656,13853,9
Bossier,5/1/2009,54171,51039,3132,5.8,154747,140248,14499,9.4
Bossier,6/1/2009,55272,51631,3641,6.6,154716,140009,14707,9.5
Bossier,7/1/2009,55631,52004,3627,6.5,154502,139901,14601,9.5
Bossier,8/1/2009,54646,51371,3275,6,154307,139492,14814,9.6
Bossier,9/1/2009,54277,51121,3156,5.8,153827,138818,15009,9.8
Bossier,10/1/2009,53916,50807,3109,5.8,153784,138432,15352,10
Bossier,11/1/2009,54226,51288,2938,5.4,153878,138659,15219,9.9
Bossier,12/1/2009,53591,50662,2929,5.5,153111,138013,15098,9.9
Bossier,1/1/2010,55852,52562,3290,5.9,153484,138438,15046,9.8
Bossier,2/1/2010,55633,52621,3012,5.4,153694,138581,15113,9.8
Bossier,3/1/2010,56142,53213,2929,5.2,153954,138751,15202,9.9
Bossier,4/1/2010,56832,53914,2918,5.1,154622,139297,15325,9.9
Bossier,5/1/2010,56761,53679,3082,5.4,154091,139241,14849,9.6
Bossier,6/1/2010,57594,54123,3471,6,153616,139141,14474,9.4
Bossier,7/1/2010,57767,54374,3393,5.9,153691,139179,14512,9.4
Bossier,8/1/2010,57085,53705,3380,5.9,154086,139438,14648,9.5
Bossier,9/1/2010,56823,53526,3297,5.8,153975,139396,14579,9.5
Bossier,10/1/2010,57076,53754,3322,5.8,153635,139119,14516,9.4
Bossier,11/1/2010,56929,53657,3272,5.7,154125,139044,15081,9.8
Bossier,12/1/2010,56558,53545,3013,5.3,153650,139301,14348,9.3
Bossier,1/1/2011,56854,53410,3444,6.1,153263,139250,14013,9.1
Bossier,2/1/2011,56822,53749,3073,5.4,153214,139394,13820,9
Bossier,3/1/2011,57211,54217,2994,5.2,153376,139639,13737,9
Bossier,4/1/2011,57226,54277,2949,5.2,153543,139586,13957,9.1
Bossier,5/1/2011,57166,54050,3116,5.5,153479,139624,13855,9
Bossier,6/1/2011,57592,54136,3456,6,153346,139384,13962,9.1
Bossier,7/1/2011,57980,54634,3346,5.8,153288,139524,13763,9
Bossier,8/1/2011,57476,54318,3158,5.5,153760,139942,13818,9
Bossier,9/1/2011,57450,54228,3222,5.6,154131,140183,13948,9
Bossier,10/1/2011,57284,54104,3180,5.6,153961,140368,13594,8.8
Bossier,11/1/2011,57355,54347,3008,5.2,154128,140826,13302,8.6
Bossier,12/1/2011,56815,53939,2876,5.1,153995,140902,13093,8.5
Bossier,1/1/2012,57548,54249,3299,5.7,154381,141584,12797,8.3
Bossier,2/1/2012,57506,54459,3047,5.3,154671,141858,12813,8.3
Bossier,3/1/2012,57904,54830,3074,5.3,154749,142036,12713,8.2
Bossier,4/1/2012,57966,55043,2923,5,154545,141899,12646,8.2
Bossier,5/1/2012,57983,54790,3193,5.5,154866,142206,12660,8.2
Bossier,6/1/2012,58627,54960,3667,6.3,155083,142391,12692,8.2
Bossier,7/1/2012,58527,55084,3443,5.9,154948,142292,12656,8.2
Bossier,8/1/2012,57657,54447,3210,5.6,154763,142291,12471,8.1
Bossier,9/1/2012,57198,54182,3016,5.3,155160,143044,12115,7.8
Bossier,10/1/2012,57482,54402,3080,5.4,155554,143431,12124,7.8
Bossier,11/1/2012,57060,54225,2835,5,155338,143333,12005,7.7
Bossier,12/1/2012,56816,53749,3067,5.4,155628,143330,12298,7.9
Bossier,1/1/2013,56754,53019,3735,6.6,155763,143292,12471,8
Bossier,2/1/2013,56344,53086,3258,5.8,155312,143362,11950,7.7
Bossier,3/1/2013,56650,53478,3172,5.6,155005,143316,11689,7.5
Bossier,4/1/2013,57297,54138,3159,5.5,155394,143635,11760,7.6
Bossier,5/1/2013,57381,53976,3405,5.9,155536,143882,11654,7.5
Bossier,6/1/2013,58160,54286,3874,6.7,155749,143999,11751,7.5
Bossier,7/1/2013,57894,54320,3574,6.2,155599,144264,11335,7.3
Bossier,8/1/2013,56877,53520,3357,5.9,155605,144326,11279,7.2
Bossier,9/1/2013,56558,53355,3203,5.7,155687,144418,11270,7.2
Bossier,10/1/2013,56343,53194,3149,5.6,154673,143537,11136,7.2
Bossier,11/1/2013,56532,53648,2884,5.1,155265,144479,10787,6.9
Bossier,12/1/2013,56049,53468,2581,4.6,155182,144778,10404,6.7
Bossier,1/1/2014,56665,53730,2935,5.2,155352,145150,10202,6.6
Bossier,2/1/2014,56658,53940,2718,4.8,155483,145134,10349,6.7
Bossier,3/1/2014,57342,54440,2902,5.1,156028,145648,10380,6.7
Bossier,4/1/2014,57445,54712,2733,4.8,155369,145667,9702,6.2
Bossier,5/1/2014,57619,54526,3093,5.4,155684,145825,9859,6.3
Bossier,6/1/2014,58299,54857,3442,5.9,155707,146247,9460,6.1
Bossier,7/1/2014,58844,55164,3680,6.3,156007,146399,9608,6.2
Bossier,8/1/2014,58241,54595,3646,6.3,156130,146530,9599,6.1
Bossier,9/1/2014,58013,54476,3537,6.1,156040,146778,9262,5.9
Bossier,10/1/2014,58543,54996,3547,6.1,156417,147427,8990,5.7
Bossier,11/1/2014,58538,54999,3539,6,156494,147404,9090,5.8
Bossier,12/1/2014,58015,54803,3212,5.5,156332,147615,8717,5.6
Bossier,1/1/2015,58033,54491,3542,6.1,157030,148145,8885,5.7
Bossier,2/1/2015,57873,54629,3244,5.6,156644,148045,8599,5.5
Bossier,3/1/2015,58165,54883,3282,5.6,156643,148128,8515,5.4
Bossier,4/1/2015,58511,55321,3190,5.5,157060,148511,8550,5.4
Bossier,5/1/2015,58288,54938,3350,5.7,157651,148817,8834,5.6
Bossier,6/1/2015,58497,54950,3547,6.1,157062,148816,8247,5.3
Bossier,7/1/2015,58564,55097,3467,5.9,156997,148830,8167,5.2
Bossier,8/1/2015,57766,54566,3200,5.5,157172,149181,7992,5.1
Bossier,9/1/2015,57382,54216,3166,5.5,156733,148826,7907,5
Bossier,10/1/2015,57348,54191,3157,5.5,157167,149246,7922,5
Bossier,11/1/2015,57248,54282,2966,5.2,157463,149463,8000,5.1
Bossier,12/1/2015,56996,54273,2723,4.8,158035,150128,7907,5
Bossier,1/1/2016,57494,54352,3142,5.5,158280,150653,7627,4.8
Bossier,2/1/2016,57659,54789,2870,5,158640,150939,7702,4.9
Bossier,3/1/2016,57943,54986,2957,5.1,159179,151218,7961,5
Bossier,4/1/2016,57823,54952,2871,5,159141,151074,8067,5.1
Bossier,5/1/2016,57579,54682,2897,5,158784,151132,7652,4.8
Bossier,6/1/2016,58353,54895,3458,5.9,158967,151223,7744,4.9
Bossier,7/1/2016,58228,54835,3393,5.8,159194,151554,7641,4.8
Bossier,8/1/2016,57400,54187,3213,5.6,159562,151779,7784,4.9
Bossier,9/1/2016,57293,54053,3240,5.7,159714,151761,7953,5
Bossier,10/1/2016,57126,54099,3027,5.3,159605,151793,7811,4.9
Bossier,11/1/2016,57172,54360,2812,4.9,159506,151954,7553,4.7
Bossier,12/1/2016,56706,54050,2656,4.7,159678,152157,7521,4.7
Bossier,1/1/2017,57179,54219,2960,5.2,159620,152152,7468,4.7
Bossier,2/1/2017,57158,54436,2722,4.8,159859,152480,7379,4.6
Bossier,3/1/2017,57572,54952,2620,4.6,160137,153065,7073,4.4
Bossier,4/1/2017,57465,54932,2533,4.4,160345,153255,7089,4.4
Bossier,5/1/2017,56930,54397,2533,4.4,160068,153069,7000,4.4
Bossier,6/1/2017,57822,54989,2833,4.9,160192,153318,6873,4.3
Bossier,7/1/2017,58353,55552,2801,4.8,160462,153569,6892,4.3
Bossier,8/1/2017,57807,55099,2708,4.7,160586,153503,7082,4.4
Bossier,9/1/2017,57963,55465,2498,4.3,161140,154286,6854,4.3
Bossier,10/1/2017,57461,55247,2214,3.9,160309,153609,6700,4.2
Bossier,11/1/2017,57580,55340,2240,3.9,160579,153805,6774,4.2
Bossier,12/1/2017,57376,55260,2116,3.7,160535,153904,6632,4.1
Bossier,1/1/2018,57513,55192,2321,4,160914,154425,6489,4
Bossier,2/1/2018,57780,55578,2202,3.8,161778,155197,6581,4.1
Bossier,3/1/2018,58007,55696,2311,4,161686,155214,6472,4
Bossier,4/1/2018,58272,55956,2316,4,161771,155312,6459,4
Bossier,5/1/2018,57997,55581,2416,4.2,161848,155652,6196,3.8
Bossier,6/1/2018,58860,55747,3113,5.3,162210,155762,6447,4
Bossier,7/1/2018,59016,56211,2805,4.8,162341,156146,6195,3.8
Bossier,8/1/2018,57803,55243,2560,4.4,161660,155504,6156,3.8
Bossier,9/1/2018,57506,55092,2414,4.2,162087,156015,6073,3.7
Bossier,10/1/2018,57600,55233,2367,4.1,162602,156391,6211,3.8
Bossier,11/1/2018,57649,55386,2263,3.9,162836,156721,6115,3.8
Bossier,12/1/2018,57319,55128,2191,3.8,163206,156817,6389,3.9
Bossier,1/1/2019,57602,55035,2567,4.5,162963,156487,6475,4
Bossier,2/1/2019,57625,55451,2174,3.8,162999,156863,6136,3.8
Bossier,3/1/2019,57870,55798,2072,3.6,162904,156701,6202,3.8
Bossier,4/1/2019,57675,55719,1956,3.4,162586,156625,5961,3.7
Bossier,5/1/2019,57635,55353,2282,4,162751,156821,5930,3.6
Bossier,6/1/2019,58471,55630,2841,4.9,163168,157232,5935,3.6
Bossier,7/1/2019,58777,56009,2768,4.7,163590,157529,6061,3.7
Bossier,8/1/2019,57910,55386,2524,4.4,163774,157829,5945,3.6
Bossier,9/1/2019,57847,55404,2443,4.2,164092,158339,5753,3.5
Bossier,10/1/2019,57799,55321,2478,4.3,164416,158545,5871,3.6
Bossier,11/1/2019,57916,55502,2414,4.2,164496,158629,5868,3.6
Bossier,12/1/2019,57369,55127,2242,3.9,164699,158845,5853,3.6
Bossier,1/1/2020,57429,54977,2452,4.3,164377,158508,5869,3.6
Bossier,2/1/2020,57075,55131,1944,3.4,164467,158714,5753,3.5
Bossier,3/1/2020,57925,54510,3415,5.9,162559,155353,7206,4.4
Bossier,4/1/2020,53732,48084,5648,10.5,156269,133185,23084,14.8
Bossier,5/1/2020,54301,48811,5490,10.1,158101,137173,20929,13.2
Bossier,6/1/2020,56377,51382,4995,8.9,159994,142342,17652,11
Bossier,7/1/2020,56768,52174,4594,8.1,160132,143779,16352,10.2
Bossier,8/1/2020,56373,52666,3707,6.6,160706,147245,13461,8.4
Bossier,9/1/2020,56586,52870,3716,6.6,160174,147620,12554,7.8
Bossier,10/1/2020,57088,53737,3351,5.9,161003,149931,11072,6.9
Bossier,11/1/2020,56758,53904,2854,5,160629,149934,10694,6.7
Bossier,12/1/2020,56277,53443,2834,5,160745,149975,10770,6.7
Bossier,1/1/2021,55759,52882,2877,5.2,160088,149852,10236,6.4
Bossier,2/1/2021,55902,53243,2659,4.8,160184,150189,9995,6.2
Bossier,3/1/2021,56345,53844,2501,4.4,160400,150644,9756,6.1
Bossier,4/1/2021,56412,53950,2462,4.4,160843,151081,9762,6.1
Bossier,5/1/2021,56262,53824,2438,4.3,160800,151535,9266,5.8
Bossier,6/1/2021,57254,54408,2846,5,161197,151734,9462,5.9
Bossier,7/1/2021,57455,54978,2477,4.3,161504,152773,8731,5.4
Bossier,8/1/2021,56609,54435,2174,3.8,161527,153250,8276,5.1
Bossier,9/1/2021,57762,55765,1997,3.5,161495,153843,7652,4.7
Bossier,10/1/2021,56828,55017,1811,3.2,161754,154475,7279,4.5
Bossier,11/1/2021,57029,55406,1623,2.8,162281,155530,6751,4.2
Bossier,12/1/2021,56851,55387,1464,2.6,162497,156099,6398,3.9
Bossier,1/1/2022,57011,55164,1847,3.2,163627,157115,6512,4
Bossier,2/1/2022,57147,55500,1647,2.9,163899,157598,6301,3.8
Bossier,3/1/2022,57568,55979,1589,2.8,164220,158206,6014,3.7
Bossier,4/1/2022,57447,55957,1490,2.6,163893,157891,6002,3.7
Bossier,5/1/2022,57505,55868,1637,2.8,164362,158378,5983,3.6
Bossier,6/1/2022,58493,56302,2191,3.7,164046,158094,5951,3.6
Bossier,7/1/2022,58438,56459,1979,3.4,164026,158258,5768,3.5
Bossier,8/1/2022,57503,55654,1849,3.2,164654,158735,5919,3.6
Bossier,9/1/2022,57434,55686,1748,3,164602,158810,5792,3.5
Bossier,10/1/2022,57449,55798,1651,2.9,164648,158684,5964,3.6
Bossier,11/1/2022,57566,55991,1575,2.7,164450,158507,5943,3.6
Bossier,12/1/2022,57367,55765,1602,2.8,165025,159259,5766,3.5
Bossier,1/1/2023,57407,55581,1826,3.2,165964,160217,5747,3.5
Bossier,2/1/2023,57865,56108,1757,3,166358,160395,5962,3.6
Bossier,3/1/2023,58005,56340,1665,2.9,166651,160812,5839,3.5
Bossier,4/1/2023,58163,56634,1529,2.6,166725,160974,5751,3.4
Bossier,5/1/2023,57903,56075,1828,3.2,166886,160796,6089,3.6
Bossier,6/1/2023,58541,56386,2155,3.7,166937,160979,5958,3.6
Bossier,7/1/2023,58323,56497,1826,3.1,167103,161183,5920,3.5
Bossier,8/1/2023,57586,55669,1917,3.3,167759,161475,6284,3.7
Bossier,9/1/2023,57637,55534,2103,3.6,167767,161442,6326,3.8
Bossier,10/1/2023,57721,55630,2091,3.6,167690,161211,6479,3.9
Bossier,11/1/2023,57747,55772,1975,3.4,168140,161886,6254,3.7
Bossier,12/1/2023,57344,55319,2025,3.5,167439,161124,6315,3.8
Bossier,1/1/2024,57244,54980,2264,4,167339,161190,6149,3.7
Bossier,2/1/2024,57292,55124,2168,3.8,167475,161013,6462,3.9
Bossier,3/1/2024,57962,55858,2104,3.6,167922,161425,6497,3.9
Bossier,4/1/2024,57707,55885,1822,3.2,167988,161495,6492,3.9
Bossier,5/1/2024,57268,55283,1985,3.5,167799,161164,6635,4
Bossier,6/1/2024,58383,55870,2513,4.3,168005,161155,6849,4.1
Bossier,7/1/2024,58592,56113,2479,4.2,168315,161219,7097,4.2
Bossier,8/1/2024,57832,55348,2484,4.3,168496,161425,7071,4.2
Bossier,9/1/2024,57732,55304,2428,4.2,168703,161802,6901,4.1
Bossier,10/1/2024,57666,55269,2397,4.2,168428,161456,6972,4.1
Bossier,11/1/2024,57628,55336,2292,4,168304,161183,7121,4.2
Bossier,12/1/2024,57394,55266,2128,3.7,168547,161661,6886,4.1
Bossier,1/1/2025,56793,54612,2181,3.8,170744,163895,6849,4
Bossier,2/1/2025,57446,55271,2175,3.8,170359,163307,7052,4.1
Caddo,1/1/1990,112014,101608,10406,9.3,125833,119081,6752,5.4
Caddo,2/1/1990,110225,103893,6332,5.7,125710,119059,6651,5.3
Caddo,3/1/1990,111122,104914,6208,5.6,125801,119203,6598,5.2
Caddo,4/1/1990,111008,105067,5941,5.4,125649,118852,6797,5.4
Caddo,5/1/1990,111468,105383,6085,5.5,125893,119151,6742,5.4
Caddo,6/1/1990,113887,106669,7218,6.3,125573,118983,6590,5.2
Caddo,7/1/1990,113738,106987,6751,5.9,125732,118810,6922,5.5
Caddo,8/1/1990,113437,106139,7298,6.4,125990,118802,7188,5.7
Caddo,9/1/1990,114171,106467,7704,6.7,125892,118524,7368,5.9
Caddo,10/1/1990,114061,106441,7620,6.7,125995,118536,7459,5.9
Caddo,11/1/1990,113572,106103,7469,6.6,126070,118306,7764,6.2
Caddo,12/1/1990,112924,105514,7410,6.6,126142,118241,7901,6.3
Caddo,1/1/1991,112938,104513,8425,7.5,125955,117940,8015,6.4
Caddo,2/1/1991,110936,103330,7606,6.9,126020,117755,8265,6.6
Caddo,3/1/1991,114376,103263,11113,9.7,126238,117652,8586,6.8
Caddo,4/1/1991,112482,104918,7564,6.7,126548,118109,8439,6.7
Caddo,5/1/1991,111940,104577,7363,6.6,126176,117440,8736,6.9
Caddo,6/1/1991,115332,107016,8316,7.2,126331,117639,8692,6.9
Caddo,7/1/1991,114532,106963,7569,6.6,126154,117568,8586,6.8
Caddo,8/1/1991,113419,105832,7587,6.7,126150,117484,8666,6.9
Caddo,9/1/1991,113860,106323,7537,6.6,126650,117928,8722,6.9
Caddo,10/1/1991,113748,106362,7386,6.5,126642,117800,8842,7
Caddo,11/1/1991,112099,105154,6945,6.2,126701,117770,8931,7
Caddo,12/1/1991,111478,104560,6918,6.2,126664,117466,9198,7.3
Caddo,1/1/1992,111683,103793,7890,7.1,127261,117978,9283,7.3
Caddo,2/1/1992,113053,102996,10057,8.9,127207,117753,9454,7.4
Caddo,3/1/1992,112193,105444,6749,6,127604,118144,9460,7.4
Caddo,4/1/1992,111916,105523,6393,5.7,127841,118426,9415,7.4
Caddo,5/1/1992,112544,105911,6633,5.9,128119,118375,9744,7.6
Caddo,6/1/1992,115578,107542,8036,7,128459,118419,10040,7.8
Caddo,7/1/1992,116779,109710,7069,6.1,128563,118713,9850,7.7
Caddo,8/1/1992,116491,109309,7182,6.2,128613,118826,9787,7.6
Caddo,9/1/1992,116493,109614,6879,5.9,128501,118720,9781,7.6
Caddo,10/1/1992,115588,109272,6316,5.5,128026,118628,9398,7.3
Caddo,11/1/1992,115834,109792,6042,5.2,128441,118876,9565,7.4
Caddo,12/1/1992,113272,107278,5994,5.3,128554,118997,9557,7.4
Caddo,1/1/1993,110864,104252,6612,6,128400,119075,9325,7.3
Caddo,2/1/1993,111091,105071,6020,5.4,128458,119275,9183,7.1
Caddo,3/1/1993,111287,105289,5998,5.4,128598,119542,9056,7
Caddo,4/1/1993,111272,105314,5958,5.4,128584,119474,9110,7.1
Caddo,5/1/1993,111918,105507,6411,5.7,129264,120115,9149,7.1
Caddo,6/1/1993,113973,106402,7571,6.6,129411,120290,9121,7
Caddo,7/1/1993,114214,107300,6914,6.1,129397,120467,8930,6.9
Caddo,8/1/1993,114051,107136,6915,6.1,129619,120856,8763,6.8
Caddo,9/1/1993,112867,105806,7061,6.3,129268,120554,8714,6.7
Caddo,10/1/1993,113181,106023,7158,6.3,129573,120823,8750,6.8
Caddo,11/1/1993,113134,106408,6726,5.9,129711,121169,8542,6.6
Caddo,12/1/1993,112642,105561,7081,6.3,129941,121464,8477,6.5
Caddo,1/1/1994,111816,103508,8308,7.4,130596,121966,8630,6.6
Caddo,2/1/1994,111838,104239,7599,6.8,130669,122086,8583,6.6
Caddo,3/1/1994,111843,104303,7540,6.7,130400,121930,8470,6.5
Caddo,4/1/1994,113553,106036,7517,6.6,130621,122290,8331,6.4
Caddo,5/1/1994,113883,106603,7280,6.4,130779,122864,7915,6.1
Caddo,6/1/1994,116580,108325,8255,7.1,130561,122634,7927,6.1
Caddo,7/1/1994,117270,109100,8170,7,130652,122706,7946,6.1
Caddo,8/1/1994,117752,109690,8062,6.8,131275,123342,7933,6
Caddo,9/1/1994,116624,108819,7805,6.7,131421,123687,7734,5.9
Caddo,10/1/1994,116222,108582,7640,6.6,131744,124112,7632,5.8
Caddo,11/1/1994,115087,108198,6889,6,131891,124516,7375,5.6
Caddo,12/1/1994,113702,107224,6478,5.7,131951,124721,7230,5.5
Caddo,1/1/1995,113065,105259,7806,6.9,132038,124663,7375,5.6
Caddo,2/1/1995,112963,106279,6684,5.9,132115,124928,7187,5.4
Caddo,3/1/1995,114429,107283,7146,6.2,132108,124955,7153,5.4
Caddo,4/1/1995,115321,108112,7209,6.3,132590,124945,7645,5.8
Caddo,5/1/1995,114629,107497,7132,6.2,131851,124421,7430,5.6
Caddo,6/1/1995,117528,109149,8379,7.1,131949,124522,7427,5.6
Caddo,7/1/1995,117900,109850,8050,6.8,132343,124816,7527,5.7
Caddo,8/1/1995,116796,108731,8065,6.9,132336,124852,7484,5.7
Caddo,9/1/1995,115656,107867,7789,6.7,132611,125133,7478,5.6
Caddo,10/1/1995,116291,108904,7387,6.4,132716,125388,7328,5.5
Caddo,11/1/1995,115465,108855,6610,5.7,132614,125188,7426,5.6
Caddo,12/1/1995,114808,108363,6445,5.6,132511,125088,7423,5.6
Caddo,1/1/1996,113234,105881,7353,6.5,132616,125125,7491,5.6
Caddo,2/1/1996,113278,106927,6351,5.6,132952,125639,7313,5.5
Caddo,3/1/1996,116763,106389,10374,8.9,133180,125862,7318,5.5
Caddo,4/1/1996,114562,107991,6571,5.7,133409,125994,7415,5.6
Caddo,5/1/1996,115529,108339,7190,6.2,133667,126244,7423,5.6
Caddo,6/1/1996,118024,109631,8393,7.1,133697,126602,7095,5.3
Caddo,7/1/1996,118596,110730,7866,6.6,134284,126947,7337,5.5
Caddo,8/1/1996,117490,109947,7543,6.4,134054,127172,6882,5.1
Caddo,9/1/1996,117465,110033,7432,6.3,134515,127536,6979,5.2
Caddo,10/1/1996,118091,110925,7166,6.1,134921,127890,7031,5.2
Caddo,11/1/1996,117492,111080,6412,5.5,135007,127771,7236,5.4
Caddo,12/1/1996,116861,110752,6109,5.2,135113,127860,7253,5.4
Caddo,1/1/1997,115410,108043,7367,6.4,135456,128298,7158,5.3
Caddo,2/1/1997,114120,107872,6248,5.5,135400,128298,7102,5.2
Caddo,3/1/1997,115568,108773,6795,5.9,135891,128891,7000,5.2
Caddo,4/1/1997,115232,108882,6350,5.5,136016,129143,6873,5.1
Caddo,5/1/1997,117982,107346,10636,9,136119,129464,6655,4.9
Caddo,6/1/1997,118813,110030,8783,7.4,136211,129412,6799,5
Caddo,7/1/1997,119265,111251,8014,6.7,136477,129822,6655,4.9
Caddo,8/1/1997,119815,110251,9564,8,136618,130010,6608,4.8
Caddo,9/1/1997,116838,109309,7529,6.4,136675,130019,6656,4.9
Caddo,10/1/1997,116165,109594,6571,5.7,136633,130179,6454,4.7
Caddo,11/1/1997,116548,110651,5897,5.1,136961,130653,6308,4.6
Caddo,12/1/1997,115349,109766,5583,4.8,137155,130679,6476,4.7
Caddo,1/1/1998,113933,107608,6325,5.6,137095,130726,6368,4.6
Caddo,2/1/1998,113585,108063,5522,4.9,137112,130807,6306,4.6
Caddo,3/1/1998,115590,109154,6436,5.6,137236,130814,6422,4.7
Caddo,4/1/1998,116474,110437,6037,5.2,137150,131209,5941,4.3
Caddo,5/1/1998,116141,109919,6222,5.4,137372,131325,6047,4.4
Caddo,6/1/1998,121990,109988,12002,9.8,137455,131244,6212,4.5
Caddo,7/1/1998,122169,110486,11683,9.6,137588,131329,6259,4.5
Caddo,8/1/1998,118244,111250,6994,5.9,137570,131390,6179,4.5
Caddo,9/1/1998,117140,110765,6375,5.4,138286,131986,6300,4.6
Caddo,10/1/1998,115645,110147,5498,4.8,138279,131999,6280,4.5
Caddo,11/1/1998,114854,109937,4917,4.3,138381,132280,6100,4.4
Caddo,12/1/1998,113841,109244,4597,4,138634,132602,6032,4.4
Caddo,1/1/1999,113522,108135,5387,4.7,139003,133027,5976,4.3
Caddo,2/1/1999,113189,108445,4744,4.2,138967,132856,6111,4.4
Caddo,3/1/1999,113923,109447,4476,3.9,138730,132947,5783,4.2
Caddo,4/1/1999,114534,110093,4441,3.9,138959,132955,6004,4.3
Caddo,5/1/1999,114094,109768,4326,3.8,139107,133311,5796,4.2
Caddo,6/1/1999,116816,111092,5724,4.9,139329,133378,5951,4.3
Caddo,7/1/1999,117214,111860,5354,4.6,139439,133414,6025,4.3
Caddo,8/1/1999,116299,110948,5351,4.6,139430,133591,5838,4.2
Caddo,9/1/1999,115318,109999,5319,4.6,139622,133707,5915,4.2
Caddo,10/1/1999,115893,110928,4965,4.3,139771,133993,5778,4.1
Caddo,11/1/1999,115247,110728,4519,3.9,140025,134309,5716,4.1
Caddo,12/1/1999,114329,110157,4172,3.6,140177,134523,5653,4
Caddo,1/1/2000,113994,108146,5848,5.1,142267,136559,5708,4
Caddo,2/1/2000,113622,108390,5232,4.6,142456,136598,5858,4.1
Caddo,3/1/2000,114610,109045,5565,4.9,142434,136701,5733,4
Caddo,4/1/2000,113800,108899,4901,4.3,142751,137270,5481,3.8
Caddo,5/1/2000,113085,107541,5544,4.9,142388,136630,5758,4
Caddo,6/1/2000,115107,108493,6614,5.7,142591,136940,5651,4
Caddo,7/1/2000,115895,109723,6172,5.3,142278,136531,5747,4
Caddo,8/1/2000,115529,109261,6268,5.4,142514,136662,5853,4.1
Caddo,9/1/2000,114212,108167,6045,5.3,142518,136893,5625,3.9
Caddo,10/1/2000,115155,109430,5725,5,142622,137088,5534,3.9
Caddo,11/1/2000,114453,108889,5564,4.9,142962,137322,5639,3.9
Caddo,12/1/2000,113822,108628,5194,4.6,143248,137614,5634,3.9
Caddo,1/1/2001,116490,108146,8344,7.2,143800,137778,6023,4.2
Caddo,2/1/2001,114132,108619,5513,4.8,143701,137612,6089,4.2
Caddo,3/1/2001,114736,108664,6072,5.3,143924,137783,6141,4.3
Caddo,4/1/2001,114504,108562,5942,5.2,143569,137299,6271,4.4
Caddo,5/1/2001,113347,107361,5986,5.3,143318,137092,6226,4.3
Caddo,6/1/2001,115621,108511,7110,6.1,143357,136873,6484,4.5
Caddo,7/1/2001,115562,108942,6620,5.7,143654,137071,6583,4.6
Caddo,8/1/2001,114020,107543,6477,5.7,143284,136241,7042,4.9
Caddo,9/1/2001,113515,106528,6987,6.2,143989,136846,7142,5
Caddo,10/1/2001,113533,106531,7002,6.2,144086,136392,7694,5.3
Caddo,11/1/2001,112839,105705,7134,6.3,144240,136238,8003,5.5
Caddo,12/1/2001,112118,104959,7159,6.4,144305,136047,8258,5.7
Caddo,1/1/2002,112777,102701,10076,8.9,143883,135701,8182,5.7
Caddo,2/1/2002,112321,104099,8222,7.3,144653,136438,8215,5.7
Caddo,3/1/2002,111163,104024,7139,6.4,144481,136177,8304,5.7
Caddo,4/1/2002,111481,104535,6946,6.2,144725,136126,8599,5.9
Caddo,5/1/2002,111033,103932,7101,6.4,144938,136539,8399,5.8
Caddo,6/1/2002,113186,104957,8229,7.3,144808,136415,8393,5.8
Caddo,7/1/2002,113404,105951,7453,6.6,144803,136413,8390,5.8
Caddo,8/1/2002,113055,105677,7378,6.5,145009,136705,8304,5.7
Caddo,9/1/2002,112481,105381,7100,6.3,145552,137302,8251,5.7
Caddo,10/1/2002,111850,105105,6745,6,145314,137008,8307,5.7
Caddo,11/1/2002,110998,104232,6766,6.1,145041,136521,8520,5.9
Caddo,12/1/2002,110504,103730,6774,6.1,145066,136426,8640,6
Caddo,1/1/2003,109386,101593,7793,7.1,145937,137417,8520,5.8
Caddo,2/1/2003,109342,102181,7161,6.5,146100,137482,8618,5.9
Caddo,3/1/2003,110028,102569,7459,6.8,146022,137434,8588,5.9
Caddo,4/1/2003,111707,103014,8693,7.8,146474,137633,8842,6
Caddo,5/1/2003,112101,103206,8895,7.9,146500,137544,8957,6.1
Caddo,6/1/2003,113955,104537,9418,8.3,147056,137790,9266,6.3
Caddo,7/1/2003,114089,105498,8591,7.5,146485,137474,9011,6.2
Caddo,8/1/2003,113095,105069,8026,7.1,146445,137549,8896,6.1
Caddo,9/1/2003,111876,104426,7450,6.7,146530,137609,8921,6.1
Caddo,10/1/2003,111980,105065,6915,6.2,146716,137984,8732,6
Caddo,11/1/2003,112220,105706,6514,5.8,147000,138424,8576,5.8
Caddo,12/1/2003,112388,105967,6421,5.7,146729,138411,8317,5.7
Caddo,1/1/2004,111166,103683,7483,6.7,146842,138472,8370,5.7
Caddo,2/1/2004,110612,104084,6528,5.9,146709,138542,8167,5.6
Caddo,3/1/2004,111366,104368,6998,6.3,146944,138453,8491,5.8
Caddo,4/1/2004,112194,105691,6503,5.8,146850,138680,8170,5.6
Caddo,5/1/2004,112204,105546,6658,5.9,147065,138852,8212,5.6
Caddo,6/1/2004,115037,107064,7973,6.9,147460,139174,8286,5.6
Caddo,7/1/2004,115941,108549,7392,6.4,147692,139556,8136,5.5
Caddo,8/1/2004,114548,107946,6602,5.8,147564,139573,7990,5.4
Caddo,9/1/2004,114066,107609,6457,5.7,147415,139487,7927,5.4
Caddo,10/1/2004,114515,108022,6493,5.7,147793,139732,8061,5.5
Caddo,11/1/2004,114464,108185,6279,5.5,148162,140231,7932,5.4
Caddo,12/1/2004,114483,108369,6114,5.3,148059,140125,7934,5.4
Caddo,1/1/2005,113745,106726,7019,6.2,148029,140245,7784,5.3
Caddo,2/1/2005,113428,107011,6417,5.7,148364,140385,7980,5.4
Caddo,3/1/2005,114005,107622,6383,5.6,148391,140654,7737,5.2
Caddo,4/1/2005,114661,108560,6101,5.3,148926,141254,7672,5.2
Caddo,5/1/2005,114751,108410,6341,5.5,149261,141609,7651,5.1
Caddo,6/1/2005,116480,108926,7554,6.5,149238,141714,7524,5
Caddo,7/1/2005,116795,109279,7516,6.4,149432,142026,7406,5
Caddo,8/1/2005,116027,109336,6691,5.8,149779,142434,7345,4.9
Caddo,9/1/2005,125253,116465,8788,7,149954,142401,7553,5
Caddo,10/1/2005,126352,118376,7976,6.3,150001,142548,7453,5
Caddo,11/1/2005,126176,117929,8247,6.5,150065,142499,7566,5
Caddo,12/1/2005,122650,116787,5863,4.8,150030,142752,7279,4.9
Caddo,1/1/2006,120211,115170,5041,4.2,150214,143150,7064,4.7
Caddo,2/1/2006,119484,115272,4212,3.5,150641,143457,7184,4.8
Caddo,3/1/2006,119495,115069,4426,3.7,150813,143741,7072,4.7
Caddo,4/1/2006,118652,114270,4382,3.7,150881,143761,7120,4.7
Caddo,5/1/2006,119345,114546,4799,4,151069,144089,6980,4.6
Caddo,6/1/2006,121747,115742,6005,4.9,151354,144353,7001,4.6
Caddo,7/1/2006,121357,115493,5864,4.8,151377,144202,7175,4.7
Caddo,8/1/2006,119691,114280,5411,4.5,151716,144625,7091,4.7
Caddo,9/1/2006,118091,112856,5235,4.4,151662,144815,6847,4.5
Caddo,10/1/2006,118250,113084,5166,4.4,152041,145314,6727,4.4
Caddo,11/1/2006,118186,112956,5230,4.4,152406,145534,6872,4.5
Caddo,12/1/2006,117376,112381,4995,4.3,152732,145970,6762,4.4
Caddo,1/1/2007,117883,110388,7495,6.4,153144,146028,7116,4.6
Caddo,2/1/2007,116602,111163,5439,4.7,152983,146057,6927,4.5
Caddo,3/1/2007,117565,112303,5262,4.5,153051,146320,6731,4.4
Caddo,4/1/2007,118259,112866,5393,4.6,152435,145586,6850,4.5
Caddo,5/1/2007,118298,112475,5823,4.9,152670,145903,6766,4.4
Caddo,6/1/2007,120581,113728,6853,5.7,153041,146063,6979,4.6
Caddo,7/1/2007,121957,114906,7051,5.8,153054,145905,7149,4.7
Caddo,8/1/2007,120126,114067,6059,5,152749,145682,7067,4.6
Caddo,9/1/2007,119255,113290,5965,5,153414,146244,7170,4.7
Caddo,10/1/2007,118430,113127,5303,4.5,153183,145946,7237,4.7
Caddo,11/1/2007,119275,114158,5117,4.3,153835,146595,7240,4.7
Caddo,12/1/2007,119479,113975,5504,4.6,153918,146273,7645,5
Caddo,1/1/2008,118012,111912,6100,5.2,154063,146378,7685,5
Caddo,2/1/2008,117792,112514,5278,4.5,153653,146156,7497,4.9
Caddo,3/1/2008,118830,113037,5793,4.9,153908,146086,7822,5.1
Caddo,4/1/2008,119116,113876,5240,4.4,153769,146132,7637,5
Caddo,5/1/2008,119060,113378,5682,4.8,154303,145908,8395,5.4
Caddo,6/1/2008,121936,114849,7087,5.8,154313,145737,8575,5.6
Caddo,7/1/2008,123751,116072,7679,6.2,154469,145532,8937,5.8
Caddo,8/1/2008,124619,117530,7089,5.7,154641,145203,9438,6.1
Caddo,9/1/2008,124257,117956,6301,5.1,154570,145076,9494,6.1
Caddo,10/1/2008,120819,113685,7134,5.9,154876,144802,10074,6.5
Caddo,11/1/2008,120186,112960,7226,6,154639,144100,10538,6.8
Caddo,12/1/2008,119732,112158,7574,6.3,154655,143369,11286,7.3
Caddo,1/1/2009,120297,109996,10301,8.6,154210,142152,12058,7.8
Caddo,2/1/2009,119317,109784,9533,8,154538,141640,12898,8.3
Caddo,3/1/2009,119042,110221,8821,7.4,154133,140707,13426,8.7
Caddo,4/1/2009,120194,111629,8565,7.1,154509,140656,13853,9
Caddo,5/1/2009,119199,110489,8710,7.3,154747,140248,14499,9.4
Caddo,6/1/2009,121901,111772,10129,8.3,154716,140009,14707,9.5
Caddo,7/1/2009,123478,112578,10900,8.8,154502,139901,14601,9.5
Caddo,8/1/2009,120598,111206,9392,7.8,154307,139492,14814,9.6
Caddo,9/1/2009,119234,110668,8566,7.2,153827,138818,15009,9.8
Caddo,10/1/2009,118127,109988,8139,6.9,153784,138432,15352,10
Caddo,11/1/2009,118593,111028,7565,6.4,153878,138659,15219,9.9
Caddo,12/1/2009,117649,109671,7978,6.8,153111,138013,15098,9.9
Caddo,1/1/2010,114963,106245,8718,7.6,153484,138438,15046,9.8
Caddo,2/1/2010,114810,106294,8516,7.4,153694,138581,15113,9.8
Caddo,3/1/2010,115572,107499,8073,7,153954,138751,15202,9.9
Caddo,4/1/2010,116794,108797,7997,6.8,154622,139297,15325,9.9
Caddo,5/1/2010,116820,108328,8492,7.3,154091,139241,14849,9.6
Caddo,6/1/2010,118981,109204,9777,8.2,153616,139141,14474,9.4
Caddo,7/1/2010,119734,109595,10139,8.5,153691,139179,14512,9.4
Caddo,8/1/2010,117853,108323,9530,8.1,154086,139438,14648,9.5
Caddo,9/1/2010,117383,108029,9354,8,153975,139396,14579,9.5
Caddo,10/1/2010,117430,108432,8998,7.7,153635,139119,14516,9.4
Caddo,11/1/2010,117221,108330,8891,7.6,154125,139044,15081,9.8
Caddo,12/1/2010,116577,108144,8433,7.2,153650,139301,14348,9.3
Caddo,1/1/2011,115618,106222,9396,8.1,153263,139250,14013,9.1
Caddo,2/1/2011,115474,106900,8574,7.4,153214,139394,13820,9
Caddo,3/1/2011,116296,107860,8436,7.3,153376,139639,13737,9
Caddo,4/1/2011,115921,107863,8058,7,153543,139586,13957,9.1
Caddo,5/1/2011,115784,107377,8407,7.3,153479,139624,13855,9
Caddo,6/1/2011,117134,107559,9575,8.2,153346,139384,13962,9.1
Caddo,7/1/2011,117686,108440,9246,7.9,153288,139524,13763,9
Caddo,8/1/2011,116821,107826,8995,7.7,153760,139942,13818,9
Caddo,9/1/2011,116567,107717,8850,7.6,154131,140183,13948,9
Caddo,10/1/2011,116056,107481,8575,7.4,153961,140368,13594,8.8
Caddo,11/1/2011,116075,107981,8094,7,154128,140826,13302,8.6
Caddo,12/1/2011,115073,107161,7912,6.9,153995,140902,13093,8.5
Caddo,1/1/2012,114023,105332,8691,7.6,154381,141584,12797,8.3
Caddo,2/1/2012,113854,105705,8149,7.2,154671,141858,12813,8.3
Caddo,3/1/2012,114718,106506,8212,7.2,154749,142036,12713,8.2
Caddo,4/1/2012,114572,106837,7735,6.8,154545,141899,12646,8.2
Caddo,5/1/2012,114600,106281,8319,7.3,154866,142206,12660,8.2
Caddo,6/1/2012,116309,106642,9667,8.3,155083,142391,12692,8.2
Caddo,7/1/2012,115986,106749,9237,8,154948,142292,12656,8.2
Caddo,8/1/2012,114195,105596,8599,7.5,154763,142291,12471,8.1
Caddo,9/1/2012,113388,105168,8220,7.2,155160,143044,12115,7.8
Caddo,10/1/2012,113548,105528,8020,7.1,155554,143431,12124,7.8
Caddo,11/1/2012,112557,105180,7377,6.6,155338,143333,12005,7.7
Caddo,12/1/2012,112133,104248,7885,7,155628,143330,12298,7.9
Caddo,1/1/2013,110683,101367,9316,8.4,155763,143292,12471,8
Caddo,2/1/2013,110052,101529,8523,7.7,155312,143362,11950,7.7
Caddo,3/1/2013,110776,102358,8418,7.6,155005,143316,11689,7.5
Caddo,4/1/2013,111694,103578,8116,7.3,155394,143635,11760,7.6
Caddo,5/1/2013,111653,103192,8461,7.6,155536,143882,11654,7.5
Caddo,6/1/2013,113539,103801,9738,8.6,155749,143999,11751,7.5
Caddo,7/1/2013,112872,103733,9139,8.1,155599,144264,11335,7.3
Caddo,8/1/2013,110685,102238,8447,7.6,155605,144326,11279,7.2
Caddo,9/1/2013,110230,102000,8230,7.5,155687,144418,11270,7.2
Caddo,10/1/2013,109535,101721,7814,7.1,154673,143537,11136,7.2
Caddo,11/1/2013,109884,102623,7261,6.6,155265,144479,10787,6.9
Caddo,12/1/2013,109102,102260,6842,6.3,155182,144778,10404,6.7
Caddo,1/1/2014,108209,100828,7381,6.8,155352,145150,10202,6.6
Caddo,2/1/2014,108139,101215,6924,6.4,155483,145134,10349,6.7
Caddo,3/1/2014,109383,102206,7177,6.6,156028,145648,10380,6.7
Caddo,4/1/2014,109476,102703,6773,6.2,155369,145667,9702,6.2
Caddo,5/1/2014,109995,102366,7629,6.9,155684,145825,9859,6.3
Caddo,6/1/2014,111718,102918,8800,7.9,155707,146247,9460,6.1
Caddo,7/1/2014,112507,103367,9140,8.1,156007,146399,9608,6.2
Caddo,8/1/2014,111411,102327,9084,8.2,156130,146530,9599,6.1
Caddo,9/1/2014,110918,102137,8781,7.9,156040,146778,9262,5.9
Caddo,10/1/2014,111625,103184,8441,7.6,156417,147427,8990,5.7
Caddo,11/1/2014,111611,103184,8427,7.6,156494,147404,9090,5.8
Caddo,12/1/2014,110719,102780,7939,7.2,156332,147615,8717,5.6
Caddo,1/1/2015,110336,101668,8668,7.9,157030,148145,8885,5.7
Caddo,2/1/2015,109850,101915,7935,7.2,156644,148045,8599,5.5
Caddo,3/1/2015,110271,102401,7870,7.1,156643,148128,8515,5.4
Caddo,4/1/2015,110890,103266,7624,6.9,157060,148511,8550,5.4
Caddo,5/1/2015,110637,102556,8081,7.3,157651,148817,8834,5.6
Caddo,6/1/2015,111239,102486,8753,7.9,157062,148816,8247,5.3
Caddo,7/1/2015,111120,102690,8430,7.6,156997,148830,8167,5.2
Caddo,8/1/2015,109468,101740,7728,7.1,157172,149181,7992,5.1
Caddo,9/1/2015,108647,101145,7502,6.9,156733,148826,7907,5
Caddo,10/1/2015,108467,101161,7306,6.7,157167,149246,7922,5
Caddo,11/1/2015,108083,101296,6787,6.3,157463,149463,8000,5.1
Caddo,12/1/2015,107610,101242,6368,5.9,158035,150128,7907,5
Caddo,1/1/2016,106755,99621,7134,6.7,158280,150653,7627,4.8
Caddo,2/1/2016,107080,100437,6643,6.2,158640,150939,7702,4.9
Caddo,3/1/2016,107652,100808,6844,6.4,159179,151218,7961,5
Caddo,4/1/2016,107380,100759,6621,6.2,159141,151074,8067,5.1
Caddo,5/1/2016,106956,100229,6727,6.3,158784,151132,7652,4.8
Caddo,6/1/2016,108695,100586,8109,7.5,158967,151223,7744,4.9
Caddo,7/1/2016,108323,100466,7857,7.3,159194,151554,7641,4.8
Caddo,8/1/2016,106849,99306,7543,7.1,159562,151779,7784,4.9
Caddo,9/1/2016,106586,99115,7471,7,159714,151761,7953,5
Caddo,10/1/2016,106203,99284,6919,6.5,159605,151793,7811,4.9
Caddo,11/1/2016,106173,99725,6448,6.1,159506,151954,7553,4.7
Caddo,12/1/2016,105392,99162,6230,5.9,159678,152157,7521,4.7
Caddo,1/1/2017,104136,97274,6862,6.6,159620,152152,7468,4.7
Caddo,2/1/2017,104064,97695,6369,6.1,159859,152480,7379,4.6
Caddo,3/1/2017,104745,98599,6146,5.9,160137,153065,7073,4.4
Caddo,4/1/2017,104639,98596,6043,5.8,160345,153255,7089,4.4
Caddo,5/1/2017,103641,97572,6069,5.9,160068,153069,7000,4.4
Caddo,6/1/2017,105478,98582,6896,6.5,160192,153318,6873,4.3
Caddo,7/1/2017,106281,99619,6662,6.3,160462,153569,6892,4.3
Caddo,8/1/2017,105314,98857,6457,6.1,160586,153503,7082,4.4
Caddo,9/1/2017,105415,99559,5856,5.6,161140,154286,6854,4.3
Caddo,10/1/2017,104470,99221,5249,5,160309,153609,6700,4.2
Caddo,11/1/2017,104555,99396,5159,4.9,160579,153805,6774,4.2
Caddo,12/1/2017,104155,99231,4924,4.7,160535,153904,6632,4.1
Caddo,1/1/2018,103370,97955,5415,5.2,160914,154425,6489,4
Caddo,2/1/2018,103902,98644,5258,5.1,161778,155197,6581,4.1
Caddo,3/1/2018,104244,98813,5431,5.2,161686,155214,6472,4
Caddo,4/1/2018,104595,99327,5268,5,161771,155312,6459,4
Caddo,5/1/2018,104246,98627,5619,5.4,161848,155652,6196,3.8
Caddo,6/1/2018,106097,98931,7166,6.8,162210,155762,6447,4
Caddo,7/1/2018,106368,99793,6575,6.2,162341,156146,6195,3.8
Caddo,8/1/2018,104173,98077,6096,5.9,161660,155504,6156,3.8
Caddo,9/1/2018,103332,97817,5515,5.3,162087,156015,6073,3.7
Caddo,10/1/2018,103415,98035,5380,5.2,162602,156391,6211,3.8
Caddo,11/1/2018,103376,98334,5042,4.9,162836,156721,6115,3.8
Caddo,12/1/2018,102996,97864,5132,5,163206,156817,6389,3.9
Caddo,1/1/2019,102477,96703,5774,5.6,162963,156487,6475,4
Caddo,2/1/2019,102354,97393,4961,4.8,162999,156863,6136,3.8
Caddo,3/1/2019,102660,98033,4627,4.5,162904,156701,6202,3.8
Caddo,4/1/2019,102325,97952,4373,4.3,162586,156625,5961,3.7
Caddo,5/1/2019,102170,97247,4923,4.8,162751,156821,5930,3.6
Caddo,6/1/2019,103999,97797,6202,6,163168,157232,5935,3.6
Caddo,7/1/2019,104521,98471,6050,5.8,163590,157529,6061,3.7
Caddo,8/1/2019,102979,97300,5679,5.5,163774,157829,5945,3.6
Caddo,9/1/2019,102616,97309,5307,5.2,164092,158339,5753,3.5
Caddo,10/1/2019,102640,97194,5446,5.3,164416,158545,5871,3.6
Caddo,11/1/2019,102864,97563,5301,5.2,164496,158629,5868,3.6
Caddo,12/1/2019,101898,96888,5010,4.9,164699,158845,5853,3.6
Caddo,1/1/2020,100691,95368,5323,5.3,164377,158508,5869,3.6
Caddo,2/1/2020,99993,95584,4409,4.4,164467,158714,5753,3.5
Caddo,3/1/2020,102017,94482,7535,7.4,162559,155353,7206,4.4
Caddo,4/1/2020,95681,83372,12309,12.9,156269,133185,23084,14.8
Caddo,5/1/2020,98095,84637,13458,13.7,158101,137173,20929,13.2
Caddo,6/1/2020,102048,89141,12907,12.6,159994,142342,17652,11
Caddo,7/1/2020,102862,90561,12301,12,160132,143779,16352,10.2
Caddo,8/1/2020,101632,91344,10288,10.1,160706,147245,13461,8.4
Caddo,9/1/2020,101891,91657,10234,10,160174,147620,12554,7.8
Caddo,10/1/2020,102385,93150,9235,9,161003,149931,11072,6.9
Caddo,11/1/2020,101495,93494,8001,7.9,160629,149934,10694,6.7
Caddo,12/1/2020,100574,92671,7903,7.9,160745,149975,10770,6.7
Caddo,1/1/2021,99625,91658,7967,8,160088,149852,10236,6.4
Caddo,2/1/2021,99736,92307,7429,7.4,160184,150189,9995,6.2
Caddo,3/1/2021,100486,93419,7067,7,160400,150644,9756,6.1
Caddo,4/1/2021,100658,93562,7096,7,160843,151081,9762,6.1
Caddo,5/1/2021,100482,93394,7088,7.1,160800,151535,9266,5.8
Caddo,6/1/2021,102559,94380,8179,8,161197,151734,9462,5.9
Caddo,7/1/2021,102522,95427,7095,6.9,161504,152773,8731,5.4
Caddo,8/1/2021,100649,94459,6190,6.2,161527,153250,8276,5.1
Caddo,9/1/2021,102050,96730,5320,5.2,161495,153843,7652,4.7
Caddo,10/1/2021,100140,95447,4693,4.7,161754,154475,7279,4.5
Caddo,11/1/2021,100341,96113,4228,4.2,162281,155530,6751,4.2
Caddo,12/1/2021,99797,96021,3776,3.8,162497,156099,6398,3.9
Caddo,1/1/2022,100241,95602,4639,4.6,163627,157115,6512,4
Caddo,2/1/2022,100379,96190,4189,4.2,163899,157598,6301,3.8
Caddo,3/1/2022,101070,97087,3983,3.9,164220,158206,6014,3.7
Caddo,4/1/2022,100693,96999,3694,3.7,163893,157891,6002,3.7
Caddo,5/1/2022,100931,96925,4006,4,164362,158378,5983,3.6
Caddo,6/1/2022,102723,97635,5088,5,164046,158094,5951,3.6
Caddo,7/1/2022,102650,97849,4801,4.7,164026,158258,5768,3.5
Caddo,8/1/2022,100935,96510,4425,4.4,164654,158735,5919,3.6
Caddo,9/1/2022,100573,96555,4018,4,164602,158810,5792,3.5
Caddo,10/1/2022,100434,96755,3679,3.7,164648,158684,5964,3.6
Caddo,11/1/2022,100665,97106,3559,3.5,164450,158507,5943,3.6
Caddo,12/1/2022,100199,96677,3522,3.5,165025,159259,5766,3.5
Caddo,1/1/2023,100499,96354,4145,4.1,165964,160217,5747,3.5
Caddo,2/1/2023,101206,97293,3913,3.9,166358,160395,5962,3.6
Caddo,3/1/2023,101388,97692,3696,3.6,166651,160812,5839,3.5
Caddo,4/1/2023,101573,98164,3409,3.4,166725,160974,5751,3.4
Caddo,5/1/2023,101297,97232,4065,4,166886,160796,6089,3.6
Caddo,6/1/2023,102588,97736,4852,4.7,166937,160979,5958,3.6
Caddo,7/1/2023,102024,97871,4153,4.1,167103,161183,5920,3.5
Caddo,8/1/2023,100816,96512,4304,4.3,167759,161475,6284,3.7
Caddo,9/1/2023,100688,96294,4394,4.4,167767,161442,6326,3.8
Caddo,10/1/2023,100900,96465,4435,4.4,167690,161211,6479,3.9
Caddo,11/1/2023,100899,96711,4188,4.2,168140,161886,6254,3.7
Caddo,12/1/2023,100079,95892,4187,4.2,167439,161124,6315,3.8
Caddo,1/1/2024,99963,95276,4687,4.7,167339,161190,6149,3.7
Caddo,2/1/2024,100217,95623,4594,4.6,167475,161013,6462,3.9
Caddo,3/1/2024,101336,96906,4430,4.4,167922,161425,6497,3.9
Caddo,4/1/2024,100907,96894,4013,4,167988,161495,6492,3.9
Caddo,5/1/2024,100133,95903,4230,4.2,167799,161164,6635,4
Caddo,6/1/2024,102229,96808,5421,5.3,168005,161155,6849,4.1
Caddo,7/1/2024,102577,97232,5345,5.2,168315,161219,7097,4.2
Caddo,8/1/2024,101024,95941,5083,5,168496,161425,7071,4.2
Caddo,9/1/2024,100697,95851,4846,4.8,168703,161802,6901,4.1
Caddo,10/1/2024,100649,95758,4891,4.9,168428,161456,6972,4.1
Caddo,11/1/2024,100700,95939,4761,4.7,168304,161183,7121,4.2
Caddo,12/1/2024,100129,95796,4333,4.3,168547,161661,6886,4.1
Caddo,1/1/2025,97473,93067,4406,4.5,170744,163895,6849,4
Caddo,2/1/2025,98314,94062,4252,4.3,170359,163307,7052,4.1
Calcasieu,1/1/1990,73721,69358,4363,5.9,125833,119081,6752,5.4
Calcasieu,2/1/1990,73770,69715,4055,5.5,125710,119059,6651,5.3
Calcasieu,3/1/1990,74948,71108,3840,5.1,125801,119203,6598,5.2
Calcasieu,4/1/1990,75957,72270,3687,4.9,125649,118852,6797,5.4
Calcasieu,5/1/1990,76042,72582,3460,4.6,125893,119151,6742,5.4
Calcasieu,6/1/1990,79613,74943,4670,5.9,125573,118983,6590,5.2
Calcasieu,7/1/1990,80337,75689,4648,5.8,125732,118810,6922,5.5
Calcasieu,8/1/1990,78472,73500,4972,6.3,125990,118802,7188,5.7
Calcasieu,9/1/1990,79492,74441,5051,6.4,125892,118524,7368,5.9
Calcasieu,10/1/1990,79472,74769,4703,5.9,125995,118536,7459,5.9
Calcasieu,11/1/1990,79573,74399,5174,6.5,126070,118306,7764,6.2
Calcasieu,12/1/1990,78906,73476,5430,6.9,126142,118241,7901,6.3
Calcasieu,1/1/1991,78713,73337,5376,6.8,125955,117940,8015,6.4
Calcasieu,2/1/1991,79065,74363,4702,5.9,126020,117755,8265,6.6
Calcasieu,3/1/1991,80448,75773,4675,5.8,126238,117652,8586,6.8
Calcasieu,4/1/1991,81062,76322,4740,5.8,126548,118109,8439,6.7
Calcasieu,5/1/1991,80357,75014,5343,6.6,126176,117440,8736,6.9
Calcasieu,6/1/1991,83850,77068,6782,8.1,126331,117639,8692,6.9
Calcasieu,7/1/1991,83893,76989,6904,8.2,126154,117568,8586,6.8
Calcasieu,8/1/1991,83963,76695,7268,8.7,126150,117484,8666,6.9
Calcasieu,9/1/1991,82618,75482,7136,8.6,126650,117928,8722,6.9
Calcasieu,10/1/1991,82584,76005,6579,8,126642,117800,8842,7
Calcasieu,11/1/1991,82433,76204,6229,7.6,126701,117770,8931,7
Calcasieu,12/1/1991,81921,75892,6029,7.4,126664,117466,9198,7.3
Calcasieu,1/1/1992,80304,73488,6816,8.5,127261,117978,9283,7.3
Calcasieu,2/1/1992,80149,74298,5851,7.3,127207,117753,9454,7.4
Calcasieu,3/1/1992,81196,75347,5849,7.2,127604,118144,9460,7.4
Calcasieu,4/1/1992,81496,75431,6065,7.4,127841,118426,9415,7.4
Calcasieu,5/1/1992,81471,75289,6182,7.6,128119,118375,9744,7.6
Calcasieu,6/1/1992,83296,75482,7814,9.4,128459,118419,10040,7.8
Calcasieu,7/1/1992,85987,78916,7071,8.2,128563,118713,9850,7.7
Calcasieu,8/1/1992,85554,78941,6613,7.7,128613,118826,9787,7.6
Calcasieu,9/1/1992,83367,77025,6342,7.6,128501,118720,9781,7.6
Calcasieu,10/1/1992,82623,76641,5982,7.2,128026,118628,9398,7.3
Calcasieu,11/1/1992,82417,77005,5412,6.6,128441,118876,9565,7.4
Calcasieu,12/1/1992,80075,74550,5525,6.9,128554,118997,9557,7.4
Calcasieu,1/1/1993,78007,71192,6815,8.7,128400,119075,9325,7.3
Calcasieu,2/1/1993,77604,71683,5921,7.6,128458,119275,9183,7.1
Calcasieu,3/1/1993,78867,73020,5847,7.4,128598,119542,9056,7
Calcasieu,4/1/1993,78542,72808,5734,7.3,128584,119474,9110,7.1
Calcasieu,5/1/1993,78446,73146,5300,6.8,129264,120115,9149,7.1
Calcasieu,6/1/1993,80317,74132,6185,7.7,129411,120290,9121,7
Calcasieu,7/1/1993,81158,75807,5351,6.6,129397,120467,8930,6.9
Calcasieu,8/1/1993,80950,75797,5153,6.4,129619,120856,8763,6.8
Calcasieu,9/1/1993,80951,76223,4728,5.8,129268,120554,8714,6.7
Calcasieu,10/1/1993,80271,74893,5378,6.7,129573,120823,8750,6.8
Calcasieu,11/1/1993,80622,75509,5113,6.3,129711,121169,8542,6.6
Calcasieu,12/1/1993,80986,75894,5092,6.3,129941,121464,8477,6.5
Calcasieu,1/1/1994,81440,75238,6202,7.6,130596,121966,8630,6.6
Calcasieu,2/1/1994,81762,76311,5451,6.7,130669,122086,8583,6.6
Calcasieu,3/1/1994,82675,77082,5593,6.8,130400,121930,8470,6.5
Calcasieu,4/1/1994,81902,76101,5801,7.1,130621,122290,8331,6.4
Calcasieu,5/1/1994,81668,75961,5707,7,130779,122864,7915,6.1
Calcasieu,6/1/1994,83214,76840,6374,7.7,130561,122634,7927,6.1
Calcasieu,7/1/1994,84627,78540,6087,7.2,130652,122706,7946,6.1
Calcasieu,8/1/1994,84551,78498,6053,7.2,131275,123342,7933,6
Calcasieu,9/1/1994,83982,78035,5947,7.1,131421,123687,7734,5.9
Calcasieu,10/1/1994,84590,78987,5603,6.6,131744,124112,7632,5.8
Calcasieu,11/1/1994,83740,78473,5267,6.3,131891,124516,7375,5.6
Calcasieu,12/1/1994,82780,77880,4900,5.9,131951,124721,7230,5.5
Calcasieu,1/1/1995,82823,77139,5684,6.9,132038,124663,7375,5.6
Calcasieu,2/1/1995,82181,77210,4971,6,132115,124928,7187,5.4
Calcasieu,3/1/1995,83742,78777,4965,5.9,132108,124955,7153,5.4
Calcasieu,4/1/1995,83249,77832,5417,6.5,132590,124945,7645,5.8
Calcasieu,5/1/1995,82987,77963,5024,6.1,131851,124421,7430,5.6
Calcasieu,6/1/1995,83790,78218,5572,6.6,131949,124522,7427,5.6
Calcasieu,7/1/1995,85264,80191,5073,5.9,132343,124816,7527,5.7
Calcasieu,8/1/1995,86875,81923,4952,5.7,132336,124852,7484,5.7
Calcasieu,9/1/1995,86749,81693,5056,5.8,132611,125133,7478,5.6
Calcasieu,10/1/1995,86786,82178,4608,5.3,132716,125388,7328,5.5
Calcasieu,11/1/1995,86562,82070,4492,5.2,132614,125188,7426,5.6
Calcasieu,12/1/1995,86638,82489,4149,4.8,132511,125088,7423,5.6
Calcasieu,1/1/1996,85879,81022,4857,5.7,132616,125125,7491,5.6
Calcasieu,2/1/1996,86233,82195,4038,4.7,132952,125639,7313,5.5
Calcasieu,3/1/1996,87339,83117,4222,4.8,133180,125862,7318,5.5
Calcasieu,4/1/1996,86006,81469,4537,5.3,133409,125994,7415,5.6
Calcasieu,5/1/1996,86858,81837,5021,5.8,133667,126244,7423,5.6
Calcasieu,6/1/1996,87544,82110,5434,6.2,133697,126602,7095,5.3
Calcasieu,7/1/1996,88332,83367,4965,5.6,134284,126947,7337,5.5
Calcasieu,8/1/1996,88613,83753,4860,5.5,134054,127172,6882,5.1
Calcasieu,9/1/1996,88633,83572,5061,5.7,134515,127536,6979,5.2
Calcasieu,10/1/1996,88597,83226,5371,6.1,134921,127890,7031,5.2
Calcasieu,11/1/1996,88165,83274,4891,5.5,135007,127771,7236,5.4
Calcasieu,12/1/1996,88676,83630,5046,5.7,135113,127860,7253,5.4
Calcasieu,1/1/1997,87779,82277,5502,6.3,135456,128298,7158,5.3
Calcasieu,2/1/1997,87662,83098,4564,5.2,135400,128298,7102,5.2
Calcasieu,3/1/1997,89248,84197,5051,5.7,135891,128891,7000,5.2
Calcasieu,4/1/1997,89086,84203,4883,5.5,136016,129143,6873,5.1
Calcasieu,5/1/1997,88499,83383,5116,5.8,136119,129464,6655,4.9
Calcasieu,6/1/1997,88214,81854,6360,7.2,136211,129412,6799,5
Calcasieu,7/1/1997,89408,83629,5779,6.5,136477,129822,6655,4.9
Calcasieu,8/1/1997,89026,83948,5078,5.7,136618,130010,6608,4.8
Calcasieu,9/1/1997,88197,82962,5235,5.9,136675,130019,6656,4.9
Calcasieu,10/1/1997,88980,84216,4764,5.4,136633,130179,6454,4.7
Calcasieu,11/1/1997,89271,84729,4542,5.1,136961,130653,6308,4.6
Calcasieu,12/1/1997,88754,84379,4375,4.9,137155,130679,6476,4.7
Calcasieu,1/1/1998,88320,83310,5010,5.7,137095,130726,6368,4.6
Calcasieu,2/1/1998,87773,84093,3680,4.2,137112,130807,6306,4.6
Calcasieu,3/1/1998,88691,84472,4219,4.8,137236,130814,6422,4.7
Calcasieu,4/1/1998,89289,85207,4082,4.6,137150,131209,5941,4.3
Calcasieu,5/1/1998,88856,84668,4188,4.7,137372,131325,6047,4.4
Calcasieu,6/1/1998,89611,84699,4912,5.5,137455,131244,6212,4.5
Calcasieu,7/1/1998,89747,85073,4674,5.2,137588,131329,6259,4.5
Calcasieu,8/1/1998,88727,83619,5108,5.8,137570,131390,6179,4.5
Calcasieu,9/1/1998,88008,83086,4922,5.6,138286,131986,6300,4.6
Calcasieu,10/1/1998,87428,82953,4475,5.1,138279,131999,6280,4.5
Calcasieu,11/1/1998,86392,82168,4224,4.9,138381,132280,6100,4.4
Calcasieu,12/1/1998,86315,82456,3859,4.5,138634,132602,6032,4.4
Calcasieu,1/1/1999,88405,83540,4865,5.5,139003,133027,5976,4.3
Calcasieu,2/1/1999,88943,85006,3937,4.4,138967,132856,6111,4.4
Calcasieu,3/1/1999,89061,85196,3865,4.3,138730,132947,5783,4.2
Calcasieu,4/1/1999,88850,84872,3978,4.5,138959,132955,6004,4.3
Calcasieu,5/1/1999,87802,83671,4131,4.7,139107,133311,5796,4.2
Calcasieu,6/1/1999,89723,84263,5460,6.1,139329,133378,5951,4.3
Calcasieu,7/1/1999,89975,84810,5165,5.7,139439,133414,6025,4.3
Calcasieu,8/1/1999,89736,84799,4937,5.5,139430,133591,5838,4.2
Calcasieu,9/1/1999,89867,85091,4776,5.3,139622,133707,5915,4.2
Calcasieu,10/1/1999,90701,86275,4426,4.9,139771,133993,5778,4.1
Calcasieu,11/1/1999,89931,85961,3970,4.4,140025,134309,5716,4.1
Calcasieu,12/1/1999,89295,85687,3608,4,140177,134523,5653,4
Calcasieu,1/1/2000,85895,81379,4516,5.3,142267,136559,5708,4
Calcasieu,2/1/2000,86456,82578,3878,4.5,142456,136598,5858,4.1
Calcasieu,3/1/2000,86838,82742,4096,4.7,142434,136701,5733,4
Calcasieu,4/1/2000,86461,82835,3626,4.2,142751,137270,5481,3.8
Calcasieu,5/1/2000,85886,81772,4114,4.8,142388,136630,5758,4
Calcasieu,6/1/2000,86408,81551,4857,5.6,142591,136940,5651,4
Calcasieu,7/1/2000,86775,82324,4451,5.1,142278,136531,5747,4
Calcasieu,8/1/2000,86154,81649,4505,5.2,142514,136662,5853,4.1
Calcasieu,9/1/2000,84953,80641,4312,5.1,142518,136893,5625,3.9
Calcasieu,10/1/2000,86045,81895,4150,4.8,142622,137088,5534,3.9
Calcasieu,11/1/2000,85658,81517,4141,4.8,142962,137322,5639,3.9
Calcasieu,12/1/2000,85823,81631,4192,4.9,143248,137614,5634,3.9
Calcasieu,1/1/2001,86261,81202,5059,5.9,143800,137778,6023,4.2
Calcasieu,2/1/2001,85545,81352,4193,4.9,143701,137612,6089,4.2
Calcasieu,3/1/2001,86182,81883,4299,5,143924,137783,6141,4.3
Calcasieu,4/1/2001,85942,81537,4405,5.1,143569,137299,6271,4.4
Calcasieu,5/1/2001,85068,80569,4499,5.3,143318,137092,6226,4.3
Calcasieu,6/1/2001,86491,81054,5437,6.3,143357,136873,6484,4.5
Calcasieu,7/1/2001,87384,82323,5061,5.8,143654,137071,6583,4.6
Calcasieu,8/1/2001,85495,80445,5050,5.9,143284,136241,7042,4.9
Calcasieu,9/1/2001,86251,81222,5029,5.8,143989,136846,7142,5
Calcasieu,10/1/2001,86140,81263,4877,5.7,144086,136392,7694,5.3
Calcasieu,11/1/2001,85530,80834,4696,5.5,144240,136238,8003,5.5
Calcasieu,12/1/2001,84948,80208,4740,5.6,144305,136047,8258,5.7
Calcasieu,1/1/2002,85261,80320,4941,5.8,143883,135701,8182,5.7
Calcasieu,2/1/2002,85775,81543,4232,4.9,144653,136438,8215,5.7
Calcasieu,3/1/2002,85705,81428,4277,5,144481,136177,8304,5.7
Calcasieu,4/1/2002,84935,80607,4328,5.1,144725,136126,8599,5.9
Calcasieu,5/1/2002,84165,79323,4842,5.8,144938,136539,8399,5.8
Calcasieu,6/1/2002,85518,79854,5664,6.6,144808,136415,8393,5.8
Calcasieu,7/1/2002,85894,80720,5174,6,144803,136413,8390,5.8
Calcasieu,8/1/2002,84971,79964,5007,5.9,145009,136705,8304,5.7
Calcasieu,9/1/2002,85202,80233,4969,5.8,145552,137302,8251,5.7
Calcasieu,10/1/2002,84294,79757,4537,5.4,145314,137008,8307,5.7
Calcasieu,11/1/2002,84315,79725,4590,5.4,145041,136521,8520,5.9
Calcasieu,12/1/2002,84379,79625,4754,5.6,145066,136426,8640,6
Calcasieu,1/1/2003,86897,81453,5444,6.3,145937,137417,8520,5.8
Calcasieu,2/1/2003,86978,81846,5132,5.9,146100,137482,8618,5.9
Calcasieu,3/1/2003,86797,81429,5368,6.2,146022,137434,8588,5.9
Calcasieu,4/1/2003,86578,81305,5273,6.1,146474,137633,8842,6
Calcasieu,5/1/2003,85729,80302,5427,6.3,146500,137544,8957,6.1
Calcasieu,6/1/2003,87098,80267,6831,7.8,147056,137790,9266,6.3
Calcasieu,7/1/2003,86445,80167,6278,7.3,146485,137474,9011,6.2
Calcasieu,8/1/2003,86626,80767,5859,6.8,146445,137549,8896,6.1
Calcasieu,9/1/2003,85333,79825,5508,6.5,146530,137609,8921,6.1
Calcasieu,10/1/2003,86063,81280,4783,5.6,146716,137984,8732,6
Calcasieu,11/1/2003,86008,81471,4537,5.3,147000,138424,8576,5.8
Calcasieu,12/1/2003,85596,81199,4397,5.1,146729,138411,8317,5.7
Calcasieu,1/1/2004,85352,80276,5076,5.9,146842,138472,8370,5.7
Calcasieu,2/1/2004,84996,80649,4347,5.1,146709,138542,8167,5.6
Calcasieu,3/1/2004,86488,81822,4666,5.4,146944,138453,8491,5.8
Calcasieu,4/1/2004,85883,81261,4622,5.4,146850,138680,8170,5.6
Calcasieu,5/1/2004,85146,80252,4894,5.7,147065,138852,8212,5.6
Calcasieu,6/1/2004,86135,80500,5635,6.5,147460,139174,8286,5.6
Calcasieu,7/1/2004,86114,81190,4924,5.7,147692,139556,8136,5.5
Calcasieu,8/1/2004,86576,82249,4327,5,147564,139573,7990,5.4
Calcasieu,9/1/2004,85562,81069,4493,5.3,147415,139487,7927,5.4
Calcasieu,10/1/2004,86931,82708,4223,4.9,147793,139732,8061,5.5
Calcasieu,11/1/2004,87136,82874,4262,4.9,148162,140231,7932,5.4
Calcasieu,12/1/2004,87228,83015,4213,4.8,148059,140125,7934,5.4
Calcasieu,1/1/2005,87011,82077,4934,5.7,148029,140245,7784,5.3
Calcasieu,2/1/2005,86855,82388,4467,5.1,148364,140385,7980,5.4
Calcasieu,3/1/2005,86961,82666,4295,4.9,148391,140654,7737,5.2
Calcasieu,4/1/2005,87688,83426,4262,4.9,148926,141254,7672,5.2
Calcasieu,5/1/2005,88892,84468,4424,5,149261,141609,7651,5.1
Calcasieu,6/1/2005,89531,84278,5253,5.9,149238,141714,7524,5
Calcasieu,7/1/2005,88808,83963,4845,5.5,149432,142026,7406,5
Calcasieu,8/1/2005,88878,84278,4600,5.2,149779,142434,7345,4.9
Calcasieu,9/1/2005,96883,89270,7613,7.9,149954,142401,7553,5
Calcasieu,10/1/2005,103674,86399,17275,16.7,150001,142548,7453,5
Calcasieu,11/1/2005,104705,87804,16901,16.1,150065,142499,7566,5
Calcasieu,12/1/2005,92468,87581,4887,5.3,150030,142752,7279,4.9
Calcasieu,1/1/2006,90653,86868,3785,4.2,150214,143150,7064,4.7
Calcasieu,2/1/2006,90040,87138,2902,3.2,150641,143457,7184,4.8
Calcasieu,3/1/2006,90600,87706,2894,3.2,150813,143741,7072,4.7
Calcasieu,4/1/2006,90360,87569,2791,3.1,150881,143761,7120,4.7
Calcasieu,5/1/2006,90624,87538,3086,3.4,151069,144089,6980,4.6
Calcasieu,6/1/2006,91636,87583,4053,4.4,151354,144353,7001,4.6
Calcasieu,7/1/2006,91183,87758,3425,3.8,151377,144202,7175,4.7
Calcasieu,8/1/2006,90082,86623,3459,3.8,151716,144625,7091,4.7
Calcasieu,9/1/2006,90804,87504,3300,3.6,151662,144815,6847,4.5
Calcasieu,10/1/2006,91816,88612,3204,3.5,152041,145314,6727,4.4
Calcasieu,11/1/2006,92495,89163,3332,3.6,152406,145534,6872,4.5
Calcasieu,12/1/2006,92303,89291,3012,3.3,152732,145970,6762,4.4
Calcasieu,1/1/2007,91377,87669,3708,4.1,153144,146028,7116,4.6
Calcasieu,2/1/2007,91250,88050,3200,3.5,152983,146057,6927,4.5
Calcasieu,3/1/2007,91888,88586,3302,3.6,153051,146320,6731,4.4
Calcasieu,4/1/2007,92468,89141,3327,3.6,152435,145586,6850,4.5
Calcasieu,5/1/2007,92663,89025,3638,3.9,152670,145903,6766,4.4
Calcasieu,6/1/2007,94362,90032,4330,4.6,153041,146063,6979,4.6
Calcasieu,7/1/2007,93249,89195,4054,4.3,153054,145905,7149,4.7
Calcasieu,8/1/2007,92041,88208,3833,4.2,152749,145682,7067,4.6
Calcasieu,9/1/2007,91257,87449,3808,4.2,153414,146244,7170,4.7
Calcasieu,10/1/2007,92019,88816,3203,3.5,153183,145946,7237,4.7
Calcasieu,11/1/2007,92340,89102,3238,3.5,153835,146595,7240,4.7
Calcasieu,12/1/2007,91718,88189,3529,3.8,153918,146273,7645,5
Calcasieu,1/1/2008,91672,87491,4181,4.6,154063,146378,7685,5
Calcasieu,2/1/2008,91611,88173,3438,3.8,153653,146156,7497,4.9
Calcasieu,3/1/2008,92129,88632,3497,3.8,153908,146086,7822,5.1
Calcasieu,4/1/2008,94139,91013,3126,3.3,153769,146132,7637,5
Calcasieu,5/1/2008,94794,91173,3621,3.8,154303,145908,8395,5.4
Calcasieu,6/1/2008,96023,91480,4543,4.7,154313,145737,8575,5.6
Calcasieu,7/1/2008,96920,92581,4339,4.5,154469,145532,8937,5.8
Calcasieu,8/1/2008,95189,90798,4391,4.6,154641,145203,9438,6.1
Calcasieu,9/1/2008,94351,90226,4125,4.4,154570,145076,9494,6.1
Calcasieu,10/1/2008,95150,90872,4278,4.5,154876,144802,10074,6.5
Calcasieu,11/1/2008,94746,90625,4121,4.3,154639,144100,10538,6.8
Calcasieu,12/1/2008,93222,89007,4215,4.5,154655,143369,11286,7.3
Calcasieu,1/1/2009,93727,88691,5036,5.4,154210,142152,12058,7.8
Calcasieu,2/1/2009,93378,88448,4930,5.3,154538,141640,12898,8.3
Calcasieu,3/1/2009,93559,88234,5325,5.7,154133,140707,13426,8.7
Calcasieu,4/1/2009,93239,87819,5420,5.8,154509,140656,13853,9
Calcasieu,5/1/2009,93805,88153,5652,6,154747,140248,14499,9.4
Calcasieu,6/1/2009,94598,87869,6729,7.1,154716,140009,14707,9.5
Calcasieu,7/1/2009,92653,86154,6499,7,154502,139901,14601,9.5
Calcasieu,8/1/2009,91162,84985,6177,6.8,154307,139492,14814,9.6
Calcasieu,9/1/2009,90616,84558,6058,6.7,153827,138818,15009,9.8
Calcasieu,10/1/2009,92565,86896,5669,6.1,153784,138432,15352,10
Calcasieu,11/1/2009,92517,87101,5416,5.9,153878,138659,15219,9.9
Calcasieu,12/1/2009,90966,85185,5781,6.4,153111,138013,15098,9.9
Calcasieu,1/1/2010,87727,81037,6690,7.6,153484,138438,15046,9.8
Calcasieu,2/1/2010,87401,81433,5968,6.8,153694,138581,15113,9.8
Calcasieu,3/1/2010,87777,81728,6049,6.9,153954,138751,15202,9.9
Calcasieu,4/1/2010,88843,82753,6090,6.9,154622,139297,15325,9.9
Calcasieu,5/1/2010,88751,82309,6442,7.3,154091,139241,14849,9.6
Calcasieu,6/1/2010,89338,82063,7275,8.1,153616,139141,14474,9.4
Calcasieu,7/1/2010,88946,81854,7092,8,153691,139179,14512,9.4
Calcasieu,8/1/2010,88407,81353,7054,8,154086,139438,14648,9.5
Calcasieu,9/1/2010,87844,81000,6844,7.8,153975,139396,14579,9.5
Calcasieu,10/1/2010,87337,80795,6542,7.5,153635,139119,14516,9.4
Calcasieu,11/1/2010,87276,80692,6584,7.5,154125,139044,15081,9.8
Calcasieu,12/1/2010,86981,80607,6374,7.3,153650,139301,14348,9.3
Calcasieu,1/1/2011,87086,80039,7047,8.1,153263,139250,14013,9.1
Calcasieu,2/1/2011,86708,80336,6372,7.3,153214,139394,13820,9
Calcasieu,3/1/2011,87097,80876,6221,7.1,153376,139639,13737,9
Calcasieu,4/1/2011,87680,81696,5984,6.8,153543,139586,13957,9.1
Calcasieu,5/1/2011,87296,81048,6248,7.2,153479,139624,13855,9
Calcasieu,6/1/2011,87694,80918,6776,7.7,153346,139384,13962,9.1
Calcasieu,7/1/2011,87873,81350,6523,7.4,153288,139524,13763,9
Calcasieu,8/1/2011,87395,80944,6451,7.4,153760,139942,13818,9
Calcasieu,9/1/2011,87516,81237,6279,7.2,154131,140183,13948,9
Calcasieu,10/1/2011,87751,81599,6152,7,153961,140368,13594,8.8
Calcasieu,11/1/2011,87979,82132,5847,6.6,154128,140826,13302,8.6
Calcasieu,12/1/2011,87437,81657,5780,6.6,153995,140902,13093,8.5
Calcasieu,1/1/2012,87421,81022,6399,7.3,154381,141584,12797,8.3
Calcasieu,2/1/2012,87173,81406,5767,6.6,154671,141858,12813,8.3
Calcasieu,3/1/2012,87937,82118,5819,6.6,154749,142036,12713,8.2
Calcasieu,4/1/2012,87758,82235,5523,6.3,154545,141899,12646,8.2
Calcasieu,5/1/2012,88053,82082,5971,6.8,154866,142206,12660,8.2
Calcasieu,6/1/2012,90093,83257,6836,7.6,155083,142391,12692,8.2
Calcasieu,7/1/2012,89806,83326,6480,7.2,154948,142292,12656,8.2
Calcasieu,8/1/2012,88312,82461,5851,6.6,154763,142291,12471,8.1
Calcasieu,9/1/2012,88367,83032,5335,6,155160,143044,12115,7.8
Calcasieu,10/1/2012,89390,84159,5231,5.9,155554,143431,12124,7.8
Calcasieu,11/1/2012,88555,83750,4805,5.4,155338,143333,12005,7.7
Calcasieu,12/1/2012,88141,82785,5356,6.1,155628,143330,12298,7.9
Calcasieu,1/1/2013,88271,81977,6294,7.1,155763,143292,12471,8
Calcasieu,2/1/2013,87799,82385,5414,6.2,155312,143362,11950,7.7
Calcasieu,3/1/2013,88276,82862,5414,6.1,155005,143316,11689,7.5
Calcasieu,4/1/2013,88843,83493,5350,6,155394,143635,11760,7.6
Calcasieu,5/1/2013,88999,83227,5772,6.5,155536,143882,11654,7.5
Calcasieu,6/1/2013,90533,84026,6507,7.2,155749,143999,11751,7.5
Calcasieu,7/1/2013,90451,84378,6073,6.7,155599,144264,11335,7.3
Calcasieu,8/1/2013,89369,83564,5805,6.5,155605,144326,11279,7.2
Calcasieu,9/1/2013,89799,84349,5450,6.1,155687,144418,11270,7.2
Calcasieu,10/1/2013,90585,85503,5082,5.6,154673,143537,11136,7.2
Calcasieu,11/1/2013,90334,85626,4708,5.2,155265,144479,10787,6.9
Calcasieu,12/1/2013,89477,85170,4307,4.8,155182,144778,10404,6.7
Calcasieu,1/1/2014,89469,84598,4871,5.4,155352,145150,10202,6.6
Calcasieu,2/1/2014,89531,84983,4548,5.1,155483,145134,10349,6.7
Calcasieu,3/1/2014,91336,86552,4784,5.2,156028,145648,10380,6.7
Calcasieu,4/1/2014,91394,86854,4540,5,155369,145667,9702,6.2
Calcasieu,5/1/2014,93049,87905,5144,5.5,155684,145825,9859,6.3
Calcasieu,6/1/2014,94701,88821,5880,6.2,155707,146247,9460,6.1
Calcasieu,7/1/2014,95860,89640,6220,6.5,156007,146399,9608,6.2
Calcasieu,8/1/2014,95924,89652,6272,6.5,156130,146530,9599,6.1
Calcasieu,9/1/2014,95948,89957,5991,6.2,156040,146778,9262,5.9
Calcasieu,10/1/2014,96718,91000,5718,5.9,156417,147427,8990,5.7
Calcasieu,11/1/2014,97713,91882,5831,6,156494,147404,9090,5.8
Calcasieu,12/1/2014,96864,91401,5463,5.6,156332,147615,8717,5.6
Calcasieu,1/1/2015,96820,90718,6102,6.3,157030,148145,8885,5.7
Calcasieu,2/1/2015,96724,91260,5464,5.6,156644,148045,8599,5.5
Calcasieu,3/1/2015,97841,92474,5367,5.5,156643,148128,8515,5.4
Calcasieu,4/1/2015,98554,93356,5198,5.3,157060,148511,8550,5.4
Calcasieu,5/1/2015,98024,92552,5472,5.6,157651,148817,8834,5.6
Calcasieu,6/1/2015,99168,93484,5684,5.7,157062,148816,8247,5.3
Calcasieu,7/1/2015,99682,94074,5608,5.6,156997,148830,8167,5.2
Calcasieu,8/1/2015,98866,93675,5191,5.3,157172,149181,7992,5.1
Calcasieu,9/1/2015,98578,93423,5155,5.2,156733,148826,7907,5
Calcasieu,10/1/2015,100802,95936,4866,4.8,157167,149246,7922,5
Calcasieu,11/1/2015,100878,96276,4602,4.6,157463,149463,8000,5.1
Calcasieu,12/1/2015,98643,94179,4464,4.5,158035,150128,7907,5
Calcasieu,1/1/2016,99787,94658,5129,5.1,158280,150653,7627,4.8
Calcasieu,2/1/2016,100407,95762,4645,4.6,158640,150939,7702,4.9
Calcasieu,3/1/2016,101736,96926,4810,4.7,159179,151218,7961,5
Calcasieu,4/1/2016,101669,97054,4615,4.5,159141,151074,8067,5.1
Calcasieu,5/1/2016,101805,97187,4618,4.5,158784,151132,7652,4.8
Calcasieu,6/1/2016,104191,98659,5532,5.3,158967,151223,7744,4.9
Calcasieu,7/1/2016,104347,98988,5359,5.1,159194,151554,7641,4.8
Calcasieu,8/1/2016,103164,97964,5200,5,159562,151779,7784,4.9
Calcasieu,9/1/2016,104692,99464,5228,5,159714,151761,7953,5
Calcasieu,10/1/2016,104537,99805,4732,4.5,159605,151793,7811,4.9
Calcasieu,11/1/2016,104370,99897,4473,4.3,159506,151954,7553,4.7
Calcasieu,12/1/2016,103529,99167,4362,4.2,159678,152157,7521,4.7
Calcasieu,1/1/2017,104105,99177,4928,4.7,159620,152152,7468,4.7
Calcasieu,2/1/2017,104346,99903,4443,4.3,159859,152480,7379,4.6
Calcasieu,3/1/2017,106258,102026,4232,4,160137,153065,7073,4.4
Calcasieu,4/1/2017,107260,103131,4129,3.8,160345,153255,7089,4.4
Calcasieu,5/1/2017,107525,103315,4210,3.9,160068,153069,7000,4.4
Calcasieu,6/1/2017,110045,105286,4759,4.3,160192,153318,6873,4.3
Calcasieu,7/1/2017,111272,106641,4631,4.2,160462,153569,6892,4.3
Calcasieu,8/1/2017,110456,105956,4500,4.1,160586,153503,7082,4.4
Calcasieu,9/1/2017,110478,106089,4389,4,161140,154286,6854,4.3
Calcasieu,10/1/2017,110204,106443,3761,3.4,160309,153609,6700,4.2
Calcasieu,11/1/2017,109372,105549,3823,3.5,160579,153805,6774,4.2
Calcasieu,12/1/2017,108480,104844,3636,3.4,160535,153904,6632,4.1
Calcasieu,1/1/2018,107894,103761,4133,3.8,160914,154425,6489,4
Calcasieu,2/1/2018,109122,105244,3878,3.6,161778,155197,6581,4.1
Calcasieu,3/1/2018,110462,106510,3952,3.6,161686,155214,6472,4
Calcasieu,4/1/2018,110602,106675,3927,3.6,161771,155312,6459,4
Calcasieu,5/1/2018,110114,106021,4093,3.7,161848,155652,6196,3.8
Calcasieu,6/1/2018,112283,107061,5222,4.7,162210,155762,6447,4
Calcasieu,7/1/2018,111721,106893,4828,4.3,162341,156146,6195,3.8
Calcasieu,8/1/2018,109691,105318,4373,4,161660,155504,6156,3.8
Calcasieu,9/1/2018,109282,105167,4115,3.8,162087,156015,6073,3.7
Calcasieu,10/1/2018,109912,106003,3909,3.6,162602,156391,6211,3.8
Calcasieu,11/1/2018,108808,105123,3685,3.4,162836,156721,6115,3.8
Calcasieu,12/1/2018,107017,103258,3759,3.5,163206,156817,6389,3.9
Calcasieu,1/1/2019,105954,101507,4447,4.2,162963,156487,6475,4
Calcasieu,2/1/2019,105948,102157,3791,3.6,162999,156863,6136,3.8
Calcasieu,3/1/2019,107458,103870,3588,3.3,162904,156701,6202,3.8
Calcasieu,4/1/2019,107220,103861,3359,3.1,162586,156625,5961,3.7
Calcasieu,5/1/2019,106919,103020,3899,3.6,162751,156821,5930,3.6
Calcasieu,6/1/2019,108163,103281,4882,4.5,163168,157232,5935,3.6
Calcasieu,7/1/2019,107248,102425,4823,4.5,163590,157529,6061,3.7
Calcasieu,8/1/2019,105682,101166,4516,4.3,163774,157829,5945,3.6
Calcasieu,9/1/2019,105660,101343,4317,4.1,164092,158339,5753,3.5
Calcasieu,10/1/2019,106298,102060,4238,4,164416,158545,5871,3.6
Calcasieu,11/1/2019,105793,101578,4215,4,164496,158629,5868,3.6
Calcasieu,12/1/2019,103956,99806,4150,4,164699,158845,5853,3.6
Calcasieu,1/1/2020,102989,98389,4600,4.5,164377,158508,5869,3.6
Calcasieu,2/1/2020,101994,98212,3782,3.7,164467,158714,5753,3.5
Calcasieu,3/1/2020,103210,96696,6514,6.3,162559,155353,7206,4.4
Calcasieu,4/1/2020,95563,83174,12389,13,156269,133185,23084,14.8
Calcasieu,5/1/2020,95776,82877,12899,13.5,158101,137173,20929,13.2
Calcasieu,6/1/2020,97542,86135,11407,11.7,159994,142342,17652,11
Calcasieu,7/1/2020,99106,88131,10975,11.1,160132,143779,16352,10.2
Calcasieu,8/1/2020,96965,88028,8937,9.2,160706,147245,13461,8.4
Calcasieu,9/1/2020,91776,78559,13217,14.4,160174,147620,12554,7.8
Calcasieu,10/1/2020,91161,81504,9657,10.6,161003,149931,11072,6.9
Calcasieu,11/1/2020,91790,83735,8055,8.8,160629,149934,10694,6.7
Calcasieu,12/1/2020,92569,84893,7676,8.3,160745,149975,10770,6.7
Calcasieu,1/1/2021,91604,84248,7356,8,160088,149852,10236,6.4
Calcasieu,2/1/2021,92259,85443,6816,7.4,160184,150189,9995,6.2
Calcasieu,3/1/2021,93087,86634,6453,6.9,160400,150644,9756,6.1
Calcasieu,4/1/2021,93988,87788,6200,6.6,160843,151081,9762,6.1
Calcasieu,5/1/2021,94170,88143,6027,6.4,160800,151535,9266,5.8
Calcasieu,6/1/2021,96430,89672,6758,7,161197,151734,9462,5.9
Calcasieu,7/1/2021,97073,91297,5776,6,161504,152773,8731,5.4
Calcasieu,8/1/2021,94597,89607,4990,5.3,161527,153250,8276,5.1
Calcasieu,9/1/2021,96203,91851,4352,4.5,161495,153843,7652,4.7
Calcasieu,10/1/2021,95443,91691,3752,3.9,161754,154475,7279,4.5
Calcasieu,11/1/2021,94748,91389,3359,3.5,162281,155530,6751,4.2
Calcasieu,12/1/2021,92919,89896,3023,3.3,162497,156099,6398,3.9
Calcasieu,1/1/2022,92414,88726,3688,4,163627,157115,6512,4
Calcasieu,2/1/2022,92003,88698,3305,3.6,163899,157598,6301,3.8
Calcasieu,3/1/2022,92632,89475,3157,3.4,164220,158206,6014,3.7
Calcasieu,4/1/2022,91958,89053,2905,3.2,163893,157891,6002,3.7
Calcasieu,5/1/2022,91299,88188,3111,3.4,164362,158378,5983,3.6
Calcasieu,6/1/2022,92816,88862,3954,4.3,164046,158094,5951,3.6
Calcasieu,7/1/2022,92198,88574,3624,3.9,164026,158258,5768,3.5
Calcasieu,8/1/2022,91513,88144,3369,3.7,164654,158735,5919,3.6
Calcasieu,9/1/2022,91708,88585,3123,3.4,164602,158810,5792,3.5
Calcasieu,10/1/2022,91009,88130,2879,3.2,164648,158684,5964,3.6
Calcasieu,11/1/2022,90484,87704,2780,3.1,164450,158507,5943,3.6
Calcasieu,12/1/2022,89637,86837,2800,3.1,165025,159259,5766,3.5
Calcasieu,1/1/2023,89606,86334,3272,3.7,165964,160217,5747,3.5
Calcasieu,2/1/2023,90211,87155,3056,3.4,166358,160395,5962,3.6
Calcasieu,3/1/2023,91463,88600,2863,3.1,166651,160812,5839,3.5
Calcasieu,4/1/2023,90360,87726,2634,2.9,166725,160974,5751,3.4
Calcasieu,5/1/2023,90012,86907,3105,3.4,166886,160796,6089,3.6
Calcasieu,6/1/2023,91594,88000,3594,3.9,166937,160979,5958,3.6
Calcasieu,7/1/2023,91230,88210,3020,3.3,167103,161183,5920,3.5
Calcasieu,8/1/2023,90788,87619,3169,3.5,167759,161475,6284,3.7
Calcasieu,9/1/2023,91240,87863,3377,3.7,167767,161442,6326,3.8
Calcasieu,10/1/2023,91600,88225,3375,3.7,167690,161211,6479,3.9
Calcasieu,11/1/2023,91666,88460,3206,3.5,168140,161886,6254,3.7
Calcasieu,12/1/2023,90567,87278,3289,3.6,167439,161124,6315,3.8
Calcasieu,1/1/2024,90264,86597,3667,4.1,167339,161190,6149,3.7
Calcasieu,2/1/2024,90871,87335,3536,3.9,167475,161013,6462,3.9
Calcasieu,3/1/2024,91763,88354,3409,3.7,167922,161425,6497,3.9
Calcasieu,4/1/2024,92012,88987,3025,3.3,167988,161495,6492,3.9
Calcasieu,5/1/2024,90963,87726,3237,3.6,167799,161164,6635,4
Calcasieu,6/1/2024,92646,88490,4156,4.5,168005,161155,6849,4.1
Calcasieu,7/1/2024,93267,89131,4136,4.4,168315,161219,7097,4.2
Calcasieu,8/1/2024,92434,88328,4106,4.4,168496,161425,7071,4.2
Calcasieu,9/1/2024,92217,88265,3952,4.3,168703,161802,6901,4.1
Calcasieu,10/1/2024,92141,88176,3965,4.3,168428,161456,6972,4.1
Calcasieu,11/1/2024,91808,87911,3897,4.2,168304,161183,7121,4.2
Calcasieu,12/1/2024,91101,87456,3645,4,168547,161661,6886,4.1
Calcasieu,1/1/2025,81737,77943,3794,4.6,170744,163895,6849,4
Calcasieu,2/1/2025,82669,79052,3617,4.4,170359,163307,7052,4.1
Caldwell,1/1/1990,3989,3682,307,7.7,125833,119081,6752,5.4
Caldwell,2/1/1990,3958,3652,306,7.7,125710,119059,6651,5.3
Caldwell,3/1/1990,3881,3603,278,7.2,125801,119203,6598,5.2
Caldwell,4/1/1990,3745,3473,272,7.3,125649,118852,6797,5.4
Caldwell,5/1/1990,3938,3671,267,6.8,125893,119151,6742,5.4
Caldwell,6/1/1990,3995,3718,277,6.9,125573,118983,6590,5.2
Caldwell,7/1/1990,3843,3576,267,6.9,125732,118810,6922,5.5
Caldwell,8/1/1990,3877,3559,318,8.2,125990,118802,7188,5.7
Caldwell,9/1/1990,3783,3453,330,8.7,125892,118524,7368,5.9
Caldwell,10/1/1990,3873,3572,301,7.8,125995,118536,7459,5.9
Caldwell,11/1/1990,3898,3515,383,9.8,126070,118306,7764,6.2
Caldwell,12/1/1990,3811,3454,357,9.4,126142,118241,7901,6.3
Caldwell,1/1/1991,3928,3417,511,13,125955,117940,8015,6.4
Caldwell,2/1/1991,3931,3476,455,11.6,126020,117755,8265,6.6
Caldwell,3/1/1991,3958,3538,420,10.6,126238,117652,8586,6.8
Caldwell,4/1/1991,3896,3427,469,12,126548,118109,8439,6.7
Caldwell,5/1/1991,3941,3328,613,15.6,126176,117440,8736,6.9
Caldwell,6/1/1991,4013,3395,618,15.4,126331,117639,8692,6.9
Caldwell,7/1/1991,4091,3597,494,12.1,126154,117568,8586,6.8
Caldwell,8/1/1991,4070,3689,381,9.4,126150,117484,8666,6.9
Caldwell,9/1/1991,3992,3631,361,9,126650,117928,8722,6.9
Caldwell,10/1/1991,4087,3755,332,8.1,126642,117800,8842,7
Caldwell,11/1/1991,4029,3686,343,8.5,126701,117770,8931,7
Caldwell,12/1/1991,3903,3557,346,8.9,126664,117466,9198,7.3
Caldwell,1/1/1992,3893,3415,478,12.3,127261,117978,9283,7.3
Caldwell,2/1/1992,3936,3500,436,11.1,127207,117753,9454,7.4
Caldwell,3/1/1992,3949,3544,405,10.3,127604,118144,9460,7.4
Caldwell,4/1/1992,4014,3629,385,9.6,127841,118426,9415,7.4
Caldwell,5/1/1992,3980,3603,377,9.5,128119,118375,9744,7.6
Caldwell,6/1/1992,4068,3608,460,11.3,128459,118419,10040,7.8
Caldwell,7/1/1992,4262,3869,393,9.2,128563,118713,9850,7.7
Caldwell,8/1/1992,4159,3767,392,9.4,128613,118826,9787,7.6
Caldwell,9/1/1992,4089,3744,345,8.4,128501,118720,9781,7.6
Caldwell,10/1/1992,4111,3821,290,7.1,128026,118628,9398,7.3
Caldwell,11/1/1992,4068,3776,292,7.2,128441,118876,9565,7.4
Caldwell,12/1/1992,3949,3648,301,7.6,128554,118997,9557,7.4
Caldwell,1/1/1993,4155,3770,385,9.3,128400,119075,9325,7.3
Caldwell,2/1/1993,4199,3816,383,9.1,128458,119275,9183,7.1
Caldwell,3/1/1993,4200,3824,376,9,128598,119542,9056,7
Caldwell,4/1/1993,4245,3888,357,8.4,128584,119474,9110,7.1
Caldwell,5/1/1993,4275,3940,335,7.8,129264,120115,9149,7.1
Caldwell,6/1/1993,4318,3953,365,8.5,129411,120290,9121,7
Caldwell,7/1/1993,4433,4087,346,7.8,129397,120467,8930,6.9
Caldwell,8/1/1993,4377,4023,354,8.1,129619,120856,8763,6.8
Caldwell,9/1/1993,4331,3991,340,7.9,129268,120554,8714,6.7
Caldwell,10/1/1993,4381,4078,303,6.9,129573,120823,8750,6.8
Caldwell,11/1/1993,4310,4025,285,6.6,129711,121169,8542,6.6
Caldwell,12/1/1993,4342,4052,290,6.7,129941,121464,8477,6.5
Caldwell,1/1/1994,4457,4035,422,9.5,130596,121966,8630,6.6
Caldwell,2/1/1994,4370,4005,365,8.4,130669,122086,8583,6.6
Caldwell,3/1/1994,4448,4072,376,8.5,130400,121930,8470,6.5
Caldwell,4/1/1994,4391,4012,379,8.6,130621,122290,8331,6.4
Caldwell,5/1/1994,4376,4027,349,8,130779,122864,7915,6.1
Caldwell,6/1/1994,4493,4061,432,9.6,130561,122634,7927,6.1
Caldwell,7/1/1994,4595,4122,473,10.3,130652,122706,7946,6.1
Caldwell,8/1/1994,4612,4141,471,10.2,131275,123342,7933,6
Caldwell,9/1/1994,4553,4154,399,8.8,131421,123687,7734,5.9
Caldwell,10/1/1994,4518,4168,350,7.7,131744,124112,7632,5.8
Caldwell,11/1/1994,4502,4168,334,7.4,131891,124516,7375,5.6
Caldwell,12/1/1994,4522,4180,342,7.6,131951,124721,7230,5.5
Caldwell,1/1/1995,4466,4065,401,9,132038,124663,7375,5.6
Caldwell,2/1/1995,4410,4014,396,9,132115,124928,7187,5.4
Caldwell,3/1/1995,4444,4067,377,8.5,132108,124955,7153,5.4
Caldwell,4/1/1995,4284,3928,356,8.3,132590,124945,7645,5.8
Caldwell,5/1/1995,4235,3913,322,7.6,131851,124421,7430,5.6
Caldwell,6/1/1995,4355,3940,415,9.5,131949,124522,7427,5.6
Caldwell,7/1/1995,4369,3950,419,9.6,132343,124816,7527,5.7
Caldwell,8/1/1995,4295,3946,349,8.1,132336,124852,7484,5.7
Caldwell,9/1/1995,4225,3914,311,7.4,132611,125133,7478,5.6
Caldwell,10/1/1995,4289,4006,283,6.6,132716,125388,7328,5.5
Caldwell,11/1/1995,4271,3935,336,7.9,132614,125188,7426,5.6
Caldwell,12/1/1995,4181,3830,351,8.4,132511,125088,7423,5.6
Caldwell,1/1/1996,4477,3933,544,12.2,132616,125125,7491,5.6
Caldwell,2/1/1996,4385,3903,482,11,132952,125639,7313,5.5
Caldwell,3/1/1996,4407,3939,468,10.6,133180,125862,7318,5.5
Caldwell,4/1/1996,4502,4028,474,10.5,133409,125994,7415,5.6
Caldwell,5/1/1996,4396,3969,427,9.7,133667,126244,7423,5.6
Caldwell,6/1/1996,4548,4096,452,9.9,133697,126602,7095,5.3
Caldwell,7/1/1996,4514,4088,426,9.4,134284,126947,7337,5.5
Caldwell,8/1/1996,4469,4048,421,9.4,134054,127172,6882,5.1
Caldwell,9/1/1996,4482,4052,430,9.6,134515,127536,6979,5.2
Caldwell,10/1/1996,4402,4035,367,8.3,134921,127890,7031,5.2
Caldwell,11/1/1996,4337,3996,341,7.9,135007,127771,7236,5.4
Caldwell,12/1/1996,4339,3999,340,7.8,135113,127860,7253,5.4
Caldwell,1/1/1997,4484,3888,596,13.3,135456,128298,7158,5.3
Caldwell,2/1/1997,4482,3942,540,12,135400,128298,7102,5.2
Caldwell,3/1/1997,4508,3942,566,12.6,135891,128891,7000,5.2
Caldwell,4/1/1997,4283,3926,357,8.3,136016,129143,6873,5.1
Caldwell,5/1/1997,4217,3830,387,9.2,136119,129464,6655,4.9
Caldwell,6/1/1997,4365,3895,470,10.8,136211,129412,6799,5
Caldwell,7/1/1997,4413,4049,364,8.2,136477,129822,6655,4.9
Caldwell,8/1/1997,4369,4016,353,8.1,136618,130010,6608,4.8
Caldwell,9/1/1997,4216,3926,290,6.9,136675,130019,6656,4.9
Caldwell,10/1/1997,4166,3875,291,7,136633,130179,6454,4.7
Caldwell,11/1/1997,4096,3832,264,6.4,136961,130653,6308,4.6
Caldwell,12/1/1997,4161,3894,267,6.4,137155,130679,6476,4.7
Caldwell,1/1/1998,4054,3680,374,9.2,137095,130726,6368,4.6
Caldwell,2/1/1998,3938,3668,270,6.9,137112,130807,6306,4.6
Caldwell,3/1/1998,3989,3687,302,7.6,137236,130814,6422,4.7
Caldwell,4/1/1998,4003,3695,308,7.7,137150,131209,5941,4.3
Caldwell,5/1/1998,3975,3648,327,8.2,137372,131325,6047,4.4
Caldwell,6/1/1998,4061,3712,349,8.6,137455,131244,6212,4.5
Caldwell,7/1/1998,4063,3711,352,8.7,137588,131329,6259,4.5
Caldwell,8/1/1998,3952,3619,333,8.4,137570,131390,6179,4.5
Caldwell,9/1/1998,3876,3551,325,8.4,138286,131986,6300,4.6
Caldwell,10/1/1998,4032,3743,289,7.2,138279,131999,6280,4.5
Caldwell,11/1/1998,4030,3753,277,6.9,138381,132280,6100,4.4
Caldwell,12/1/1998,4257,3778,479,11.3,138634,132602,6032,4.4
Caldwell,1/1/1999,4421,3822,599,13.5,139003,133027,5976,4.3
Caldwell,2/1/1999,4119,3725,394,9.6,138967,132856,6111,4.4
Caldwell,3/1/1999,4157,3797,360,8.7,138730,132947,5783,4.2
Caldwell,4/1/1999,4342,3957,385,8.9,138959,132955,6004,4.3
Caldwell,5/1/1999,4229,3921,308,7.3,139107,133311,5796,4.2
Caldwell,6/1/1999,4369,4022,347,7.9,139329,133378,5951,4.3
Caldwell,7/1/1999,4272,3963,309,7.2,139439,133414,6025,4.3
Caldwell,8/1/1999,4278,3965,313,7.3,139430,133591,5838,4.2
Caldwell,9/1/1999,4230,3954,276,6.5,139622,133707,5915,4.2
Caldwell,10/1/1999,4252,3988,264,6.2,139771,133993,5778,4.1
Caldwell,11/1/1999,4224,3941,283,6.7,140025,134309,5716,4.1
Caldwell,12/1/1999,4205,3936,269,6.4,140177,134523,5653,4
Caldwell,1/1/2000,4294,4000,294,6.8,142267,136559,5708,4
Caldwell,2/1/2000,4210,3937,273,6.5,142456,136598,5858,4.1
Caldwell,3/1/2000,4250,3965,285,6.7,142434,136701,5733,4
Caldwell,4/1/2000,4389,4126,263,6,142751,137270,5481,3.8
Caldwell,5/1/2000,4331,4054,277,6.4,142388,136630,5758,4
Caldwell,6/1/2000,4348,4034,314,7.2,142591,136940,5651,4
Caldwell,7/1/2000,4359,4074,285,6.5,142278,136531,5747,4
Caldwell,8/1/2000,4366,4064,302,6.9,142514,136662,5853,4.1
Caldwell,9/1/2000,4360,4072,288,6.6,142518,136893,5625,3.9
Caldwell,10/1/2000,4339,4060,279,6.4,142622,137088,5534,3.9
Caldwell,11/1/2000,4342,4055,287,6.6,142962,137322,5639,3.9
Caldwell,12/1/2000,4376,4088,288,6.6,143248,137614,5634,3.9
Caldwell,1/1/2001,4374,3977,397,9.1,143800,137778,6023,4.2
Caldwell,2/1/2001,4348,3999,349,8,143701,137612,6089,4.2
Caldwell,3/1/2001,4411,4024,387,8.8,143924,137783,6141,4.3
Caldwell,4/1/2001,4283,3952,331,7.7,143569,137299,6271,4.4
Caldwell,5/1/2001,4303,3977,326,7.6,143318,137092,6226,4.3
Caldwell,6/1/2001,4322,3974,348,8.1,143357,136873,6484,4.5
Caldwell,7/1/2001,4352,4043,309,7.1,143654,137071,6583,4.6
Caldwell,8/1/2001,4320,4011,309,7.2,143284,136241,7042,4.9
Caldwell,9/1/2001,4282,3971,311,7.3,143989,136846,7142,5
Caldwell,10/1/2001,4361,4069,292,6.7,144086,136392,7694,5.3
Caldwell,11/1/2001,4360,4065,295,6.8,144240,136238,8003,5.5
Caldwell,12/1/2001,4359,4046,313,7.2,144305,136047,8258,5.7
Caldwell,1/1/2002,4414,4018,396,9,143883,135701,8182,5.7
Caldwell,2/1/2002,4399,4061,338,7.7,144653,136438,8215,5.7
Caldwell,3/1/2002,4434,4107,327,7.4,144481,136177,8304,5.7
Caldwell,4/1/2002,4483,4160,323,7.2,144725,136126,8599,5.9
Caldwell,5/1/2002,4463,4137,326,7.3,144938,136539,8399,5.8
Caldwell,6/1/2002,4536,4151,385,8.5,144808,136415,8393,5.8
Caldwell,7/1/2002,4469,4122,347,7.8,144803,136413,8390,5.8
Caldwell,8/1/2002,4462,4125,337,7.6,145009,136705,8304,5.7
Caldwell,9/1/2002,4391,4084,307,7,145552,137302,8251,5.7
Caldwell,10/1/2002,4390,4065,325,7.4,145314,137008,8307,5.7
Caldwell,11/1/2002,4405,4032,373,8.5,145041,136521,8520,5.9
Caldwell,12/1/2002,4407,4019,388,8.8,145066,136426,8640,6
Caldwell,1/1/2003,4466,3988,478,10.7,145937,137417,8520,5.8
Caldwell,2/1/2003,4389,3939,450,10.3,146100,137482,8618,5.9
Caldwell,3/1/2003,4495,4001,494,11,146022,137434,8588,5.9
Caldwell,4/1/2003,4541,4076,465,10.2,146474,137633,8842,6
Caldwell,5/1/2003,4466,4039,427,9.6,146500,137544,8957,6.1
Caldwell,6/1/2003,4572,4071,501,11,147056,137790,9266,6.3
Caldwell,7/1/2003,4402,3954,448,10.2,146485,137474,9011,6.2
Caldwell,8/1/2003,4386,3970,416,9.5,146445,137549,8896,6.1
Caldwell,9/1/2003,4313,3929,384,8.9,146530,137609,8921,6.1
Caldwell,10/1/2003,4382,4029,353,8.1,146716,137984,8732,6
Caldwell,11/1/2003,4330,3996,334,7.7,147000,138424,8576,5.8
Caldwell,12/1/2003,4282,3944,338,7.9,146729,138411,8317,5.7
Caldwell,1/1/2004,4350,3929,421,9.7,146842,138472,8370,5.7
Caldwell,2/1/2004,4288,3919,369,8.6,146709,138542,8167,5.6
Caldwell,3/1/2004,4254,3875,379,8.9,146944,138453,8491,5.8
Caldwell,4/1/2004,4294,3932,362,8.4,146850,138680,8170,5.6
Caldwell,5/1/2004,4275,3928,347,8.1,147065,138852,8212,5.6
Caldwell,6/1/2004,4365,3949,416,9.5,147460,139174,8286,5.6
Caldwell,7/1/2004,4353,3989,364,8.4,147692,139556,8136,5.5
Caldwell,8/1/2004,4272,3958,314,7.4,147564,139573,7990,5.4
Caldwell,9/1/2004,4223,3913,310,7.3,147415,139487,7927,5.4
Caldwell,10/1/2004,4241,3930,311,7.3,147793,139732,8061,5.5
Caldwell,11/1/2004,4223,3919,304,7.2,148162,140231,7932,5.4
Caldwell,12/1/2004,4146,3826,320,7.7,148059,140125,7934,5.4
Caldwell,1/1/2005,4281,3908,373,8.7,148029,140245,7784,5.3
Caldwell,2/1/2005,4122,3787,335,8.1,148364,140385,7980,5.4
Caldwell,3/1/2005,4144,3823,321,7.7,148391,140654,7737,5.2
Caldwell,4/1/2005,4223,3932,291,6.9,148926,141254,7672,5.2
Caldwell,5/1/2005,4248,3957,291,6.9,149261,141609,7651,5.1
Caldwell,6/1/2005,4327,3991,336,7.8,149238,141714,7524,5
Caldwell,7/1/2005,4375,4059,316,7.2,149432,142026,7406,5
Caldwell,8/1/2005,4305,4011,294,6.8,149779,142434,7345,4.9
Caldwell,9/1/2005,4667,4325,342,7.3,149954,142401,7553,5
Caldwell,10/1/2005,4588,4281,307,6.7,150001,142548,7453,5
Caldwell,11/1/2005,4543,4220,323,7.1,150065,142499,7566,5
Caldwell,12/1/2005,4442,4236,206,4.6,150030,142752,7279,4.9
Caldwell,1/1/2006,4424,4234,190,4.3,150214,143150,7064,4.7
Caldwell,2/1/2006,4406,4246,160,3.6,150641,143457,7184,4.8
Caldwell,3/1/2006,4413,4244,169,3.8,150813,143741,7072,4.7
Caldwell,4/1/2006,4477,4318,159,3.6,150881,143761,7120,4.7
Caldwell,5/1/2006,4399,4213,186,4.2,151069,144089,6980,4.6
Caldwell,6/1/2006,4484,4262,222,5,151354,144353,7001,4.6
Caldwell,7/1/2006,4510,4325,185,4.1,151377,144202,7175,4.7
Caldwell,8/1/2006,4448,4263,185,4.2,151716,144625,7091,4.7
Caldwell,9/1/2006,4527,4343,184,4.1,151662,144815,6847,4.5
Caldwell,10/1/2006,4544,4383,161,3.5,152041,145314,6727,4.4
Caldwell,11/1/2006,4498,4324,174,3.9,152406,145534,6872,4.5
Caldwell,12/1/2006,4427,4255,172,3.9,152732,145970,6762,4.4
Caldwell,1/1/2007,4479,4241,238,5.3,153144,146028,7116,4.6
Caldwell,2/1/2007,4501,4297,204,4.5,152983,146057,6927,4.5
Caldwell,3/1/2007,4507,4297,210,4.7,153051,146320,6731,4.4
Caldwell,4/1/2007,4637,4417,220,4.7,152435,145586,6850,4.5
Caldwell,5/1/2007,4572,4350,222,4.9,152670,145903,6766,4.4
Caldwell,6/1/2007,4581,4332,249,5.4,153041,146063,6979,4.6
Caldwell,7/1/2007,4545,4327,218,4.8,153054,145905,7149,4.7
Caldwell,8/1/2007,4498,4314,184,4.1,152749,145682,7067,4.6
Caldwell,9/1/2007,4593,4389,204,4.4,153414,146244,7170,4.7
Caldwell,10/1/2007,4637,4449,188,4.1,153183,145946,7237,4.7
Caldwell,11/1/2007,4618,4433,185,4,153835,146595,7240,4.7
Caldwell,12/1/2007,4556,4361,195,4.3,153918,146273,7645,5
Caldwell,1/1/2008,4601,4375,226,4.9,154063,146378,7685,5
Caldwell,2/1/2008,4538,4349,189,4.2,153653,146156,7497,4.9
Caldwell,3/1/2008,4640,4423,217,4.7,153908,146086,7822,5.1
Caldwell,4/1/2008,4601,4406,195,4.2,153769,146132,7637,5
Caldwell,5/1/2008,4561,4358,203,4.5,154303,145908,8395,5.4
Caldwell,6/1/2008,4574,4328,246,5.4,154313,145737,8575,5.6
Caldwell,7/1/2008,4566,4335,231,5.1,154469,145532,8937,5.8
Caldwell,8/1/2008,4553,4311,242,5.3,154641,145203,9438,6.1
Caldwell,9/1/2008,4540,4324,216,4.8,154570,145076,9494,6.1
Caldwell,10/1/2008,4559,4317,242,5.3,154876,144802,10074,6.5
Caldwell,11/1/2008,4571,4326,245,5.4,154639,144100,10538,6.8
Caldwell,12/1/2008,4465,4212,253,5.7,154655,143369,11286,7.3
Caldwell,1/1/2009,4547,4208,339,7.5,154210,142152,12058,7.8
Caldwell,2/1/2009,4548,4178,370,8.1,154538,141640,12898,8.3
Caldwell,3/1/2009,4577,4169,408,8.9,154133,140707,13426,8.7
Caldwell,4/1/2009,4675,4259,416,8.9,154509,140656,13853,9
Caldwell,5/1/2009,4717,4288,429,9.1,154747,140248,14499,9.4
Caldwell,6/1/2009,4796,4294,502,10.5,154716,140009,14707,9.5
Caldwell,7/1/2009,4767,4253,514,10.8,154502,139901,14601,9.5
Caldwell,8/1/2009,4660,4176,484,10.4,154307,139492,14814,9.6
Caldwell,9/1/2009,4544,4086,458,10.1,153827,138818,15009,9.8
Caldwell,10/1/2009,4600,4178,422,9.2,153784,138432,15352,10
Caldwell,11/1/2009,4603,4183,420,9.1,153878,138659,15219,9.9
Caldwell,12/1/2009,4575,4128,447,9.8,153111,138013,15098,9.9
Caldwell,1/1/2010,4166,3684,482,11.6,153484,138438,15046,9.8
Caldwell,2/1/2010,4172,3726,446,10.7,153694,138581,15113,9.8
Caldwell,3/1/2010,4220,3769,451,10.7,153954,138751,15202,9.9
Caldwell,4/1/2010,4227,3829,398,9.4,154622,139297,15325,9.9
Caldwell,5/1/2010,4202,3793,409,9.7,154091,139241,14849,9.6
Caldwell,6/1/2010,4250,3790,460,10.8,153616,139141,14474,9.4
Caldwell,7/1/2010,4289,3833,456,10.6,153691,139179,14512,9.4
Caldwell,8/1/2010,4182,3770,412,9.9,154086,139438,14648,9.5
Caldwell,9/1/2010,4184,3774,410,9.8,153975,139396,14579,9.5
Caldwell,10/1/2010,4109,3723,386,9.4,153635,139119,14516,9.4
Caldwell,11/1/2010,4102,3705,397,9.7,154125,139044,15081,9.8
Caldwell,12/1/2010,4059,3663,396,9.8,153650,139301,14348,9.3
Caldwell,1/1/2011,4192,3738,454,10.8,153263,139250,14013,9.1
Caldwell,2/1/2011,4189,3761,428,10.2,153214,139394,13820,9
Caldwell,3/1/2011,4175,3760,415,9.9,153376,139639,13737,9
Caldwell,4/1/2011,4104,3708,396,9.6,153543,139586,13957,9.1
Caldwell,5/1/2011,4080,3687,393,9.6,153479,139624,13855,9
Caldwell,6/1/2011,4138,3711,427,10.3,153346,139384,13962,9.1
Caldwell,7/1/2011,4107,3702,405,9.9,153288,139524,13763,9
Caldwell,8/1/2011,4058,3688,370,9.1,153760,139942,13818,9
Caldwell,9/1/2011,4066,3703,363,8.9,154131,140183,13948,9
Caldwell,10/1/2011,4126,3774,352,8.5,153961,140368,13594,8.8
Caldwell,11/1/2011,4121,3782,339,8.2,154128,140826,13302,8.6
Caldwell,12/1/2011,4090,3761,329,8,153995,140902,13093,8.5
Caldwell,1/1/2012,3959,3584,375,9.5,154381,141584,12797,8.3
Caldwell,2/1/2012,3986,3647,339,8.5,154671,141858,12813,8.3
Caldwell,3/1/2012,4013,3679,334,8.3,154749,142036,12713,8.2
Caldwell,4/1/2012,4038,3716,322,8,154545,141899,12646,8.2
Caldwell,5/1/2012,4052,3722,330,8.1,154866,142206,12660,8.2
Caldwell,6/1/2012,4108,3738,370,9,155083,142391,12692,8.2
Caldwell,7/1/2012,4116,3732,384,9.3,154948,142292,12656,8.2
Caldwell,8/1/2012,4004,3668,336,8.4,154763,142291,12471,8.1
Caldwell,9/1/2012,4026,3713,313,7.8,155160,143044,12115,7.8
Caldwell,10/1/2012,4009,3713,296,7.4,155554,143431,12124,7.8
Caldwell,11/1/2012,3987,3703,284,7.1,155338,143333,12005,7.7
Caldwell,12/1/2012,3966,3647,319,8,155628,143330,12298,7.9
Caldwell,1/1/2013,3919,3553,366,9.3,155763,143292,12471,8
Caldwell,2/1/2013,3928,3599,329,8.4,155312,143362,11950,7.7
Caldwell,3/1/2013,3921,3590,331,8.4,155005,143316,11689,7.5
Caldwell,4/1/2013,3932,3632,300,7.6,155394,143635,11760,7.6
Caldwell,5/1/2013,3981,3653,328,8.2,155536,143882,11654,7.5
Caldwell,6/1/2013,4036,3678,358,8.9,155749,143999,11751,7.5
Caldwell,7/1/2013,4027,3698,329,8.2,155599,144264,11335,7.3
Caldwell,8/1/2013,3953,3648,305,7.7,155605,144326,11279,7.2
Caldwell,9/1/2013,3982,3684,298,7.5,155687,144418,11270,7.2
Caldwell,10/1/2013,3925,3652,273,7,154673,143537,11136,7.2
Caldwell,11/1/2013,3948,3682,266,6.7,155265,144479,10787,6.9
Caldwell,12/1/2013,3954,3708,246,6.2,155182,144778,10404,6.7
Caldwell,1/1/2014,3939,3667,272,6.9,155352,145150,10202,6.6
Caldwell,2/1/2014,3956,3703,253,6.4,155483,145134,10349,6.7
Caldwell,3/1/2014,3978,3717,261,6.6,156028,145648,10380,6.7
Caldwell,4/1/2014,4005,3748,257,6.4,155369,145667,9702,6.2
Caldwell,5/1/2014,4024,3731,293,7.3,155684,145825,9859,6.3
Caldwell,6/1/2014,4125,3787,338,8.2,155707,146247,9460,6.1
Caldwell,7/1/2014,4101,3761,340,8.3,156007,146399,9608,6.2
Caldwell,8/1/2014,4070,3726,344,8.5,156130,146530,9599,6.1
Caldwell,9/1/2014,4121,3768,353,8.6,156040,146778,9262,5.9
Caldwell,10/1/2014,4130,3789,341,8.3,156417,147427,8990,5.7
Caldwell,11/1/2014,4122,3792,330,8,156494,147404,9090,5.8
Caldwell,12/1/2014,4086,3766,320,7.8,156332,147615,8717,5.6
Caldwell,1/1/2015,4038,3660,378,9.4,157030,148145,8885,5.7
Caldwell,2/1/2015,4034,3680,354,8.8,156644,148045,8599,5.5
Caldwell,3/1/2015,4061,3693,368,9.1,156643,148128,8515,5.4
Caldwell,4/1/2015,4083,3706,377,9.2,157060,148511,8550,5.4
Caldwell,5/1/2015,4075,3702,373,9.2,157651,148817,8834,5.6
Caldwell,6/1/2015,4172,3796,376,9,157062,148816,8247,5.3
Caldwell,7/1/2015,4030,3687,343,8.5,156997,148830,8167,5.2
Caldwell,8/1/2015,3961,3677,284,7.2,157172,149181,7992,5.1
Caldwell,9/1/2015,3919,3638,281,7.2,156733,148826,7907,5
Caldwell,10/1/2015,3886,3611,275,7.1,157167,149246,7922,5
Caldwell,11/1/2015,3904,3626,278,7.1,157463,149463,8000,5.1
Caldwell,12/1/2015,3911,3641,270,6.9,158035,150128,7907,5
Caldwell,1/1/2016,3957,3626,331,8.4,158280,150653,7627,4.8
Caldwell,2/1/2016,3924,3619,305,7.8,158640,150939,7702,4.9
Caldwell,3/1/2016,3971,3659,312,7.9,159179,151218,7961,5
Caldwell,4/1/2016,4033,3732,301,7.5,159141,151074,8067,5.1
Caldwell,5/1/2016,4014,3718,296,7.4,158784,151132,7652,4.8
Caldwell,6/1/2016,4101,3761,340,8.3,158967,151223,7744,4.9
Caldwell,7/1/2016,4041,3707,334,8.3,159194,151554,7641,4.8
Caldwell,8/1/2016,4055,3742,313,7.7,159562,151779,7784,4.9
Caldwell,9/1/2016,3976,3671,305,7.7,159714,151761,7953,5
Caldwell,10/1/2016,3918,3639,279,7.1,159605,151793,7811,4.9
Caldwell,11/1/2016,3892,3633,259,6.7,159506,151954,7553,4.7
Caldwell,12/1/2016,3888,3630,258,6.6,159678,152157,7521,4.7
Caldwell,1/1/2017,3871,3591,280,7.2,159620,152152,7468,4.7
Caldwell,2/1/2017,3856,3599,257,6.7,159859,152480,7379,4.6
Caldwell,3/1/2017,3898,3651,247,6.3,160137,153065,7073,4.4
Caldwell,4/1/2017,3891,3662,229,5.9,160345,153255,7089,4.4
Caldwell,5/1/2017,3853,3649,204,5.3,160068,153069,7000,4.4
Caldwell,6/1/2017,3902,3669,233,6,160192,153318,6873,4.3
Caldwell,7/1/2017,3864,3637,227,5.9,160462,153569,6892,4.3
Caldwell,8/1/2017,3831,3620,211,5.5,160586,153503,7082,4.4
Caldwell,9/1/2017,3848,3652,196,5.1,161140,154286,6854,4.3
Caldwell,10/1/2017,3784,3600,184,4.9,160309,153609,6700,4.2
Caldwell,11/1/2017,3824,3637,187,4.9,160579,153805,6774,4.2
Caldwell,12/1/2017,3826,3643,183,4.8,160535,153904,6632,4.1
Caldwell,1/1/2018,3832,3617,215,5.6,160914,154425,6489,4
Caldwell,2/1/2018,3847,3636,211,5.5,161778,155197,6581,4.1
Caldwell,3/1/2018,3873,3652,221,5.7,161686,155214,6472,4
Caldwell,4/1/2018,3875,3656,219,5.7,161771,155312,6459,4
Caldwell,5/1/2018,3841,3626,215,5.6,161848,155652,6196,3.8
Caldwell,6/1/2018,3880,3616,264,6.8,162210,155762,6447,4
Caldwell,7/1/2018,3862,3619,243,6.3,162341,156146,6195,3.8
Caldwell,8/1/2018,3784,3569,215,5.7,161660,155504,6156,3.8
Caldwell,9/1/2018,3798,3599,199,5.2,162087,156015,6073,3.7
Caldwell,10/1/2018,3789,3580,209,5.5,162602,156391,6211,3.8
Caldwell,11/1/2018,3792,3593,199,5.2,162836,156721,6115,3.8
Caldwell,12/1/2018,3804,3592,212,5.6,163206,156817,6389,3.9
Caldwell,1/1/2019,3829,3568,261,6.8,162963,156487,6475,4
Caldwell,2/1/2019,3789,3569,220,5.8,162999,156863,6136,3.8
Caldwell,3/1/2019,3782,3583,199,5.3,162904,156701,6202,3.8
Caldwell,4/1/2019,3724,3550,174,4.7,162586,156625,5961,3.7
Caldwell,5/1/2019,3762,3577,185,4.9,162751,156821,5930,3.6
Caldwell,6/1/2019,3797,3580,217,5.7,163168,157232,5935,3.6
Caldwell,7/1/2019,3734,3512,222,5.9,163590,157529,6061,3.7
Caldwell,8/1/2019,3730,3515,215,5.8,163774,157829,5945,3.6
Caldwell,9/1/2019,3782,3562,220,5.8,164092,158339,5753,3.5
Caldwell,10/1/2019,3762,3532,230,6.1,164416,158545,5871,3.6
Caldwell,11/1/2019,3780,3531,249,6.6,164496,158629,5868,3.6
Caldwell,12/1/2019,3765,3503,262,7,164699,158845,5853,3.6
Caldwell,1/1/2020,3644,3375,269,7.4,164377,158508,5869,3.6
Caldwell,2/1/2020,3619,3388,231,6.4,164467,158714,5753,3.5
Caldwell,3/1/2020,3779,3397,382,10.1,162559,155353,7206,4.4
Caldwell,4/1/2020,3428,3130,298,8.7,156269,133185,23084,14.8
Caldwell,5/1/2020,3499,3187,312,8.9,158101,137173,20929,13.2
Caldwell,6/1/2020,3643,3302,341,9.4,159994,142342,17652,11
Caldwell,7/1/2020,3607,3286,321,8.9,160132,143779,16352,10.2
Caldwell,8/1/2020,3632,3362,270,7.4,160706,147245,13461,8.4
Caldwell,9/1/2020,3663,3388,275,7.5,160174,147620,12554,7.8
Caldwell,10/1/2020,3678,3439,239,6.5,161003,149931,11072,6.9
Caldwell,11/1/2020,3637,3418,219,6,160629,149934,10694,6.7
Caldwell,12/1/2020,3652,3430,222,6.1,160745,149975,10770,6.7
Caldwell,1/1/2021,3661,3422,239,6.5,160088,149852,10236,6.4
Caldwell,2/1/2021,3659,3439,220,6,160184,150189,9995,6.2
Caldwell,3/1/2021,3688,3485,203,5.5,160400,150644,9756,6.1
Caldwell,4/1/2021,3655,3472,183,5,160843,151081,9762,6.1
Caldwell,5/1/2021,3628,3447,181,5,160800,151535,9266,5.8
Caldwell,6/1/2021,3689,3476,213,5.8,161197,151734,9462,5.9
Caldwell,7/1/2021,3665,3474,191,5.2,161504,152773,8731,5.4
Caldwell,8/1/2021,3649,3477,172,4.7,161527,153250,8276,5.1
Caldwell,9/1/2021,3729,3578,151,4,161495,153843,7652,4.7
Caldwell,10/1/2021,3656,3522,134,3.7,161754,154475,7279,4.5
Caldwell,11/1/2021,3663,3542,121,3.3,162281,155530,6751,4.2
Caldwell,12/1/2021,3657,3546,111,3,162497,156099,6398,3.9
Caldwell,1/1/2022,3620,3468,152,4.2,163627,157115,6512,4
Caldwell,2/1/2022,3661,3518,143,3.9,163899,157598,6301,3.8
Caldwell,3/1/2022,3675,3543,132,3.6,164220,158206,6014,3.7
Caldwell,4/1/2022,3641,3516,125,3.4,163893,157891,6002,3.7
Caldwell,5/1/2022,3632,3498,134,3.7,164362,158378,5983,3.6
Caldwell,6/1/2022,3704,3531,173,4.7,164046,158094,5951,3.6
Caldwell,7/1/2022,3660,3508,152,4.2,164026,158258,5768,3.5
Caldwell,8/1/2022,3617,3470,147,4.1,164654,158735,5919,3.6
Caldwell,9/1/2022,3642,3501,141,3.9,164602,158810,5792,3.5
Caldwell,10/1/2022,3632,3508,124,3.4,164648,158684,5964,3.6
Caldwell,11/1/2022,3656,3532,124,3.4,164450,158507,5943,3.6
Caldwell,12/1/2022,3692,3568,124,3.4,165025,159259,5766,3.5
Caldwell,1/1/2023,3626,3483,143,3.9,165964,160217,5747,3.5
Caldwell,2/1/2023,3670,3530,140,3.8,166358,160395,5962,3.6
Caldwell,3/1/2023,3704,3565,139,3.8,166651,160812,5839,3.5
Caldwell,4/1/2023,3670,3555,115,3.1,166725,160974,5751,3.4
Caldwell,5/1/2023,3670,3530,140,3.8,166886,160796,6089,3.6
Caldwell,6/1/2023,3732,3564,168,4.5,166937,160979,5958,3.6
Caldwell,7/1/2023,3682,3541,141,3.8,167103,161183,5920,3.5
Caldwell,8/1/2023,3701,3554,147,4,167759,161475,6284,3.7
Caldwell,9/1/2023,3677,3520,157,4.3,167767,161442,6326,3.8
Caldwell,10/1/2023,3666,3517,149,4.1,167690,161211,6479,3.9
Caldwell,11/1/2023,3699,3540,159,4.3,168140,161886,6254,3.7
Caldwell,12/1/2023,3690,3525,165,4.5,167439,161124,6315,3.8
Caldwell,1/1/2024,3673,3474,199,5.4,167339,161190,6149,3.7
Caldwell,2/1/2024,3668,3474,194,5.3,167475,161013,6462,3.9
Caldwell,3/1/2024,3701,3507,194,5.2,167922,161425,6497,3.9
Caldwell,4/1/2024,3688,3510,178,4.8,167988,161495,6492,3.9
Caldwell,5/1/2024,3651,3471,180,4.9,167799,161164,6635,4
Caldwell,6/1/2024,3765,3545,220,5.8,168005,161155,6849,4.1
Caldwell,7/1/2024,3740,3530,210,5.6,168315,161219,7097,4.2
Caldwell,8/1/2024,3717,3514,203,5.5,168496,161425,7071,4.2
Caldwell,9/1/2024,3703,3511,192,5.2,168703,161802,6901,4.1
Caldwell,10/1/2024,3679,3499,180,4.9,168428,161456,6972,4.1
Caldwell,11/1/2024,3667,3493,174,4.7,168304,161183,7121,4.2
Caldwell,12/1/2024,3671,3499,172,4.7,168547,161661,6886,4.1
Caldwell,1/1/2025,3212,3026,186,5.8,170744,163895,6849,4
Caldwell,2/1/2025,3197,3030,167,5.2,170359,163307,7052,4.1
Cameron,1/1/1990,4063,3821,242,6,125833,119081,6752,5.4
Cameron,2/1/1990,4004,3785,219,5.5,125710,119059,6651,5.3
Cameron,3/1/1990,4079,3873,206,5.1,125801,119203,6598,5.2
Cameron,4/1/1990,4155,3976,179,4.3,125649,118852,6797,5.4
Cameron,5/1/1990,4141,4022,119,2.9,125893,119151,6742,5.4
Cameron,6/1/1990,4199,4070,129,3.1,125573,118983,6590,5.2
Cameron,7/1/1990,4310,4174,136,3.2,125732,118810,6922,5.5
Cameron,8/1/1990,4325,4191,134,3.1,125990,118802,7188,5.7
Cameron,9/1/1990,4277,4118,159,3.7,125892,118524,7368,5.9
Cameron,10/1/1990,4265,4114,151,3.5,125995,118536,7459,5.9
Cameron,11/1/1990,4244,4027,217,5.1,126070,118306,7764,6.2
Cameron,12/1/1990,4086,3868,218,5.3,126142,118241,7901,6.3
Cameron,1/1/1991,3953,3709,244,6.2,125955,117940,8015,6.4
Cameron,2/1/1991,3913,3665,248,6.3,126020,117755,8265,6.6
Cameron,3/1/1991,3834,3600,234,6.1,126238,117652,8586,6.8
Cameron,4/1/1991,3841,3602,239,6.2,126548,118109,8439,6.7
Cameron,5/1/1991,3924,3772,152,3.9,126176,117440,8736,6.9
Cameron,6/1/1991,4043,3883,160,4,126331,117639,8692,6.9
Cameron,7/1/1991,4085,3920,165,4,126154,117568,8586,6.8
Cameron,8/1/1991,4031,3852,179,4.4,126150,117484,8666,6.9
Cameron,9/1/1991,3953,3777,176,4.5,126650,117928,8722,6.9
Cameron,10/1/1991,3932,3764,168,4.3,126642,117800,8842,7
Cameron,11/1/1991,3872,3621,251,6.5,126701,117770,8931,7
Cameron,12/1/1991,3804,3566,238,6.3,126664,117466,9198,7.3
Cameron,1/1/1992,3691,3411,280,7.6,127261,117978,9283,7.3
Cameron,2/1/1992,3705,3396,309,8.3,127207,117753,9454,7.4
Cameron,3/1/1992,3755,3423,332,8.8,127604,118144,9460,7.4
Cameron,4/1/1992,3712,3431,281,7.6,127841,118426,9415,7.4
Cameron,5/1/1992,3823,3553,270,7.1,128119,118375,9744,7.6
Cameron,6/1/1992,3946,3628,318,8.1,128459,118419,10040,7.8
Cameron,7/1/1992,4067,3792,275,6.8,128563,118713,9850,7.7
Cameron,8/1/1992,3990,3717,273,6.8,128613,118826,9787,7.6
Cameron,9/1/1992,3916,3660,256,6.5,128501,118720,9781,7.6
Cameron,10/1/1992,3832,3607,225,5.9,128026,118628,9398,7.3
Cameron,11/1/1992,3711,3421,290,7.8,128441,118876,9565,7.4
Cameron,12/1/1992,3643,3322,321,8.8,128554,118997,9557,7.4
Cameron,1/1/1993,3569,3226,343,9.6,128400,119075,9325,7.3
Cameron,2/1/1993,3538,3231,307,8.7,128458,119275,9183,7.1
Cameron,3/1/1993,3534,3219,315,8.9,128598,119542,9056,7
Cameron,4/1/1993,3586,3319,267,7.4,128584,119474,9110,7.1
Cameron,5/1/1993,3687,3492,195,5.3,129264,120115,9149,7.1
Cameron,6/1/1993,3729,3531,198,5.3,129411,120290,9121,7
Cameron,7/1/1993,3745,3570,175,4.7,129397,120467,8930,6.9
Cameron,8/1/1993,3712,3549,163,4.4,129619,120856,8763,6.8
Cameron,9/1/1993,3697,3533,164,4.4,129268,120554,8714,6.7
Cameron,10/1/1993,3704,3542,162,4.4,129573,120823,8750,6.8
Cameron,11/1/1993,3577,3342,235,6.6,129711,121169,8542,6.6
Cameron,12/1/1993,3555,3329,226,6.4,129941,121464,8477,6.5
Cameron,1/1/1994,3550,3241,309,8.7,130596,121966,8630,6.6
Cameron,2/1/1994,3525,3248,277,7.9,130669,122086,8583,6.6
Cameron,3/1/1994,3594,3317,277,7.7,130400,121930,8470,6.5
Cameron,4/1/1994,3650,3378,272,7.5,130621,122290,8331,6.4
Cameron,5/1/1994,3715,3521,194,5.2,130779,122864,7915,6.1
Cameron,6/1/1994,3751,3532,219,5.8,130561,122634,7927,6.1
Cameron,7/1/1994,3743,3569,174,4.6,130652,122706,7946,6.1
Cameron,8/1/1994,3665,3523,142,3.9,131275,123342,7933,6
Cameron,9/1/1994,3545,3412,133,3.8,131421,123687,7734,5.9
Cameron,10/1/1994,3539,3406,133,3.8,131744,124112,7632,5.8
Cameron,11/1/1994,3465,3247,218,6.3,131891,124516,7375,5.6
Cameron,12/1/1994,3500,3217,283,8.1,131951,124721,7230,5.5
Cameron,1/1/1995,3574,3238,336,9.4,132038,124663,7375,5.6
Cameron,2/1/1995,3503,3251,252,7.2,132115,124928,7187,5.4
Cameron,3/1/1995,3940,3669,271,6.9,132108,124955,7153,5.4
Cameron,4/1/1995,3632,3373,259,7.1,132590,124945,7645,5.8
Cameron,5/1/1995,3689,3517,172,4.7,131851,124421,7430,5.6
Cameron,6/1/1995,3865,3660,205,5.3,131949,124522,7427,5.6
Cameron,7/1/1995,3983,3809,174,4.4,132343,124816,7527,5.7
Cameron,8/1/1995,3996,3820,176,4.4,132336,124852,7484,5.7
Cameron,9/1/1995,3760,3590,170,4.5,132611,125133,7478,5.6
Cameron,10/1/1995,3613,3461,152,4.2,132716,125388,7328,5.5
Cameron,11/1/1995,3383,3142,241,7.1,132614,125188,7426,5.6
Cameron,12/1/1995,3283,3033,250,7.6,132511,125088,7423,5.6
Cameron,1/1/1996,3495,3212,283,8.1,132616,125125,7491,5.6
Cameron,2/1/1996,3510,3248,262,7.5,132952,125639,7313,5.5
Cameron,3/1/1996,3506,3255,251,7.2,133180,125862,7318,5.5
Cameron,4/1/1996,3560,3327,233,6.5,133409,125994,7415,5.6
Cameron,5/1/1996,3638,3472,166,4.6,133667,126244,7423,5.6
Cameron,6/1/1996,3704,3529,175,4.7,133697,126602,7095,5.3
Cameron,7/1/1996,3753,3598,155,4.1,134284,126947,7337,5.5
Cameron,8/1/1996,3680,3547,133,3.6,134054,127172,6882,5.1
Cameron,9/1/1996,3705,3562,143,3.9,134515,127536,6979,5.2
Cameron,10/1/1996,3618,3488,130,3.6,134921,127890,7031,5.2
Cameron,11/1/1996,3460,3271,189,5.5,135007,127771,7236,5.4
Cameron,12/1/1996,3445,3241,204,5.9,135113,127860,7253,5.4
Cameron,1/1/1997,3269,3070,199,6.1,135456,128298,7158,5.3
Cameron,2/1/1997,3338,3149,189,5.7,135400,128298,7102,5.2
Cameron,3/1/1997,3337,3113,224,6.7,135891,128891,7000,5.2
Cameron,4/1/1997,3459,3250,209,6,136016,129143,6873,5.1
Cameron,5/1/1997,3630,3493,137,3.8,136119,129464,6655,4.9
Cameron,6/1/1997,3797,3636,161,4.2,136211,129412,6799,5
Cameron,7/1/1997,3836,3682,154,4,136477,129822,6655,4.9
Cameron,8/1/1997,3879,3738,141,3.6,136618,130010,6608,4.8
Cameron,9/1/1997,3869,3709,160,4.1,136675,130019,6656,4.9
Cameron,10/1/1997,3839,3696,143,3.7,136633,130179,6454,4.7
Cameron,11/1/1997,3602,3428,174,4.8,136961,130653,6308,4.6
Cameron,12/1/1997,3596,3399,197,5.5,137155,130679,6476,4.7
Cameron,1/1/1998,3680,3445,235,6.4,137095,130726,6368,4.6
Cameron,2/1/1998,3712,3513,199,5.4,137112,130807,6306,4.6
Cameron,3/1/1998,3804,3574,230,6,137236,130814,6422,4.7
Cameron,4/1/1998,3871,3677,194,5,137150,131209,5941,4.3
Cameron,5/1/1998,4045,3923,122,3,137372,131325,6047,4.4
Cameron,6/1/1998,4242,4072,170,4,137455,131244,6212,4.5
Cameron,7/1/1998,4595,4450,145,3.2,137588,131329,6259,4.5
Cameron,8/1/1998,4413,4273,140,3.2,137570,131390,6179,4.5
Cameron,9/1/1998,4245,4116,129,3,138286,131986,6300,4.6
Cameron,10/1/1998,4214,4088,126,3,138279,131999,6280,4.5
Cameron,11/1/1998,4208,4077,131,3.1,138381,132280,6100,4.4
Cameron,12/1/1998,4162,4004,158,3.8,138634,132602,6032,4.4
Cameron,1/1/1999,3759,3554,205,5.5,139003,133027,5976,4.3
Cameron,2/1/1999,3704,3507,197,5.3,138967,132856,6111,4.4
Cameron,3/1/1999,3667,3475,192,5.2,138730,132947,5783,4.2
Cameron,4/1/1999,3833,3649,184,4.8,138959,132955,6004,4.3
Cameron,5/1/1999,3804,3634,170,4.5,139107,133311,5796,4.2
Cameron,6/1/1999,3869,3686,183,4.7,139329,133378,5951,4.3
Cameron,7/1/1999,3910,3736,174,4.5,139439,133414,6025,4.3
Cameron,8/1/1999,3845,3687,158,4.1,139430,133591,5838,4.2
Cameron,9/1/1999,3838,3659,179,4.7,139622,133707,5915,4.2
Cameron,10/1/1999,3786,3628,158,4.2,139771,133993,5778,4.1
Cameron,11/1/1999,3843,3640,203,5.3,140025,134309,5716,4.1
Cameron,12/1/1999,3752,3560,192,5.1,140177,134523,5653,4
Cameron,1/1/2000,4517,4274,243,5.4,142267,136559,5708,4
Cameron,2/1/2000,4579,4337,242,5.3,142456,136598,5858,4.1
Cameron,3/1/2000,4602,4345,257,5.6,142434,136701,5733,4
Cameron,4/1/2000,4561,4349,212,4.6,142751,137270,5481,3.8
Cameron,5/1/2000,4500,4294,206,4.6,142388,136630,5758,4
Cameron,6/1/2000,4522,4282,240,5.3,142591,136940,5651,4
Cameron,7/1/2000,4535,4323,212,4.7,142278,136531,5747,4
Cameron,8/1/2000,4492,4288,204,4.5,142514,136662,5853,4.1
Cameron,9/1/2000,4421,4233,188,4.3,142518,136893,5625,3.9
Cameron,10/1/2000,4488,4300,188,4.2,142622,137088,5534,3.9
Cameron,11/1/2000,4505,4280,225,5,142962,137322,5639,3.9
Cameron,12/1/2000,4509,4286,223,4.9,143248,137614,5634,3.9
Cameron,1/1/2001,4522,4234,288,6.4,143800,137778,6023,4.2
Cameron,2/1/2001,4509,4243,266,5.9,143701,137612,6089,4.2
Cameron,3/1/2001,4549,4269,280,6.2,143924,137783,6141,4.3
Cameron,4/1/2001,4482,4252,230,5.1,143569,137299,6271,4.4
Cameron,5/1/2001,4399,4201,198,4.5,143318,137092,6226,4.3
Cameron,6/1/2001,4471,4227,244,5.5,143357,136873,6484,4.5
Cameron,7/1/2001,4500,4293,207,4.6,143654,137071,6583,4.6
Cameron,8/1/2001,4385,4195,190,4.3,143284,136241,7042,4.9
Cameron,9/1/2001,4434,4234,200,4.5,143989,136846,7142,5
Cameron,10/1/2001,4427,4236,191,4.3,144086,136392,7694,5.3
Cameron,11/1/2001,4439,4215,224,5,144240,136238,8003,5.5
Cameron,12/1/2001,4409,4182,227,5.1,144305,136047,8258,5.7
Cameron,1/1/2002,4384,4135,249,5.7,143883,135701,8182,5.7
Cameron,2/1/2002,4433,4198,235,5.3,144653,136438,8215,5.7
Cameron,3/1/2002,4436,4191,245,5.5,144481,136177,8304,5.7
Cameron,4/1/2002,4395,4150,245,5.6,144725,136126,8599,5.9
Cameron,5/1/2002,4298,4084,214,5,144938,136539,8399,5.8
Cameron,6/1/2002,4367,4111,256,5.9,144808,136415,8393,5.8
Cameron,7/1/2002,4389,4156,233,5.3,144803,136413,8390,5.8
Cameron,8/1/2002,4328,4117,211,4.9,145009,136705,8304,5.7
Cameron,9/1/2002,4344,4131,213,4.9,145552,137302,8251,5.7
Cameron,10/1/2002,4298,4106,192,4.5,145314,137008,8307,5.7
Cameron,11/1/2002,4323,4105,218,5,145041,136521,8520,5.9
Cameron,12/1/2002,4315,4100,215,5,145066,136426,8640,6
Cameron,1/1/2003,4400,4143,257,5.8,145937,137417,8520,5.8
Cameron,2/1/2003,4410,4163,247,5.6,146100,137482,8618,5.9
Cameron,3/1/2003,4400,4141,259,5.9,146022,137434,8588,5.9
Cameron,4/1/2003,4383,4136,247,5.6,146474,137633,8842,6
Cameron,5/1/2003,4312,4084,228,5.3,146500,137544,8957,6.1
Cameron,6/1/2003,4352,4083,269,6.2,147056,137790,9266,6.3
Cameron,7/1/2003,4338,4079,259,6,146485,137474,9011,6.2
Cameron,8/1/2003,4328,4109,219,5.1,146445,137549,8896,6.1
Cameron,9/1/2003,4263,4061,202,4.7,146530,137609,8921,6.1
Cameron,10/1/2003,4331,4135,196,4.5,146716,137984,8732,6
Cameron,11/1/2003,4357,4145,212,4.9,147000,138424,8576,5.8
Cameron,12/1/2003,4339,4130,209,4.8,146729,138411,8317,5.7
Cameron,1/1/2004,4310,4052,258,6,146842,138472,8370,5.7
Cameron,2/1/2004,4321,4071,250,5.8,146709,138542,8167,5.6
Cameron,3/1/2004,4392,4130,262,6,146944,138453,8491,5.8
Cameron,4/1/2004,4336,4102,234,5.4,146850,138680,8170,5.6
Cameron,5/1/2004,4257,4050,207,4.9,147065,138852,8212,5.6
Cameron,6/1/2004,4316,4062,254,5.9,147460,139174,8286,5.6
Cameron,7/1/2004,4312,4098,214,5,147692,139556,8136,5.5
Cameron,8/1/2004,4341,4151,190,4.4,147564,139573,7990,5.4
Cameron,9/1/2004,4263,4092,171,4,147415,139487,7927,5.4
Cameron,10/1/2004,4344,4175,169,3.9,147793,139732,8061,5.5
Cameron,11/1/2004,4375,4182,193,4.4,148162,140231,7932,5.4
Cameron,12/1/2004,4394,4190,204,4.6,148059,140125,7934,5.4
Cameron,1/1/2005,4346,4096,250,5.8,148029,140245,7784,5.3
Cameron,2/1/2005,4335,4112,223,5.1,148364,140385,7980,5.4
Cameron,3/1/2005,4331,4126,205,4.7,148391,140654,7737,5.2
Cameron,4/1/2005,4359,4164,195,4.5,148926,141254,7672,5.2
Cameron,5/1/2005,4389,4215,174,4,149261,141609,7651,5.1
Cameron,6/1/2005,4438,4207,231,5.2,149238,141714,7524,5
Cameron,7/1/2005,4394,4191,203,4.6,149432,142026,7406,5
Cameron,8/1/2005,4389,4206,183,4.2,149779,142434,7345,4.9
Cameron,9/1/2005,4720,4456,264,5.6,149954,142401,7553,5
Cameron,10/1/2005,4784,4312,472,9.9,150001,142548,7453,5
Cameron,11/1/2005,4890,4383,507,10.4,150065,142499,7566,5
Cameron,12/1/2005,4593,4371,222,4.8,150030,142752,7279,4.9
Cameron,1/1/2006,3718,3552,166,4.5,150214,143150,7064,4.7
Cameron,2/1/2006,3701,3562,139,3.8,150641,143457,7184,4.8
Cameron,3/1/2006,3730,3585,145,3.9,150813,143741,7072,4.7
Cameron,4/1/2006,3686,3580,106,2.9,150881,143761,7120,4.7
Cameron,5/1/2006,3686,3578,108,2.9,151069,144089,6980,4.6
Cameron,6/1/2006,3725,3581,144,3.9,151354,144353,7001,4.6
Cameron,7/1/2006,3708,3587,121,3.3,151377,144202,7175,4.7
Cameron,8/1/2006,3661,3541,120,3.3,151716,144625,7091,4.7
Cameron,9/1/2006,3686,3578,108,2.9,151662,144815,6847,4.5
Cameron,10/1/2006,3733,3623,110,2.9,152041,145314,6727,4.4
Cameron,11/1/2006,3763,3644,119,3.2,152406,145534,6872,4.5
Cameron,12/1/2006,3769,3650,119,3.2,152732,145970,6762,4.4
Cameron,1/1/2007,3562,3412,150,4.2,153144,146028,7116,4.6
Cameron,2/1/2007,3540,3425,115,3.2,152983,146057,6927,4.5
Cameron,3/1/2007,3563,3446,117,3.3,153051,146320,6731,4.4
Cameron,4/1/2007,3575,3468,107,3,152435,145586,6850,4.5
Cameron,5/1/2007,3577,3462,115,3.2,152670,145903,6766,4.4
Cameron,6/1/2007,3646,3502,144,3.9,153041,146063,6979,4.6
Cameron,7/1/2007,3602,3470,132,3.7,153054,145905,7149,4.7
Cameron,8/1/2007,3565,3432,133,3.7,152749,145682,7067,4.6
Cameron,9/1/2007,3527,3402,125,3.5,153414,146244,7170,4.7
Cameron,10/1/2007,3568,3455,113,3.2,153183,145946,7237,4.7
Cameron,11/1/2007,3588,3466,122,3.4,153835,146595,7240,4.7
Cameron,12/1/2007,3556,3431,125,3.5,153918,146273,7645,5
Cameron,1/1/2008,3453,3304,149,4.3,154063,146378,7685,5
Cameron,2/1/2008,3453,3328,125,3.6,153653,146156,7497,4.9
Cameron,3/1/2008,3479,3346,133,3.8,153908,146086,7822,5.1
Cameron,4/1/2008,3553,3434,119,3.3,153769,146132,7637,5
Cameron,5/1/2008,3571,3441,130,3.6,154303,145908,8395,5.4
Cameron,6/1/2008,3621,3454,167,4.6,154313,145737,8575,5.6
Cameron,7/1/2008,3654,3495,159,4.4,154469,145532,8937,5.8
Cameron,8/1/2008,3569,3428,141,4,154641,145203,9438,6.1
Cameron,9/1/2008,3547,3406,141,4,154570,145076,9494,6.1
Cameron,10/1/2008,3618,3430,188,5.2,154876,144802,10074,6.5
Cameron,11/1/2008,3588,3421,167,4.7,154639,144100,10538,6.8
Cameron,12/1/2008,3525,3360,165,4.7,154655,143369,11286,7.3
Cameron,1/1/2009,3199,3013,186,5.8,154210,142152,12058,7.8
Cameron,2/1/2009,3203,3006,197,6.2,154538,141640,12898,8.3
Cameron,3/1/2009,3183,2997,186,5.8,154133,140707,13426,8.7
Cameron,4/1/2009,3144,2985,159,5.1,154509,140656,13853,9
Cameron,5/1/2009,3165,2995,170,5.4,154747,140248,14499,9.4
Cameron,6/1/2009,3193,2986,207,6.5,154716,140009,14707,9.5
Cameron,7/1/2009,3114,2927,187,6,154502,139901,14601,9.5
Cameron,8/1/2009,3071,2890,181,5.9,154307,139492,14814,9.6
Cameron,9/1/2009,3044,2874,170,5.6,153827,138818,15009,9.8
Cameron,10/1/2009,3125,2954,171,5.5,153784,138432,15352,10
Cameron,11/1/2009,3136,2961,175,5.6,153878,138659,15219,9.9
Cameron,12/1/2009,3075,2895,180,5.9,153111,138013,15098,9.9
Cameron,1/1/2010,3274,3083,191,5.8,153484,138438,15046,9.8
Cameron,2/1/2010,3295,3108,187,5.7,153694,138581,15113,9.8
Cameron,3/1/2010,3308,3118,190,5.7,153954,138751,15202,9.9
Cameron,4/1/2010,3349,3167,182,5.4,154622,139297,15325,9.9
Cameron,5/1/2010,3326,3149,177,5.3,154091,139241,14849,9.6
Cameron,6/1/2010,3358,3142,216,6.4,153616,139141,14474,9.4
Cameron,7/1/2010,3360,3145,215,6.4,153691,139179,14512,9.4
Cameron,8/1/2010,3331,3120,211,6.3,154086,139438,14648,9.5
Cameron,9/1/2010,3295,3100,195,5.9,153975,139396,14579,9.5
Cameron,10/1/2010,3290,3096,194,5.9,153635,139119,14516,9.4
Cameron,11/1/2010,3274,3082,192,5.9,154125,139044,15081,9.8
Cameron,12/1/2010,3248,3076,172,5.3,153650,139301,14348,9.3
Cameron,1/1/2011,3251,3043,208,6.4,153263,139250,14013,9.1
Cameron,2/1/2011,3237,3054,183,5.7,153214,139394,13820,9
Cameron,3/1/2011,3249,3074,175,5.4,153376,139639,13737,9
Cameron,4/1/2011,3287,3114,173,5.3,153543,139586,13957,9.1
Cameron,5/1/2011,3266,3093,173,5.3,153479,139624,13855,9
Cameron,6/1/2011,3287,3088,199,6.1,153346,139384,13962,9.1
Cameron,7/1/2011,3297,3115,182,5.5,153288,139524,13763,9
Cameron,8/1/2011,3261,3097,164,5,153760,139942,13818,9
Cameron,9/1/2011,3267,3102,165,5.1,154131,140183,13948,9
Cameron,10/1/2011,3278,3113,165,5,153961,140368,13594,8.8
Cameron,11/1/2011,3300,3133,167,5.1,154128,140826,13302,8.6
Cameron,12/1/2011,3278,3115,163,5,153995,140902,13093,8.5
Cameron,1/1/2012,3203,3019,184,5.7,154381,141584,12797,8.3
Cameron,2/1/2012,3200,3038,162,5.1,154671,141858,12813,8.3
Cameron,3/1/2012,3212,3056,156,4.9,154749,142036,12713,8.2
Cameron,4/1/2012,3218,3067,151,4.7,154545,141899,12646,8.2
Cameron,5/1/2012,3234,3068,166,5.1,154866,142206,12660,8.2
Cameron,6/1/2012,3304,3111,193,5.8,155083,142391,12692,8.2
Cameron,7/1/2012,3298,3125,173,5.2,154948,142292,12656,8.2
Cameron,8/1/2012,3244,3085,159,4.9,154763,142291,12471,8.1
Cameron,9/1/2012,3238,3099,139,4.3,155160,143044,12115,7.8
Cameron,10/1/2012,3292,3145,147,4.5,155554,143431,12124,7.8
Cameron,11/1/2012,3274,3131,143,4.4,155338,143333,12005,7.7
Cameron,12/1/2012,3259,3096,163,5,155628,143330,12298,7.9
Cameron,1/1/2013,3273,3076,197,6,155763,143292,12471,8
Cameron,2/1/2013,3256,3089,167,5.1,155312,143362,11950,7.7
Cameron,3/1/2013,3269,3099,170,5.2,155005,143316,11689,7.5
Cameron,4/1/2013,3294,3125,169,5.1,155394,143635,11760,7.6
Cameron,5/1/2013,3302,3123,179,5.4,155536,143882,11654,7.5
Cameron,6/1/2013,3364,3153,211,6.3,155749,143999,11751,7.5
Cameron,7/1/2013,3368,3179,189,5.6,155599,144264,11335,7.3
Cameron,8/1/2013,3314,3145,169,5.1,155605,144326,11279,7.2
Cameron,9/1/2013,3329,3168,161,4.8,155687,144418,11270,7.2
Cameron,10/1/2013,3358,3206,152,4.5,154673,143537,11136,7.2
Cameron,11/1/2013,3351,3207,144,4.3,155265,144479,10787,6.9
Cameron,12/1/2013,3318,3194,124,3.7,155182,144778,10404,6.7
Cameron,1/1/2014,3255,3110,145,4.5,155352,145150,10202,6.6
Cameron,2/1/2014,3256,3126,130,4,155483,145134,10349,6.7
Cameron,3/1/2014,3323,3178,145,4.4,156028,145648,10380,6.7
Cameron,4/1/2014,3324,3189,135,4.1,155369,145667,9702,6.2
Cameron,5/1/2014,3380,3227,153,4.5,155684,145825,9859,6.3
Cameron,6/1/2014,3447,3267,180,5.2,155707,146247,9460,6.1
Cameron,7/1/2014,3510,3307,203,5.8,156007,146399,9608,6.2
Cameron,8/1/2014,3504,3306,198,5.7,156130,146530,9599,6.1
Cameron,9/1/2014,3490,3316,174,5,156040,146778,9262,5.9
Cameron,10/1/2014,3522,3345,177,5,156417,147427,8990,5.7
Cameron,11/1/2014,3559,3378,181,5.1,156494,147404,9090,5.8
Cameron,12/1/2014,3533,3365,168,4.8,156332,147615,8717,5.6
Cameron,1/1/2015,3575,3380,195,5.5,157030,148145,8885,5.7
Cameron,2/1/2015,3574,3401,173,4.8,156644,148045,8599,5.5
Cameron,3/1/2015,3630,3445,185,5.1,156643,148128,8515,5.4
Cameron,4/1/2015,3641,3472,169,4.6,157060,148511,8550,5.4
Cameron,5/1/2015,3623,3444,179,4.9,157651,148817,8834,5.6
Cameron,6/1/2015,3670,3487,183,5,157062,148816,8247,5.3
Cameron,7/1/2015,3691,3513,178,4.8,156997,148830,8167,5.2
Cameron,8/1/2015,3661,3496,165,4.5,157172,149181,7992,5.1
Cameron,9/1/2015,3635,3479,156,4.3,156733,148826,7907,5
Cameron,10/1/2015,3721,3566,155,4.2,157167,149246,7922,5
Cameron,11/1/2015,3729,3584,145,3.9,157463,149463,8000,5.1
Cameron,12/1/2015,3644,3508,136,3.7,158035,150128,7907,5
Cameron,1/1/2016,3702,3530,172,4.6,158280,150653,7627,4.8
Cameron,2/1/2016,3729,3569,160,4.3,158640,150939,7702,4.9
Cameron,3/1/2016,3779,3612,167,4.4,159179,151218,7961,5
Cameron,4/1/2016,3778,3615,163,4.3,159141,151074,8067,5.1
Cameron,5/1/2016,3782,3626,156,4.1,158784,151132,7652,4.8
Cameron,6/1/2016,3878,3685,193,5,158967,151223,7744,4.9
Cameron,7/1/2016,3880,3696,184,4.7,159194,151554,7641,4.8
Cameron,8/1/2016,3827,3654,173,4.5,159562,151779,7784,4.9
Cameron,9/1/2016,3882,3702,180,4.6,159714,151761,7953,5
Cameron,10/1/2016,3868,3707,161,4.2,159605,151793,7811,4.9
Cameron,11/1/2016,3860,3715,145,3.8,159506,151954,7553,4.7
Cameron,12/1/2016,3832,3688,144,3.8,159678,152157,7521,4.7
Cameron,1/1/2017,3840,3679,161,4.2,159620,152152,7468,4.7
Cameron,2/1/2017,3859,3702,157,4.1,159859,152480,7379,4.6
Cameron,3/1/2017,3928,3783,145,3.7,160137,153065,7073,4.4
Cameron,4/1/2017,3964,3823,141,3.6,160345,153255,7089,4.4
Cameron,5/1/2017,3969,3837,132,3.3,160068,153069,7000,4.4
Cameron,6/1/2017,4069,3917,152,3.7,160192,153318,6873,4.3
Cameron,7/1/2017,4118,3962,156,3.8,160462,153569,6892,4.3
Cameron,8/1/2017,4084,3930,154,3.8,160586,153503,7082,4.4
Cameron,9/1/2017,4076,3927,149,3.7,161140,154286,6854,4.3
Cameron,10/1/2017,4065,3936,129,3.2,160309,153609,6700,4.2
Cameron,11/1/2017,4032,3904,128,3.2,160579,153805,6774,4.2
Cameron,12/1/2017,3999,3879,120,3,160535,153904,6632,4.1
Cameron,1/1/2018,3993,3862,131,3.3,160914,154425,6489,4
Cameron,2/1/2018,4052,3916,136,3.4,161778,155197,6581,4.1
Cameron,3/1/2018,4104,3968,136,3.3,161686,155214,6472,4
Cameron,4/1/2018,4103,3969,134,3.3,161771,155312,6459,4
Cameron,5/1/2018,4090,3950,140,3.4,161848,155652,6196,3.8
Cameron,6/1/2018,4175,3989,186,4.5,162210,155762,6447,4
Cameron,7/1/2018,4155,3980,175,4.2,162341,156146,6195,3.8
Cameron,8/1/2018,4067,3918,149,3.7,161660,155504,6156,3.8
Cameron,9/1/2018,4046,3911,135,3.3,162087,156015,6073,3.7
Cameron,10/1/2018,4082,3944,138,3.4,162602,156391,6211,3.8
Cameron,11/1/2018,4034,3908,126,3.1,162836,156721,6115,3.8
Cameron,12/1/2018,3968,3841,127,3.2,163206,156817,6389,3.9
Cameron,1/1/2019,3923,3774,149,3.8,162963,156487,6475,4
Cameron,2/1/2019,3932,3801,131,3.3,162999,156863,6136,3.8
Cameron,3/1/2019,3991,3863,128,3.2,162904,156701,6202,3.8
Cameron,4/1/2019,3980,3858,122,3.1,162586,156625,5961,3.7
Cameron,5/1/2019,3960,3833,127,3.2,162751,156821,5930,3.6
Cameron,6/1/2019,4005,3837,168,4.2,163168,157232,5935,3.6
Cameron,7/1/2019,3968,3805,163,4.1,163590,157529,6061,3.7
Cameron,8/1/2019,3908,3766,142,3.6,163774,157829,5945,3.6
Cameron,9/1/2019,3917,3776,141,3.6,164092,158339,5753,3.5
Cameron,10/1/2019,3943,3797,146,3.7,164416,158545,5871,3.6
Cameron,11/1/2019,3907,3773,134,3.4,164496,158629,5868,3.6
Cameron,12/1/2019,3851,3707,144,3.7,164699,158845,5853,3.6
Cameron,1/1/2020,3830,3671,159,4.2,164377,158508,5869,3.6
Cameron,2/1/2020,3799,3670,129,3.4,164467,158714,5753,3.5
Cameron,3/1/2020,3828,3616,212,5.5,162559,155353,7206,4.4
Cameron,4/1/2020,3373,3108,265,7.9,156269,133185,23084,14.8
Cameron,5/1/2020,3368,3098,270,8,158101,137173,20929,13.2
Cameron,6/1/2020,3470,3214,256,7.4,159994,142342,17652,11
Cameron,7/1/2020,3524,3284,240,6.8,160132,143779,16352,10.2
Cameron,8/1/2020,3482,3289,193,5.5,160706,147245,13461,8.4
Cameron,9/1/2020,3202,2939,263,8.2,160174,147620,12554,7.8
Cameron,10/1/2020,3248,3050,198,6.1,161003,149931,11072,6.9
Cameron,11/1/2020,3310,3127,183,5.5,160629,149934,10694,6.7
Cameron,12/1/2020,3350,3173,177,5.3,160745,149975,10770,6.7
Cameron,1/1/2021,3327,3152,175,5.3,160088,149852,10236,6.4
Cameron,2/1/2021,3349,3195,154,4.6,160184,150189,9995,6.2
Cameron,3/1/2021,3377,3233,144,4.3,160400,150644,9756,6.1
Cameron,4/1/2021,3417,3282,135,4,160843,151081,9762,6.1
Cameron,5/1/2021,3420,3291,129,3.8,160800,151535,9266,5.8
Cameron,6/1/2021,3501,3349,152,4.3,161197,151734,9462,5.9
Cameron,7/1/2021,3534,3404,130,3.7,161504,152773,8731,5.4
Cameron,8/1/2021,3460,3342,118,3.4,161527,153250,8276,5.1
Cameron,9/1/2021,3538,3430,108,3.1,161495,153843,7652,4.7
Cameron,10/1/2021,3523,3424,99,2.8,161754,154475,7279,4.5
Cameron,11/1/2021,3498,3411,87,2.5,162281,155530,6751,4.2
Cameron,12/1/2021,3443,3360,83,2.4,162497,156099,6398,3.9
Cameron,1/1/2022,3425,3320,105,3.1,163627,157115,6512,4
Cameron,2/1/2022,3419,3318,101,3,163899,157598,6301,3.8
Cameron,3/1/2022,3433,3343,90,2.6,164220,158206,6014,3.7
Cameron,4/1/2022,3417,3333,84,2.5,163893,157891,6002,3.7
Cameron,5/1/2022,3384,3295,89,2.6,164362,158378,5983,3.6
Cameron,6/1/2022,3438,3321,117,3.4,164046,158094,5951,3.6
Cameron,7/1/2022,3417,3316,101,3,164026,158258,5768,3.5
Cameron,8/1/2022,3386,3292,94,2.8,164654,158735,5919,3.6
Cameron,9/1/2022,3410,3311,99,2.9,164602,158810,5792,3.5
Cameron,10/1/2022,3386,3294,92,2.7,164648,158684,5964,3.6
Cameron,11/1/2022,3366,3275,91,2.7,164450,158507,5943,3.6
Cameron,12/1/2022,3340,3245,95,2.8,165025,159259,5766,3.5
Cameron,1/1/2023,3343,3229,114,3.4,165964,160217,5747,3.5
Cameron,2/1/2023,3356,3258,98,2.9,166358,160395,5962,3.6
Cameron,3/1/2023,3401,3310,91,2.7,166651,160812,5839,3.5
Cameron,4/1/2023,3364,3283,81,2.4,166725,160974,5751,3.4
Cameron,5/1/2023,3342,3249,93,2.8,166886,160796,6089,3.6
Cameron,6/1/2023,3402,3295,107,3.1,166937,160979,5958,3.6
Cameron,7/1/2023,3389,3305,84,2.5,167103,161183,5920,3.5
Cameron,8/1/2023,3366,3276,90,2.7,167759,161475,6284,3.7
Cameron,9/1/2023,3381,3284,97,2.9,167767,161442,6326,3.8
Cameron,10/1/2023,3389,3297,92,2.7,167690,161211,6479,3.9
Cameron,11/1/2023,3394,3306,88,2.6,168140,161886,6254,3.7
Cameron,12/1/2023,3364,3266,98,2.9,167439,161124,6315,3.8
Cameron,1/1/2024,3351,3242,109,3.3,167339,161190,6149,3.7
Cameron,2/1/2024,3368,3260,108,3.2,167475,161013,6462,3.9
Cameron,3/1/2024,3397,3296,101,3,167922,161425,6497,3.9
Cameron,4/1/2024,3405,3327,78,2.3,167988,161495,6492,3.9
Cameron,5/1/2024,3368,3276,92,2.7,167799,161164,6635,4
Cameron,6/1/2024,3449,3315,134,3.9,168005,161155,6849,4.1
Cameron,7/1/2024,3473,3339,134,3.9,168315,161219,7097,4.2
Cameron,8/1/2024,3440,3305,135,3.9,168496,161425,7071,4.2
Cameron,9/1/2024,3434,3304,130,3.8,168703,161802,6901,4.1
Cameron,10/1/2024,3431,3303,128,3.7,168428,161456,6972,4.1
Cameron,11/1/2024,3410,3286,124,3.6,168304,161183,7121,4.2
Cameron,12/1/2024,3397,3272,125,3.7,168547,161661,6886,4.1
Cameron,1/1/2025,1876,1776,100,5.3,170744,163895,6849,4
Cameron,2/1/2025,1890,1796,94,5,170359,163307,7052,4.1
Catahoula,1/1/1990,4222,3786,436,10.3,125833,119081,6752,5.4
Catahoula,2/1/1990,4021,3679,342,8.5,125710,119059,6651,5.3
Catahoula,3/1/1990,4137,3810,327,7.9,125801,119203,6598,5.2
Catahoula,4/1/1990,4148,3853,295,7.1,125649,118852,6797,5.4
Catahoula,5/1/1990,4256,3962,294,6.9,125893,119151,6742,5.4
Catahoula,6/1/1990,4295,3922,373,8.7,125573,118983,6590,5.2
Catahoula,7/1/1990,4357,3973,384,8.8,125732,118810,6922,5.5
Catahoula,8/1/1990,4201,3858,343,8.2,125990,118802,7188,5.7
Catahoula,9/1/1990,4312,4002,310,7.2,125892,118524,7368,5.9
Catahoula,10/1/1990,4280,3999,281,6.6,125995,118536,7459,5.9
Catahoula,11/1/1990,4208,3902,306,7.3,126070,118306,7764,6.2
Catahoula,12/1/1990,4097,3731,366,8.9,126142,118241,7901,6.3
Catahoula,1/1/1991,4350,3712,638,14.7,125955,117940,8015,6.4
Catahoula,2/1/1991,4322,3759,563,13,126020,117755,8265,6.6
Catahoula,3/1/1991,4382,3830,552,12.6,126238,117652,8586,6.8
Catahoula,4/1/1991,4534,4074,460,10.1,126548,118109,8439,6.7
Catahoula,5/1/1991,4583,4063,520,11.3,126176,117440,8736,6.9
Catahoula,6/1/1991,4669,4136,533,11.4,126331,117639,8692,6.9
Catahoula,7/1/1991,4655,4220,435,9.3,126154,117568,8586,6.8
Catahoula,8/1/1991,4644,4209,435,9.4,126150,117484,8666,6.9
Catahoula,9/1/1991,4468,4040,428,9.6,126650,117928,8722,6.9
Catahoula,10/1/1991,4581,4200,381,8.3,126642,117800,8842,7
Catahoula,11/1/1991,4576,4177,399,8.7,126701,117770,8931,7
Catahoula,12/1/1991,4562,4034,528,11.6,126664,117466,9198,7.3
Catahoula,1/1/1992,4836,4114,722,14.9,127261,117978,9283,7.3
Catahoula,2/1/1992,4883,4253,630,12.9,127207,117753,9454,7.4
Catahoula,3/1/1992,4969,4337,632,12.7,127604,118144,9460,7.4
Catahoula,4/1/1992,4963,4434,529,10.7,127841,118426,9415,7.4
Catahoula,5/1/1992,4913,4400,513,10.4,128119,118375,9744,7.6
Catahoula,6/1/1992,5115,4395,720,14.1,128459,118419,10040,7.8
Catahoula,7/1/1992,5196,4583,613,11.8,128563,118713,9850,7.7
Catahoula,8/1/1992,4966,4513,453,9.1,128613,118826,9787,7.6
Catahoula,9/1/1992,4842,4422,420,8.7,128501,118720,9781,7.6
Catahoula,10/1/1992,4643,4284,359,7.7,128026,118628,9398,7.3
Catahoula,11/1/1992,4636,4276,360,7.8,128441,118876,9565,7.4
Catahoula,12/1/1992,4708,4277,431,9.2,128554,118997,9557,7.4
Catahoula,1/1/1993,4852,4342,510,10.5,128400,119075,9325,7.3
Catahoula,2/1/1993,4812,4364,448,9.3,128458,119275,9183,7.1
Catahoula,3/1/1993,4916,4452,464,9.4,128598,119542,9056,7
Catahoula,4/1/1993,4859,4481,378,7.8,128584,119474,9110,7.1
Catahoula,5/1/1993,4987,4611,376,7.5,129264,120115,9149,7.1
Catahoula,6/1/1993,5123,4674,449,8.8,129411,120290,9121,7
Catahoula,7/1/1993,5098,4680,418,8.2,129397,120467,8930,6.9
Catahoula,8/1/1993,5092,4679,413,8.1,129619,120856,8763,6.8
Catahoula,9/1/1993,4998,4593,405,8.1,129268,120554,8714,6.7
Catahoula,10/1/1993,5013,4637,376,7.5,129573,120823,8750,6.8
Catahoula,11/1/1993,5014,4611,403,8,129711,121169,8542,6.6
Catahoula,12/1/1993,5223,4787,436,8.3,129941,121464,8477,6.5
Catahoula,1/1/1994,5492,4811,681,12.4,130596,121966,8630,6.6
Catahoula,2/1/1994,5534,4933,601,10.9,130669,122086,8583,6.6
Catahoula,3/1/1994,5717,5120,597,10.4,130400,121930,8470,6.5
Catahoula,4/1/1994,5817,5262,555,9.5,130621,122290,8331,6.4
Catahoula,5/1/1994,5709,5213,496,8.7,130779,122864,7915,6.1
Catahoula,6/1/1994,5697,5114,583,10.2,130561,122634,7927,6.1
Catahoula,7/1/1994,5650,5113,537,9.5,130652,122706,7946,6.1
Catahoula,8/1/1994,5568,5041,527,9.5,131275,123342,7933,6
Catahoula,9/1/1994,5500,4989,511,9.3,131421,123687,7734,5.9
Catahoula,10/1/1994,5464,5009,455,8.3,131744,124112,7632,5.8
Catahoula,11/1/1994,5511,5087,424,7.7,131891,124516,7375,5.6
Catahoula,12/1/1994,5403,4928,475,8.8,131951,124721,7230,5.5
Catahoula,1/1/1995,5339,4723,616,11.5,132038,124663,7375,5.6
Catahoula,2/1/1995,5288,4762,526,9.9,132115,124928,7187,5.4
Catahoula,3/1/1995,5297,4772,525,9.9,132108,124955,7153,5.4
Catahoula,4/1/1995,5245,4766,479,9.1,132590,124945,7645,5.8
Catahoula,5/1/1995,5226,4770,456,8.7,131851,124421,7430,5.6
Catahoula,6/1/1995,5443,4953,490,9,131949,124522,7427,5.6
Catahoula,7/1/1995,5330,4870,460,8.6,132343,124816,7527,5.7
Catahoula,8/1/1995,5287,4804,483,9.1,132336,124852,7484,5.7
Catahoula,9/1/1995,5220,4713,507,9.7,132611,125133,7478,5.6
Catahoula,10/1/1995,5205,4744,461,8.9,132716,125388,7328,5.5
Catahoula,11/1/1995,5062,4581,481,9.5,132614,125188,7426,5.6
Catahoula,12/1/1995,4972,4487,485,9.8,132511,125088,7423,5.6
Catahoula,1/1/1996,4975,4333,642,12.9,132616,125125,7491,5.6
Catahoula,2/1/1996,4928,4393,535,10.9,132952,125639,7313,5.5
Catahoula,3/1/1996,4939,4451,488,9.9,133180,125862,7318,5.5
Catahoula,4/1/1996,5022,4516,506,10.1,133409,125994,7415,5.6
Catahoula,5/1/1996,4936,4431,505,10.2,133667,126244,7423,5.6
Catahoula,6/1/1996,5067,4484,583,11.5,133697,126602,7095,5.3
Catahoula,7/1/1996,5142,4562,580,11.3,134284,126947,7337,5.5
Catahoula,8/1/1996,4955,4419,536,10.8,134054,127172,6882,5.1
Catahoula,9/1/1996,4977,4477,500,10,134515,127536,6979,5.2
Catahoula,10/1/1996,4838,4382,456,9.4,134921,127890,7031,5.2
Catahoula,11/1/1996,4679,4278,401,8.6,135007,127771,7236,5.4
Catahoula,12/1/1996,4691,4233,458,9.8,135113,127860,7253,5.4
Catahoula,1/1/1997,4858,4199,659,13.6,135456,128298,7158,5.3
Catahoula,2/1/1997,4824,4289,535,11.1,135400,128298,7102,5.2
Catahoula,3/1/1997,4884,4351,533,10.9,135891,128891,7000,5.2
Catahoula,4/1/1997,4867,4446,421,8.7,136016,129143,6873,5.1
Catahoula,5/1/1997,4873,4438,435,8.9,136119,129464,6655,4.9
Catahoula,6/1/1997,5046,4537,509,10.1,136211,129412,6799,5
Catahoula,7/1/1997,5063,4595,468,9.2,136477,129822,6655,4.9
Catahoula,8/1/1997,4960,4566,394,7.9,136618,130010,6608,4.8
Catahoula,9/1/1997,4854,4472,382,7.9,136675,130019,6656,4.9
Catahoula,10/1/1997,4654,4307,347,7.5,136633,130179,6454,4.7
Catahoula,11/1/1997,4554,4202,352,7.7,136961,130653,6308,4.6
Catahoula,12/1/1997,4556,4126,430,9.4,137155,130679,6476,4.7
Catahoula,1/1/1998,4871,4326,545,11.2,137095,130726,6368,4.6
Catahoula,2/1/1998,4741,4294,447,9.4,137112,130807,6306,4.6
Catahoula,3/1/1998,4859,4385,474,9.8,137236,130814,6422,4.7
Catahoula,4/1/1998,4653,4249,404,8.7,137150,131209,5941,4.3
Catahoula,5/1/1998,4733,4292,441,9.3,137372,131325,6047,4.4
Catahoula,6/1/1998,4906,4401,505,10.3,137455,131244,6212,4.5
Catahoula,7/1/1998,5029,4574,455,9,137588,131329,6259,4.5
Catahoula,8/1/1998,4967,4475,492,9.9,137570,131390,6179,4.5
Catahoula,9/1/1998,4842,4439,403,8.3,138286,131986,6300,4.6
Catahoula,10/1/1998,4998,4528,470,9.4,138279,131999,6280,4.5
Catahoula,11/1/1998,4871,4388,483,9.9,138381,132280,6100,4.4
Catahoula,12/1/1998,4829,4331,498,10.3,138634,132602,6032,4.4
Catahoula,1/1/1999,4892,4237,655,13.4,139003,133027,5976,4.3
Catahoula,2/1/1999,4612,4126,486,10.5,138967,132856,6111,4.4
Catahoula,3/1/1999,4691,4190,501,10.7,138730,132947,5783,4.2
Catahoula,4/1/1999,4767,4335,432,9.1,138959,132955,6004,4.3
Catahoula,5/1/1999,4775,4384,391,8.2,139107,133311,5796,4.2
Catahoula,6/1/1999,5050,4503,547,10.8,139329,133378,5951,4.3
Catahoula,7/1/1999,5073,4597,476,9.4,139439,133414,6025,4.3
Catahoula,8/1/1999,4985,4536,449,9,139430,133591,5838,4.2
Catahoula,9/1/1999,4887,4471,416,8.5,139622,133707,5915,4.2
Catahoula,10/1/1999,4800,4434,366,7.6,139771,133993,5778,4.1
Catahoula,11/1/1999,4679,4336,343,7.3,140025,134309,5716,4.1
Catahoula,12/1/1999,4591,4201,390,8.5,140177,134523,5653,4
Catahoula,1/1/2000,4091,3676,415,10.1,142267,136559,5708,4
Catahoula,2/1/2000,4041,3650,391,9.7,142456,136598,5858,4.1
Catahoula,3/1/2000,4078,3717,361,8.9,142434,136701,5733,4
Catahoula,4/1/2000,4191,3869,322,7.7,142751,137270,5481,3.8
Catahoula,5/1/2000,4125,3765,360,8.7,142388,136630,5758,4
Catahoula,6/1/2000,4216,3810,406,9.6,142591,136940,5651,4
Catahoula,7/1/2000,4124,3750,374,9.1,142278,136531,5747,4
Catahoula,8/1/2000,4096,3714,382,9.3,142514,136662,5853,4.1
Catahoula,9/1/2000,4110,3743,367,8.9,142518,136893,5625,3.9
Catahoula,10/1/2000,4131,3795,336,8.1,142622,137088,5534,3.9
Catahoula,11/1/2000,4122,3736,386,9.4,142962,137322,5639,3.9
Catahoula,12/1/2000,4135,3720,415,10,143248,137614,5634,3.9
Catahoula,1/1/2001,4110,3598,512,12.5,143800,137778,6023,4.2
Catahoula,2/1/2001,4083,3664,419,10.3,143701,137612,6089,4.2
Catahoula,3/1/2001,4212,3732,480,11.4,143924,137783,6141,4.3
Catahoula,4/1/2001,4127,3757,370,9,143569,137299,6271,4.4
Catahoula,5/1/2001,4087,3748,339,8.3,143318,137092,6226,4.3
Catahoula,6/1/2001,4170,3797,373,8.9,143357,136873,6484,4.5
Catahoula,7/1/2001,4048,3711,337,8.3,143654,137071,6583,4.6
Catahoula,8/1/2001,3990,3672,318,8,143284,136241,7042,4.9
Catahoula,9/1/2001,4066,3746,320,7.9,143989,136846,7142,5
Catahoula,10/1/2001,4053,3726,327,8.1,144086,136392,7694,5.3
Catahoula,11/1/2001,4026,3685,341,8.5,144240,136238,8003,5.5
Catahoula,12/1/2001,4018,3664,354,8.8,144305,136047,8258,5.7
Catahoula,1/1/2002,4115,3607,508,12.3,143883,135701,8182,5.7
Catahoula,2/1/2002,4005,3581,424,10.6,144653,136438,8215,5.7
Catahoula,3/1/2002,4097,3637,460,11.2,144481,136177,8304,5.7
Catahoula,4/1/2002,4036,3646,390,9.7,144725,136126,8599,5.9
Catahoula,5/1/2002,4046,3679,367,9.1,144938,136539,8399,5.8
Catahoula,6/1/2002,4082,3667,415,10.2,144808,136415,8393,5.8
Catahoula,7/1/2002,4091,3727,364,8.9,144803,136413,8390,5.8
Catahoula,8/1/2002,4117,3774,343,8.3,145009,136705,8304,5.7
Catahoula,9/1/2002,4038,3710,328,8.1,145552,137302,8251,5.7
Catahoula,10/1/2002,4135,3816,319,7.7,145314,137008,8307,5.7
Catahoula,11/1/2002,4069,3732,337,8.3,145041,136521,8520,5.9
Catahoula,12/1/2002,4075,3698,377,9.3,145066,136426,8640,6
Catahoula,1/1/2003,4236,3713,523,12.3,145937,137417,8520,5.8
Catahoula,2/1/2003,4058,3589,469,11.6,146100,137482,8618,5.9
Catahoula,3/1/2003,4119,3638,481,11.7,146022,137434,8588,5.9
Catahoula,4/1/2003,4171,3767,404,9.7,146474,137633,8842,6
Catahoula,5/1/2003,4134,3760,374,9,146500,137544,8957,6.1
Catahoula,6/1/2003,4285,3863,422,9.8,147056,137790,9266,6.3
Catahoula,7/1/2003,4125,3744,381,9.2,146485,137474,9011,6.2
Catahoula,8/1/2003,4134,3759,375,9.1,146445,137549,8896,6.1
Catahoula,9/1/2003,4079,3738,341,8.4,146530,137609,8921,6.1
Catahoula,10/1/2003,4219,3916,303,7.2,146716,137984,8732,6
Catahoula,11/1/2003,4139,3831,308,7.4,147000,138424,8576,5.8
Catahoula,12/1/2003,4010,3673,337,8.4,146729,138411,8317,5.7
Catahoula,1/1/2004,4128,3721,407,9.9,146842,138472,8370,5.7
Catahoula,2/1/2004,4028,3678,350,8.7,146709,138542,8167,5.6
Catahoula,3/1/2004,4015,3665,350,8.7,146944,138453,8491,5.8
Catahoula,4/1/2004,4017,3710,307,7.6,146850,138680,8170,5.6
Catahoula,5/1/2004,4008,3713,295,7.4,147065,138852,8212,5.6
Catahoula,6/1/2004,4070,3713,357,8.8,147460,139174,8286,5.6
Catahoula,7/1/2004,4181,3867,314,7.5,147692,139556,8136,5.5
Catahoula,8/1/2004,4236,3972,264,6.2,147564,139573,7990,5.4
Catahoula,9/1/2004,4147,3886,261,6.3,147415,139487,7927,5.4
Catahoula,10/1/2004,4211,3947,264,6.3,147793,139732,8061,5.5
Catahoula,11/1/2004,4147,3866,281,6.8,148162,140231,7932,5.4
Catahoula,12/1/2004,4012,3708,304,7.6,148059,140125,7934,5.4
Catahoula,1/1/2005,4051,3688,363,9,148029,140245,7784,5.3
Catahoula,2/1/2005,3908,3593,315,8.1,148364,140385,7980,5.4
Catahoula,3/1/2005,3900,3599,301,7.7,148391,140654,7737,5.2
Catahoula,4/1/2005,4091,3821,270,6.6,148926,141254,7672,5.2
Catahoula,5/1/2005,4076,3810,266,6.5,149261,141609,7651,5.1
Catahoula,6/1/2005,4190,3875,315,7.5,149238,141714,7524,5
Catahoula,7/1/2005,4180,3886,294,7,149432,142026,7406,5
Catahoula,8/1/2005,4127,3842,285,6.9,149779,142434,7345,4.9
Catahoula,9/1/2005,4555,4052,503,11,149954,142401,7553,5
Catahoula,10/1/2005,4618,4144,474,10.3,150001,142548,7453,5
Catahoula,11/1/2005,4411,3941,470,10.7,150065,142499,7566,5
Catahoula,12/1/2005,4132,3834,298,7.2,150030,142752,7279,4.9
Catahoula,1/1/2006,4186,3927,259,6.2,150214,143150,7064,4.7
Catahoula,2/1/2006,4157,3938,219,5.3,150641,143457,7184,4.8
Catahoula,3/1/2006,4217,4004,213,5.1,150813,143741,7072,4.7
Catahoula,4/1/2006,4202,3999,203,4.8,150881,143761,7120,4.7
Catahoula,5/1/2006,4177,3964,213,5.1,151069,144089,6980,4.6
Catahoula,6/1/2006,4236,3986,250,5.9,151354,144353,7001,4.6
Catahoula,7/1/2006,4174,3953,221,5.3,151377,144202,7175,4.7
Catahoula,8/1/2006,4171,3951,220,5.3,151716,144625,7091,4.7
Catahoula,9/1/2006,4303,4091,212,4.9,151662,144815,6847,4.5
Catahoula,10/1/2006,4235,4027,208,4.9,152041,145314,6727,4.4
Catahoula,11/1/2006,4218,4006,212,5,152406,145534,6872,4.5
Catahoula,12/1/2006,4095,3869,226,5.5,152732,145970,6762,4.4
Catahoula,1/1/2007,4186,3908,278,6.6,153144,146028,7116,4.6
Catahoula,2/1/2007,4193,3949,244,5.8,152983,146057,6927,4.5
Catahoula,3/1/2007,4179,3951,228,5.5,153051,146320,6731,4.4
Catahoula,4/1/2007,4195,3975,220,5.2,152435,145586,6850,4.5
Catahoula,5/1/2007,4099,3877,222,5.4,152670,145903,6766,4.4
Catahoula,6/1/2007,4144,3885,259,6.3,153041,146063,6979,4.6
Catahoula,7/1/2007,4105,3846,259,6.3,153054,145905,7149,4.7
Catahoula,8/1/2007,4167,3935,232,5.6,152749,145682,7067,4.6
Catahoula,9/1/2007,4267,4047,220,5.2,153414,146244,7170,4.7
Catahoula,10/1/2007,4207,4015,192,4.6,153183,145946,7237,4.7
Catahoula,11/1/2007,4197,4002,195,4.6,153835,146595,7240,4.7
Catahoula,12/1/2007,4155,3916,239,5.8,153918,146273,7645,5
Catahoula,1/1/2008,4227,3954,273,6.5,154063,146378,7685,5
Catahoula,2/1/2008,4213,3975,238,5.6,153653,146156,7497,4.9
Catahoula,3/1/2008,4330,4080,250,5.8,153908,146086,7822,5.1
Catahoula,4/1/2008,4260,4048,212,5,153769,146132,7637,5
Catahoula,5/1/2008,4252,4014,238,5.6,154303,145908,8395,5.4
Catahoula,6/1/2008,4233,3928,305,7.2,154313,145737,8575,5.6
Catahoula,7/1/2008,4198,3880,318,7.6,154469,145532,8937,5.8
Catahoula,8/1/2008,4166,3890,276,6.6,154641,145203,9438,6.1
Catahoula,9/1/2008,4125,3868,257,6.2,154570,145076,9494,6.1
Catahoula,10/1/2008,4221,3950,271,6.4,154876,144802,10074,6.5
Catahoula,11/1/2008,4292,4000,292,6.8,154639,144100,10538,6.8
Catahoula,12/1/2008,4075,3769,306,7.5,154655,143369,11286,7.3
Catahoula,1/1/2009,4152,3745,407,9.8,154210,142152,12058,7.8
Catahoula,2/1/2009,4179,3773,406,9.7,154538,141640,12898,8.3
Catahoula,3/1/2009,4228,3807,421,10,154133,140707,13426,8.7
Catahoula,4/1/2009,4310,3873,437,10.1,154509,140656,13853,9
Catahoula,5/1/2009,4381,3937,444,10.1,154747,140248,14499,9.4
Catahoula,6/1/2009,4462,3941,521,11.7,154716,140009,14707,9.5
Catahoula,7/1/2009,4398,3891,507,11.5,154502,139901,14601,9.5
Catahoula,8/1/2009,4314,3870,444,10.3,154307,139492,14814,9.6
Catahoula,9/1/2009,4231,3831,400,9.5,153827,138818,15009,9.8
Catahoula,10/1/2009,4276,3885,391,9.1,153784,138432,15352,10
Catahoula,11/1/2009,4291,3930,361,8.4,153878,138659,15219,9.9
Catahoula,12/1/2009,4287,3882,405,9.4,153111,138013,15098,9.9
Catahoula,1/1/2010,4026,3599,427,10.6,153484,138438,15046,9.8
Catahoula,2/1/2010,4161,3760,401,9.6,153694,138581,15113,9.8
Catahoula,3/1/2010,4214,3806,408,9.7,153954,138751,15202,9.9
Catahoula,4/1/2010,4239,3869,370,8.7,154622,139297,15325,9.9
Catahoula,5/1/2010,4230,3852,378,8.9,154091,139241,14849,9.6
Catahoula,6/1/2010,4298,3871,427,9.9,153616,139141,14474,9.4
Catahoula,7/1/2010,4308,3862,446,10.4,153691,139179,14512,9.4
Catahoula,8/1/2010,4327,3904,423,9.8,154086,139438,14648,9.5
Catahoula,9/1/2010,4310,3901,409,9.5,153975,139396,14579,9.5
Catahoula,10/1/2010,4267,3866,401,9.4,153635,139119,14516,9.4
Catahoula,11/1/2010,4230,3814,416,9.8,154125,139044,15081,9.8
Catahoula,12/1/2010,4148,3742,406,9.8,153650,139301,14348,9.3
Catahoula,1/1/2011,4071,3618,453,11.1,153263,139250,14013,9.1
Catahoula,2/1/2011,4139,3699,440,10.6,153214,139394,13820,9
Catahoula,3/1/2011,4093,3675,418,10.2,153376,139639,13737,9
Catahoula,4/1/2011,4082,3708,374,9.2,153543,139586,13957,9.1
Catahoula,5/1/2011,4105,3723,382,9.3,153479,139624,13855,9
Catahoula,6/1/2011,4178,3735,443,10.6,153346,139384,13962,9.1
Catahoula,7/1/2011,4277,3838,439,10.3,153288,139524,13763,9
Catahoula,8/1/2011,4158,3769,389,9.4,153760,139942,13818,9
Catahoula,9/1/2011,4071,3696,375,9.2,154131,140183,13948,9
Catahoula,10/1/2011,3923,3565,358,9.1,153961,140368,13594,8.8
Catahoula,11/1/2011,3901,3556,345,8.8,154128,140826,13302,8.6
Catahoula,12/1/2011,3901,3559,342,8.8,153995,140902,13093,8.5
Catahoula,1/1/2012,3874,3487,387,10,154381,141584,12797,8.3
Catahoula,2/1/2012,3889,3531,358,9.2,154671,141858,12813,8.3
Catahoula,3/1/2012,3892,3550,342,8.8,154749,142036,12713,8.2
Catahoula,4/1/2012,3889,3569,320,8.2,154545,141899,12646,8.2
Catahoula,5/1/2012,3931,3611,320,8.1,154866,142206,12660,8.2
Catahoula,6/1/2012,4048,3667,381,9.4,155083,142391,12692,8.2
Catahoula,7/1/2012,4106,3729,377,9.2,154948,142292,12656,8.2
Catahoula,8/1/2012,3979,3650,329,8.3,154763,142291,12471,8.1
Catahoula,9/1/2012,3929,3622,307,7.8,155160,143044,12115,7.8
Catahoula,10/1/2012,3911,3618,293,7.5,155554,143431,12124,7.8
Catahoula,11/1/2012,3876,3603,273,7,155338,143333,12005,7.7
Catahoula,12/1/2012,3904,3590,314,8,155628,143330,12298,7.9
Catahoula,1/1/2013,3891,3529,362,9.3,155763,143292,12471,8
Catahoula,2/1/2013,3880,3530,350,9,155312,143362,11950,7.7
Catahoula,3/1/2013,3870,3524,346,8.9,155005,143316,11689,7.5
Catahoula,4/1/2013,3853,3532,321,8.3,155394,143635,11760,7.6
Catahoula,5/1/2013,3889,3564,325,8.4,155536,143882,11654,7.5
Catahoula,6/1/2013,3984,3613,371,9.3,155749,143999,11751,7.5
Catahoula,7/1/2013,4025,3671,354,8.8,155599,144264,11335,7.3
Catahoula,8/1/2013,3911,3625,286,7.3,155605,144326,11279,7.2
Catahoula,9/1/2013,3935,3645,290,7.4,155687,144418,11270,7.2
Catahoula,10/1/2013,3847,3570,277,7.2,154673,143537,11136,7.2
Catahoula,11/1/2013,3807,3563,244,6.4,155265,144479,10787,6.9
Catahoula,12/1/2013,3867,3625,242,6.3,155182,144778,10404,6.7
Catahoula,1/1/2014,3749,3477,272,7.3,155352,145150,10202,6.6
Catahoula,2/1/2014,3773,3510,263,7,155483,145134,10349,6.7
Catahoula,3/1/2014,3744,3470,274,7.3,156028,145648,10380,6.7
Catahoula,4/1/2014,3756,3510,246,6.5,155369,145667,9702,6.2
Catahoula,5/1/2014,3758,3475,283,7.5,155684,145825,9859,6.3
Catahoula,6/1/2014,3902,3561,341,8.7,155707,146247,9460,6.1
Catahoula,7/1/2014,3894,3554,340,8.7,156007,146399,9608,6.2
Catahoula,8/1/2014,3862,3535,327,8.5,156130,146530,9599,6.1
Catahoula,9/1/2014,3940,3617,323,8.2,156040,146778,9262,5.9
Catahoula,10/1/2014,3869,3561,308,8,156417,147427,8990,5.7
Catahoula,11/1/2014,3786,3465,321,8.5,156494,147404,9090,5.8
Catahoula,12/1/2014,3830,3504,326,8.5,156332,147615,8717,5.6
Catahoula,1/1/2015,3654,3300,354,9.7,157030,148145,8885,5.7
Catahoula,2/1/2015,3669,3325,344,9.4,156644,148045,8599,5.5
Catahoula,3/1/2015,3640,3253,387,10.6,156643,148128,8515,5.4
Catahoula,4/1/2015,3562,3191,371,10.4,157060,148511,8550,5.4
Catahoula,5/1/2015,3687,3309,378,10.3,157651,148817,8834,5.6
Catahoula,6/1/2015,3744,3344,400,10.7,157062,148816,8247,5.3
Catahoula,7/1/2015,3729,3338,391,10.5,156997,148830,8167,5.2
Catahoula,8/1/2015,3624,3303,321,8.9,157172,149181,7992,5.1
Catahoula,9/1/2015,3528,3224,304,8.6,156733,148826,7907,5
Catahoula,10/1/2015,3430,3133,297,8.7,157167,149246,7922,5
Catahoula,11/1/2015,3413,3138,275,8.1,157463,149463,8000,5.1
Catahoula,12/1/2015,3453,3169,284,8.2,158035,150128,7907,5
Catahoula,1/1/2016,3396,3053,343,10.1,158280,150653,7627,4.8
Catahoula,2/1/2016,3381,3039,342,10.1,158640,150939,7702,4.9
Catahoula,3/1/2016,3370,3031,339,10.1,159179,151218,7961,5
Catahoula,4/1/2016,3453,3129,324,9.4,159141,151074,8067,5.1
Catahoula,5/1/2016,3539,3205,334,9.4,158784,151132,7652,4.8
Catahoula,6/1/2016,3605,3242,363,10.1,158967,151223,7744,4.9
Catahoula,7/1/2016,3574,3219,355,9.9,159194,151554,7641,4.8
Catahoula,8/1/2016,3495,3182,313,9,159562,151779,7784,4.9
Catahoula,9/1/2016,3395,3088,307,9,159714,151761,7953,5
Catahoula,10/1/2016,3271,3001,270,8.3,159605,151793,7811,4.9
Catahoula,11/1/2016,3303,3053,250,7.6,159506,151954,7553,4.7
Catahoula,12/1/2016,3280,3020,260,7.9,159678,152157,7521,4.7
Catahoula,1/1/2017,3347,3066,281,8.4,159620,152152,7468,4.7
Catahoula,2/1/2017,3373,3111,262,7.8,159859,152480,7379,4.6
Catahoula,3/1/2017,3427,3171,256,7.5,160137,153065,7073,4.4
Catahoula,4/1/2017,3483,3240,243,7,160345,153255,7089,4.4
Catahoula,5/1/2017,3548,3317,231,6.5,160068,153069,7000,4.4
Catahoula,6/1/2017,3671,3400,271,7.4,160192,153318,6873,4.3
Catahoula,7/1/2017,3599,3327,272,7.6,160462,153569,6892,4.3
Catahoula,8/1/2017,3452,3198,254,7.4,160586,153503,7082,4.4
Catahoula,9/1/2017,3306,3078,228,6.9,161140,154286,6854,4.3
Catahoula,10/1/2017,3314,3114,200,6,160309,153609,6700,4.2
Catahoula,11/1/2017,3317,3126,191,5.8,160579,153805,6774,4.2
Catahoula,12/1/2017,3327,3116,211,6.3,160535,153904,6632,4.1
Catahoula,1/1/2018,3335,3100,235,7,160914,154425,6489,4
Catahoula,2/1/2018,3320,3088,232,7,161778,155197,6581,4.1
Catahoula,3/1/2018,3334,3116,218,6.5,161686,155214,6472,4
Catahoula,4/1/2018,3340,3124,216,6.5,161771,155312,6459,4
Catahoula,5/1/2018,3432,3219,213,6.2,161848,155652,6196,3.8
Catahoula,6/1/2018,3535,3251,284,8,162210,155762,6447,4
Catahoula,7/1/2018,3543,3281,262,7.4,162341,156146,6195,3.8
Catahoula,8/1/2018,3415,3185,230,6.7,161660,155504,6156,3.8
Catahoula,9/1/2018,3280,3069,211,6.4,162087,156015,6073,3.7
Catahoula,10/1/2018,3299,3097,202,6.1,162602,156391,6211,3.8
Catahoula,11/1/2018,3239,3053,186,5.7,162836,156721,6115,3.8
Catahoula,12/1/2018,3199,2997,202,6.3,163206,156817,6389,3.9
Catahoula,1/1/2019,3252,3017,235,7.2,162963,156487,6475,4
Catahoula,2/1/2019,3268,3059,209,6.4,162999,156863,6136,3.8
Catahoula,3/1/2019,3250,3069,181,5.6,162904,156701,6202,3.8
Catahoula,4/1/2019,3252,3068,184,5.7,162586,156625,5961,3.7
Catahoula,5/1/2019,3301,3116,185,5.6,162751,156821,5930,3.6
Catahoula,6/1/2019,3405,3166,239,7,163168,157232,5935,3.6
Catahoula,7/1/2019,3470,3220,250,7.2,163590,157529,6061,3.7
Catahoula,8/1/2019,3569,3345,224,6.3,163774,157829,5945,3.6
Catahoula,9/1/2019,3558,3354,204,5.7,164092,158339,5753,3.5
Catahoula,10/1/2019,3487,3286,201,5.8,164416,158545,5871,3.6
Catahoula,11/1/2019,3392,3195,197,5.8,164496,158629,5868,3.6
Catahoula,12/1/2019,3382,3187,195,5.8,164699,158845,5853,3.6
Catahoula,1/1/2020,3364,3164,200,5.9,164377,158508,5869,3.6
Catahoula,2/1/2020,3320,3156,164,4.9,164467,158714,5753,3.5
Catahoula,3/1/2020,3413,3145,268,7.9,162559,155353,7206,4.4
Catahoula,4/1/2020,3232,2956,276,8.5,156269,133185,23084,14.8
Catahoula,5/1/2020,3278,3001,277,8.5,158101,137173,20929,13.2
Catahoula,6/1/2020,3451,3128,323,9.4,159994,142342,17652,11
Catahoula,7/1/2020,3484,3166,318,9.1,160132,143779,16352,10.2
Catahoula,8/1/2020,3520,3243,277,7.9,160706,147245,13461,8.4
Catahoula,9/1/2020,3566,3276,290,8.1,160174,147620,12554,7.8
Catahoula,10/1/2020,3554,3309,245,6.9,161003,149931,11072,6.9
Catahoula,11/1/2020,3455,3237,218,6.3,160629,149934,10694,6.7
Catahoula,12/1/2020,3459,3225,234,6.8,160745,149975,10770,6.7
Catahoula,1/1/2021,3432,3184,248,7.2,160088,149852,10236,6.4
Catahoula,2/1/2021,3386,3161,225,6.6,160184,150189,9995,6.2
Catahoula,3/1/2021,3439,3225,214,6.2,160400,150644,9756,6.1
Catahoula,4/1/2021,3478,3275,203,5.8,160843,151081,9762,6.1
Catahoula,5/1/2021,3467,3273,194,5.6,160800,151535,9266,5.8
Catahoula,6/1/2021,3540,3316,224,6.3,161197,151734,9462,5.9
Catahoula,7/1/2021,3497,3294,203,5.8,161504,152773,8731,5.4
Catahoula,8/1/2021,3481,3306,175,5,161527,153250,8276,5.1
Catahoula,9/1/2021,3547,3392,155,4.4,161495,153843,7652,4.7
Catahoula,10/1/2021,3455,3313,142,4.1,161754,154475,7279,4.5
Catahoula,11/1/2021,3337,3214,123,3.7,162281,155530,6751,4.2
Catahoula,12/1/2021,3356,3244,112,3.3,162497,156099,6398,3.9
Catahoula,1/1/2022,3429,3283,146,4.3,163627,157115,6512,4
Catahoula,2/1/2022,3421,3287,134,3.9,163899,157598,6301,3.8
Catahoula,3/1/2022,3455,3326,129,3.7,164220,158206,6014,3.7
Catahoula,4/1/2022,3504,3382,122,3.5,163893,157891,6002,3.7
Catahoula,5/1/2022,3511,3367,144,4.1,164362,158378,5983,3.6
Catahoula,6/1/2022,3509,3334,175,5,164046,158094,5951,3.6
Catahoula,7/1/2022,3474,3308,166,4.8,164026,158258,5768,3.5
Catahoula,8/1/2022,3448,3301,147,4.3,164654,158735,5919,3.6
Catahoula,9/1/2022,3463,3322,141,4.1,164602,158810,5792,3.5
Catahoula,10/1/2022,3419,3294,125,3.7,164648,158684,5964,3.6
Catahoula,11/1/2022,3392,3266,126,3.7,164450,158507,5943,3.6
Catahoula,12/1/2022,3445,3309,136,3.9,165025,159259,5766,3.5
Catahoula,1/1/2023,3496,3325,171,4.9,165964,160217,5747,3.5
Catahoula,2/1/2023,3494,3341,153,4.4,166358,160395,5962,3.6
Catahoula,3/1/2023,3482,3348,134,3.8,166651,160812,5839,3.5
Catahoula,4/1/2023,3542,3416,126,3.6,166725,160974,5751,3.4
Catahoula,5/1/2023,3547,3400,147,4.1,166886,160796,6089,3.6
Catahoula,6/1/2023,3660,3472,188,5.1,166937,160979,5958,3.6
Catahoula,7/1/2023,3633,3467,166,4.6,167103,161183,5920,3.5
Catahoula,8/1/2023,3618,3460,158,4.4,167759,161475,6284,3.7
Catahoula,9/1/2023,3681,3515,166,4.5,167767,161442,6326,3.8
Catahoula,10/1/2023,3625,3472,153,4.2,167690,161211,6479,3.9
Catahoula,11/1/2023,3629,3477,152,4.2,168140,161886,6254,3.7
Catahoula,12/1/2023,3627,3480,147,4.1,167439,161124,6315,3.8
Catahoula,1/1/2024,3646,3468,178,4.9,167339,161190,6149,3.7
Catahoula,2/1/2024,3582,3401,181,5.1,167475,161013,6462,3.9
Catahoula,3/1/2024,3584,3407,177,4.9,167922,161425,6497,3.9
Catahoula,4/1/2024,3589,3433,156,4.3,167988,161495,6492,3.9
Catahoula,5/1/2024,3607,3427,180,5,167799,161164,6635,4
Catahoula,6/1/2024,3738,3507,231,6.2,168005,161155,6849,4.1
Catahoula,7/1/2024,3765,3532,233,6.2,168315,161219,7097,4.2
Catahoula,8/1/2024,3732,3525,207,5.5,168496,161425,7071,4.2
Catahoula,9/1/2024,3747,3558,189,5,168703,161802,6901,4.1
Catahoula,10/1/2024,3682,3493,189,5.1,168428,161456,6972,4.1
Catahoula,11/1/2024,3625,3445,180,5,168304,161183,7121,4.2
Catahoula,12/1/2024,3648,3464,184,5,168547,161661,6886,4.1
Catahoula,1/1/2025,3367,3169,198,5.9,170744,163895,6849,4
Catahoula,2/1/2025,3307,3121,186,5.6,170359,163307,7052,4.1
Claiborne,1/1/1990,6077,5684,393,6.5,125833,119081,6752,5.4
Claiborne,2/1/1990,6013,5665,348,5.8,125710,119059,6651,5.3
Claiborne,3/1/1990,6107,5777,330,5.4,125801,119203,6598,5.2
Claiborne,4/1/1990,6015,5681,334,5.6,125649,118852,6797,5.4
Claiborne,5/1/1990,6031,5687,344,5.7,125893,119151,6742,5.4
Claiborne,6/1/1990,6120,5721,399,6.5,125573,118983,6590,5.2
Claiborne,7/1/1990,6260,5816,444,7.1,125732,118810,6922,5.5
Claiborne,8/1/1990,6136,5717,419,6.8,125990,118802,7188,5.7
Claiborne,9/1/1990,6046,5674,372,6.2,125892,118524,7368,5.9
Claiborne,10/1/1990,6091,5751,340,5.6,125995,118536,7459,5.9
Claiborne,11/1/1990,6075,5762,313,5.2,126070,118306,7764,6.2
Claiborne,12/1/1990,6090,5761,329,5.4,126142,118241,7901,6.3
Claiborne,1/1/1991,6000,5550,450,7.5,125955,117940,8015,6.4
Claiborne,2/1/1991,5933,5508,425,7.2,126020,117755,8265,6.6
Claiborne,3/1/1991,6038,5636,402,6.7,126238,117652,8586,6.8
Claiborne,4/1/1991,6270,5874,396,6.3,126548,118109,8439,6.7
Claiborne,5/1/1991,6113,5637,476,7.8,126176,117440,8736,6.9
Claiborne,6/1/1991,6175,5640,535,8.7,126331,117639,8692,6.9
Claiborne,7/1/1991,6190,5707,483,7.8,126154,117568,8586,6.8
Claiborne,8/1/1991,6077,5591,486,8,126150,117484,8666,6.9
Claiborne,9/1/1991,6059,5615,444,7.3,126650,117928,8722,6.9
Claiborne,10/1/1991,6053,5572,481,7.9,126642,117800,8842,7
Claiborne,11/1/1991,6032,5579,453,7.5,126701,117770,8931,7
Claiborne,12/1/1991,6007,5521,486,8.1,126664,117466,9198,7.3
Claiborne,1/1/1992,6287,5624,663,10.5,127261,117978,9283,7.3
Claiborne,2/1/1992,6355,5787,568,8.9,127207,117753,9454,7.4
Claiborne,3/1/1992,6392,5827,565,8.8,127604,118144,9460,7.4
Claiborne,4/1/1992,6004,5481,523,8.7,127841,118426,9415,7.4
Claiborne,5/1/1992,5984,5449,535,8.9,128119,118375,9744,7.6
Claiborne,6/1/1992,6202,5581,621,10,128459,118419,10040,7.8
Claiborne,7/1/1992,6301,5751,550,8.7,128563,118713,9850,7.7
Claiborne,8/1/1992,6172,5625,547,8.9,128613,118826,9787,7.6
Claiborne,9/1/1992,5999,5560,439,7.3,128501,118720,9781,7.6
Claiborne,10/1/1992,5916,5489,427,7.2,128026,118628,9398,7.3
Claiborne,11/1/1992,5919,5516,403,6.8,128441,118876,9565,7.4
Claiborne,12/1/1992,5639,5277,362,6.4,128554,118997,9557,7.4
Claiborne,1/1/1993,5660,5250,410,7.2,128400,119075,9325,7.3
Claiborne,2/1/1993,5601,5248,353,6.3,128458,119275,9183,7.1
Claiborne,3/1/1993,5670,5312,358,6.3,128598,119542,9056,7
Claiborne,4/1/1993,5594,5269,325,5.8,128584,119474,9110,7.1
Claiborne,5/1/1993,5623,5288,335,6,129264,120115,9149,7.1
Claiborne,6/1/1993,5787,5348,439,7.6,129411,120290,9121,7
Claiborne,7/1/1993,5842,5476,366,6.3,129397,120467,8930,6.9
Claiborne,8/1/1993,5891,5541,350,5.9,129619,120856,8763,6.8
Claiborne,9/1/1993,5741,5416,325,5.7,129268,120554,8714,6.7
Claiborne,10/1/1993,5786,5442,344,5.9,129573,120823,8750,6.8
Claiborne,11/1/1993,5804,5453,351,6,129711,121169,8542,6.6
Claiborne,12/1/1993,5762,5410,352,6.1,129941,121464,8477,6.5
Claiborne,1/1/1994,5896,5422,474,8,130596,121966,8630,6.6
Claiborne,2/1/1994,5857,5445,412,7,130669,122086,8583,6.6
Claiborne,3/1/1994,5926,5487,439,7.4,130400,121930,8470,6.5
Claiborne,4/1/1994,5938,5411,527,8.9,130621,122290,8331,6.4
Claiborne,5/1/1994,5917,5428,489,8.3,130779,122864,7915,6.1
Claiborne,6/1/1994,6012,5476,536,8.9,130561,122634,7927,6.1
Claiborne,7/1/1994,6185,5565,620,10,130652,122706,7946,6.1
Claiborne,8/1/1994,6186,5563,623,10.1,131275,123342,7933,6
Claiborne,9/1/1994,6040,5458,582,9.6,131421,123687,7734,5.9
Claiborne,10/1/1994,5952,5451,501,8.4,131744,124112,7632,5.8
Claiborne,11/1/1994,5990,5512,478,8,131891,124516,7375,5.6
Claiborne,12/1/1994,5908,5487,421,7.1,131951,124721,7230,5.5
Claiborne,1/1/1995,5907,5464,443,7.5,132038,124663,7375,5.6
Claiborne,2/1/1995,5786,5396,390,6.7,132115,124928,7187,5.4
Claiborne,3/1/1995,5866,5432,434,7.4,132108,124955,7153,5.4
Claiborne,4/1/1995,5800,5366,434,7.5,132590,124945,7645,5.8
Claiborne,5/1/1995,5752,5309,443,7.7,131851,124421,7430,5.6
Claiborne,6/1/1995,5887,5364,523,8.9,131949,124522,7427,5.6
Claiborne,7/1/1995,5973,5481,492,8.2,132343,124816,7527,5.7
Claiborne,8/1/1995,5827,5390,437,7.5,132336,124852,7484,5.7
Claiborne,9/1/1995,5751,5305,446,7.8,132611,125133,7478,5.6
Claiborne,10/1/1995,5863,5377,486,8.3,132716,125388,7328,5.5
Claiborne,11/1/1995,5829,5374,455,7.8,132614,125188,7426,5.6
Claiborne,12/1/1995,5747,5321,426,7.4,132511,125088,7423,5.6
Claiborne,1/1/1996,5835,5222,613,10.5,132616,125125,7491,5.6
Claiborne,2/1/1996,5786,5237,549,9.5,132952,125639,7313,5.5
Claiborne,3/1/1996,5797,5300,497,8.6,133180,125862,7318,5.5
Claiborne,4/1/1996,5816,5327,489,8.4,133409,125994,7415,5.6
Claiborne,5/1/1996,5831,5337,494,8.5,133667,126244,7423,5.6
Claiborne,6/1/1996,6087,5493,594,9.8,133697,126602,7095,5.3
Claiborne,7/1/1996,6207,5659,548,8.8,134284,126947,7337,5.5
Claiborne,8/1/1996,6064,5542,522,8.6,134054,127172,6882,5.1
Claiborne,9/1/1996,6025,5462,563,9.3,134515,127536,6979,5.2
Claiborne,10/1/1996,5952,5437,515,8.7,134921,127890,7031,5.2
Claiborne,11/1/1996,5945,5420,525,8.8,135007,127771,7236,5.4
Claiborne,12/1/1996,5923,5424,499,8.4,135113,127860,7253,5.4
Claiborne,1/1/1997,6158,5532,626,10.2,135456,128298,7158,5.3
Claiborne,2/1/1997,6087,5517,570,9.4,135400,128298,7102,5.2
Claiborne,3/1/1997,6237,5586,651,10.4,135891,128891,7000,5.2
Claiborne,4/1/1997,6150,5567,583,9.5,136016,129143,6873,5.1
Claiborne,5/1/1997,6084,5517,567,9.3,136119,129464,6655,4.9
Claiborne,6/1/1997,6300,5588,712,11.3,136211,129412,6799,5
Claiborne,7/1/1997,6453,5784,669,10.4,136477,129822,6655,4.9
Claiborne,8/1/1997,6232,5724,508,8.2,136618,130010,6608,4.8
Claiborne,9/1/1997,6133,5657,476,7.8,136675,130019,6656,4.9
Claiborne,10/1/1997,5908,5478,430,7.3,136633,130179,6454,4.7
Claiborne,11/1/1997,5825,5439,386,6.6,136961,130653,6308,4.6
Claiborne,12/1/1997,5840,5453,387,6.6,137155,130679,6476,4.7
Claiborne,1/1/1998,5857,5407,450,7.7,137095,130726,6368,4.6
Claiborne,2/1/1998,5780,5404,376,6.5,137112,130807,6306,4.6
Claiborne,3/1/1998,5812,5387,425,7.3,137236,130814,6422,4.7
Claiborne,4/1/1998,5819,5426,393,6.8,137150,131209,5941,4.3
Claiborne,5/1/1998,5825,5401,424,7.3,137372,131325,6047,4.4
Claiborne,6/1/1998,5998,5466,532,8.9,137455,131244,6212,4.5
Claiborne,7/1/1998,6107,5597,510,8.4,137588,131329,6259,4.5
Claiborne,8/1/1998,6017,5529,488,8.1,137570,131390,6179,4.5
Claiborne,9/1/1998,5874,5394,480,8.2,138286,131986,6300,4.6
Claiborne,10/1/1998,5988,5492,496,8.3,138279,131999,6280,4.5
Claiborne,11/1/1998,5930,5477,453,7.6,138381,132280,6100,4.4
Claiborne,12/1/1998,5895,5471,424,7.2,138634,132602,6032,4.4
Claiborne,1/1/1999,5798,5339,459,7.9,139003,133027,5976,4.3
Claiborne,2/1/1999,5681,5317,364,6.4,138967,132856,6111,4.4
Claiborne,3/1/1999,5681,5313,368,6.5,138730,132947,5783,4.2
Claiborne,4/1/1999,5655,5254,401,7.1,138959,132955,6004,4.3
Claiborne,5/1/1999,5537,5154,383,6.9,139107,133311,5796,4.2
Claiborne,6/1/1999,5718,5168,550,9.6,139329,133378,5951,4.3
Claiborne,7/1/1999,5817,5303,514,8.8,139439,133414,6025,4.3
Claiborne,8/1/1999,5712,5282,430,7.5,139430,133591,5838,4.2
Claiborne,9/1/1999,5662,5254,408,7.2,139622,133707,5915,4.2
Claiborne,10/1/1999,5575,5163,412,7.4,139771,133993,5778,4.1
Claiborne,11/1/1999,5499,5137,362,6.6,140025,134309,5716,4.1
Claiborne,12/1/1999,5386,5049,337,6.3,140177,134523,5653,4
Claiborne,1/1/2000,6276,5895,381,6.1,142267,136559,5708,4
Claiborne,2/1/2000,6219,5857,362,5.8,142456,136598,5858,4.1
Claiborne,3/1/2000,6296,5913,383,6.1,142434,136701,5733,4
Claiborne,4/1/2000,6266,5945,321,5.1,142751,137270,5481,3.8
Claiborne,5/1/2000,6284,5907,377,6,142388,136630,5758,4
Claiborne,6/1/2000,6530,6063,467,7.2,142591,136940,5651,4
Claiborne,7/1/2000,6802,6383,419,6.2,142278,136531,5747,4
Claiborne,8/1/2000,6775,6341,434,6.4,142514,136662,5853,4.1
Claiborne,9/1/2000,6624,6191,433,6.5,142518,136893,5625,3.9
Claiborne,10/1/2000,6505,6078,427,6.6,142622,137088,5534,3.9
Claiborne,11/1/2000,6469,6060,409,6.3,142962,137322,5639,3.9
Claiborne,12/1/2000,6454,6048,406,6.3,143248,137614,5634,3.9
Claiborne,1/1/2001,6683,6211,472,7.1,143800,137778,6023,4.2
Claiborne,2/1/2001,6723,6221,502,7.5,143701,137612,6089,4.2
Claiborne,3/1/2001,6803,6276,527,7.7,143924,137783,6141,4.3
Claiborne,4/1/2001,6597,6170,427,6.5,143569,137299,6271,4.4
Claiborne,5/1/2001,6529,6100,429,6.6,143318,137092,6226,4.3
Claiborne,6/1/2001,6744,6241,503,7.5,143357,136873,6484,4.5
Claiborne,7/1/2001,6925,6470,455,6.6,143654,137071,6583,4.6
Claiborne,8/1/2001,6881,6448,433,6.3,143284,136241,7042,4.9
Claiborne,9/1/2001,6759,6357,402,5.9,143989,136846,7142,5
Claiborne,10/1/2001,6782,6373,409,6,144086,136392,7694,5.3
Claiborne,11/1/2001,6781,6328,453,6.7,144240,136238,8003,5.5
Claiborne,12/1/2001,6721,6272,449,6.7,144305,136047,8258,5.7
Claiborne,1/1/2002,6673,6158,515,7.7,143883,135701,8182,5.7
Claiborne,2/1/2002,6675,6234,441,6.6,144653,136438,8215,5.7
Claiborne,3/1/2002,6689,6232,457,6.8,144481,136177,8304,5.7
Claiborne,4/1/2002,6698,6244,454,6.8,144725,136126,8599,5.9
Claiborne,5/1/2002,6675,6245,430,6.4,144938,136539,8399,5.8
Claiborne,6/1/2002,6734,6232,502,7.5,144808,136415,8393,5.8
Claiborne,7/1/2002,6853,6402,451,6.6,144803,136413,8390,5.8
Claiborne,8/1/2002,6807,6321,486,7.1,145009,136705,8304,5.7
Claiborne,9/1/2002,6784,6314,470,6.9,145552,137302,8251,5.7
Claiborne,10/1/2002,6921,6479,442,6.4,145314,137008,8307,5.7
Claiborne,11/1/2002,6848,6410,438,6.4,145041,136521,8520,5.9
Claiborne,12/1/2002,6892,6408,484,7,145066,136426,8640,6
Claiborne,1/1/2003,6750,6220,530,7.9,145937,137417,8520,5.8
Claiborne,2/1/2003,6713,6234,479,7.1,146100,137482,8618,5.9
Claiborne,3/1/2003,6785,6280,505,7.4,146022,137434,8588,5.9
Claiborne,4/1/2003,6743,6253,490,7.3,146474,137633,8842,6
Claiborne,5/1/2003,6770,6263,507,7.5,146500,137544,8957,6.1
Claiborne,6/1/2003,6915,6294,621,9,147056,137790,9266,6.3
Claiborne,7/1/2003,6900,6347,553,8,146485,137474,9011,6.2
Claiborne,8/1/2003,6934,6417,517,7.5,146445,137549,8896,6.1
Claiborne,9/1/2003,6809,6302,507,7.4,146530,137609,8921,6.1
Claiborne,10/1/2003,6881,6417,464,6.7,146716,137984,8732,6
Claiborne,11/1/2003,6887,6457,430,6.2,147000,138424,8576,5.8
Claiborne,12/1/2003,6822,6392,430,6.3,146729,138411,8317,5.7
Claiborne,1/1/2004,6812,6313,499,7.3,146842,138472,8370,5.7
Claiborne,2/1/2004,6749,6304,445,6.6,146709,138542,8167,5.6
Claiborne,3/1/2004,6762,6286,476,7,146944,138453,8491,5.8
Claiborne,4/1/2004,6759,6321,438,6.5,146850,138680,8170,5.6
Claiborne,5/1/2004,6771,6321,450,6.6,147065,138852,8212,5.6
Claiborne,6/1/2004,6919,6383,536,7.7,147460,139174,8286,5.6
Claiborne,7/1/2004,7036,6563,473,6.7,147692,139556,8136,5.5
Claiborne,8/1/2004,7033,6611,422,6,147564,139573,7990,5.4
Claiborne,9/1/2004,6904,6503,401,5.8,147415,139487,7927,5.4
Claiborne,10/1/2004,7021,6608,413,5.9,147793,139732,8061,5.5
Claiborne,11/1/2004,7058,6653,405,5.7,148162,140231,7932,5.4
Claiborne,12/1/2004,6967,6579,388,5.6,148059,140125,7934,5.4
Claiborne,1/1/2005,6741,6300,441,6.5,148029,140245,7784,5.3
Claiborne,2/1/2005,6725,6308,417,6.2,148364,140385,7980,5.4
Claiborne,3/1/2005,6683,6284,399,6,148391,140654,7737,5.2
Claiborne,4/1/2005,6746,6358,388,5.8,148926,141254,7672,5.2
Claiborne,5/1/2005,6779,6373,406,6,149261,141609,7651,5.1
Claiborne,6/1/2005,6841,6369,472,6.9,149238,141714,7524,5
Claiborne,7/1/2005,6938,6501,437,6.3,149432,142026,7406,5
Claiborne,8/1/2005,6878,6475,403,5.9,149779,142434,7345,4.9
Claiborne,9/1/2005,7374,6836,538,7.3,149954,142401,7553,5
Claiborne,10/1/2005,7509,7021,488,6.5,150001,142548,7453,5
Claiborne,11/1/2005,7399,6889,510,6.9,150065,142499,7566,5
Claiborne,12/1/2005,7129,6785,344,4.8,150030,142752,7279,4.9
Claiborne,1/1/2006,6857,6557,300,4.4,150214,143150,7064,4.7
Claiborne,2/1/2006,6835,6586,249,3.6,150641,143457,7184,4.8
Claiborne,3/1/2006,6815,6555,260,3.8,150813,143741,7072,4.7
Claiborne,4/1/2006,6907,6644,263,3.8,150881,143761,7120,4.7
Claiborne,5/1/2006,6839,6532,307,4.5,151069,144089,6980,4.6
Claiborne,6/1/2006,6958,6588,370,5.3,151354,144353,7001,4.6
Claiborne,7/1/2006,7231,6902,329,4.5,151377,144202,7175,4.7
Claiborne,8/1/2006,7115,6781,334,4.7,151716,144625,7091,4.7
Claiborne,9/1/2006,7124,6786,338,4.7,151662,144815,6847,4.5
Claiborne,10/1/2006,7013,6685,328,4.7,152041,145314,6727,4.4
Claiborne,11/1/2006,6951,6625,326,4.7,152406,145534,6872,4.5
Claiborne,12/1/2006,6913,6600,313,4.5,152732,145970,6762,4.4
Claiborne,1/1/2007,6838,6445,393,5.7,153144,146028,7116,4.6
Claiborne,2/1/2007,6814,6465,349,5.1,152983,146057,6927,4.5
Claiborne,3/1/2007,6859,6514,345,5,153051,146320,6731,4.4
Claiborne,4/1/2007,6772,6419,353,5.2,152435,145586,6850,4.5
Claiborne,5/1/2007,6719,6339,380,5.7,152670,145903,6766,4.4
Claiborne,6/1/2007,6693,6262,431,6.4,153041,146063,6979,4.6
Claiborne,7/1/2007,6706,6303,403,6,153054,145905,7149,4.7
Claiborne,8/1/2007,6683,6330,353,5.3,152749,145682,7067,4.6
Claiborne,9/1/2007,6745,6400,345,5.1,153414,146244,7170,4.7
Claiborne,10/1/2007,6660,6349,311,4.7,153183,145946,7237,4.7
Claiborne,11/1/2007,6649,6349,300,4.5,153835,146595,7240,4.7
Claiborne,12/1/2007,6627,6314,313,4.7,153918,146273,7645,5
Claiborne,1/1/2008,6564,6218,346,5.3,154063,146378,7685,5
Claiborne,2/1/2008,6513,6181,332,5.1,153653,146156,7497,4.9
Claiborne,3/1/2008,6648,6279,369,5.6,153908,146086,7822,5.1
Claiborne,4/1/2008,6534,6223,311,4.8,153769,146132,7637,5
Claiborne,5/1/2008,6525,6186,339,5.2,154303,145908,8395,5.4
Claiborne,6/1/2008,6543,6126,417,6.4,154313,145737,8575,5.6
Claiborne,7/1/2008,6568,6167,401,6.1,154469,145532,8937,5.8
Claiborne,8/1/2008,6612,6215,397,6,154641,145203,9438,6.1
Claiborne,9/1/2008,6662,6298,364,5.5,154570,145076,9494,6.1
Claiborne,10/1/2008,6722,6284,438,6.5,154876,144802,10074,6.5
Claiborne,11/1/2008,6799,6291,508,7.5,154639,144100,10538,6.8
Claiborne,12/1/2008,6627,6150,477,7.2,154655,143369,11286,7.3
Claiborne,1/1/2009,6698,6180,518,7.7,154210,142152,12058,7.8
Claiborne,2/1/2009,6717,6126,591,8.8,154538,141640,12898,8.3
Claiborne,3/1/2009,6685,6123,562,8.4,154133,140707,13426,8.7
Claiborne,4/1/2009,6735,6149,586,8.7,154509,140656,13853,9
Claiborne,5/1/2009,6809,6165,644,9.5,154747,140248,14499,9.4
Claiborne,6/1/2009,6910,6193,717,10.4,154716,140009,14707,9.5
Claiborne,7/1/2009,6884,6159,725,10.5,154502,139901,14601,9.5
Claiborne,8/1/2009,6666,6005,661,9.9,154307,139492,14814,9.6
Claiborne,9/1/2009,6570,5947,623,9.5,153827,138818,15009,9.8
Claiborne,10/1/2009,6579,5960,619,9.4,153784,138432,15352,10
Claiborne,11/1/2009,6518,5960,558,8.6,153878,138659,15219,9.9
Claiborne,12/1/2009,6506,5933,573,8.8,153111,138013,15098,9.9
Claiborne,1/1/2010,6779,6204,575,8.5,153484,138438,15046,9.8
Claiborne,2/1/2010,6778,6242,536,7.9,153694,138581,15113,9.8
Claiborne,3/1/2010,6795,6268,527,7.8,153954,138751,15202,9.9
Claiborne,4/1/2010,6948,6418,530,7.6,154622,139297,15325,9.9
Claiborne,5/1/2010,6958,6400,558,8,154091,139241,14849,9.6
Claiborne,6/1/2010,7002,6382,620,8.9,153616,139141,14474,9.4
Claiborne,7/1/2010,7038,6430,608,8.6,153691,139179,14512,9.4
Claiborne,8/1/2010,6988,6385,603,8.6,154086,139438,14648,9.5
Claiborne,9/1/2010,6912,6319,593,8.6,153975,139396,14579,9.5
Claiborne,10/1/2010,6926,6357,569,8.2,153635,139119,14516,9.4
Claiborne,11/1/2010,6853,6302,551,8,154125,139044,15081,9.8
Claiborne,12/1/2010,6870,6335,535,7.8,153650,139301,14348,9.3
Claiborne,1/1/2011,7010,6417,593,8.5,153263,139250,14013,9.1
Claiborne,2/1/2011,6890,6346,544,7.9,153214,139394,13820,9
Claiborne,3/1/2011,6924,6381,543,7.8,153376,139639,13737,9
Claiborne,4/1/2011,6909,6401,508,7.4,153543,139586,13957,9.1
Claiborne,5/1/2011,6885,6351,534,7.8,153479,139624,13855,9
Claiborne,6/1/2011,6924,6311,613,8.9,153346,139384,13962,9.1
Claiborne,7/1/2011,6923,6361,562,8.1,153288,139524,13763,9
Claiborne,8/1/2011,6916,6353,563,8.1,153760,139942,13818,9
Claiborne,9/1/2011,6868,6315,553,8.1,154131,140183,13948,9
Claiborne,10/1/2011,6851,6320,531,7.8,153961,140368,13594,8.8
Claiborne,11/1/2011,6853,6362,491,7.2,154128,140826,13302,8.6
Claiborne,12/1/2011,6900,6415,485,7,153995,140902,13093,8.5
Claiborne,1/1/2012,7001,6484,517,7.4,154381,141584,12797,8.3
Claiborne,2/1/2012,7079,6595,484,6.8,154671,141858,12813,8.3
Claiborne,3/1/2012,7062,6583,479,6.8,154749,142036,12713,8.2
Claiborne,4/1/2012,7099,6622,477,6.7,154545,141899,12646,8.2
Claiborne,5/1/2012,7126,6618,508,7.1,154866,142206,12660,8.2
Claiborne,6/1/2012,7208,6636,572,7.9,155083,142391,12692,8.2
Claiborne,7/1/2012,7185,6613,572,8,154948,142292,12656,8.2
Claiborne,8/1/2012,7067,6538,529,7.5,154763,142291,12471,8.1
Claiborne,9/1/2012,6999,6509,490,7,155160,143044,12115,7.8
Claiborne,10/1/2012,6996,6524,472,6.7,155554,143431,12124,7.8
Claiborne,11/1/2012,6947,6506,441,6.3,155338,143333,12005,7.7
Claiborne,12/1/2012,6980,6511,469,6.7,155628,143330,12298,7.9
Claiborne,1/1/2013,6573,6039,534,8.1,155763,143292,12471,8
Claiborne,2/1/2013,6545,6056,489,7.5,155312,143362,11950,7.7
Claiborne,3/1/2013,6554,6074,480,7.3,155005,143316,11689,7.5
Claiborne,4/1/2013,6593,6134,459,7,155394,143635,11760,7.6
Claiborne,5/1/2013,6637,6162,475,7.2,155536,143882,11654,7.5
Claiborne,6/1/2013,6703,6157,546,8.1,155749,143999,11751,7.5
Claiborne,7/1/2013,6725,6204,521,7.7,155599,144264,11335,7.3
Claiborne,8/1/2013,6539,6077,462,7.1,155605,144326,11279,7.2
Claiborne,9/1/2013,6464,6012,452,7,155687,144418,11270,7.2
Claiborne,10/1/2013,6327,5904,423,6.7,154673,143537,11136,7.2
Claiborne,11/1/2013,6361,5965,396,6.2,155265,144479,10787,6.9
Claiborne,12/1/2013,6268,5911,357,5.7,155182,144778,10404,6.7
Claiborne,1/1/2014,6267,5851,416,6.6,155352,145150,10202,6.6
Claiborne,2/1/2014,6222,5842,380,6.1,155483,145134,10349,6.7
Claiborne,3/1/2014,6240,5838,402,6.4,156028,145648,10380,6.7
Claiborne,4/1/2014,6230,5847,383,6.1,155369,145667,9702,6.2
Claiborne,5/1/2014,6268,5832,436,7,155684,145825,9859,6.3
Claiborne,6/1/2014,6344,5866,478,7.5,155707,146247,9460,6.1
Claiborne,7/1/2014,6461,5950,511,7.9,156007,146399,9608,6.2
Claiborne,8/1/2014,6393,5876,517,8.1,156130,146530,9599,6.1
Claiborne,9/1/2014,6350,5837,513,8.1,156040,146778,9262,5.9
Claiborne,10/1/2014,6395,5899,496,7.8,156417,147427,8990,5.7
Claiborne,11/1/2014,6362,5864,498,7.8,156494,147404,9090,5.8
Claiborne,12/1/2014,6338,5853,485,7.7,156332,147615,8717,5.6
Claiborne,1/1/2015,6299,5782,517,8.2,157030,148145,8885,5.7
Claiborne,2/1/2015,6245,5757,488,7.8,156644,148045,8599,5.5
Claiborne,3/1/2015,6192,5709,483,7.8,156643,148128,8515,5.4
Claiborne,4/1/2015,6207,5743,464,7.5,157060,148511,8550,5.4
Claiborne,5/1/2015,6199,5736,463,7.5,157651,148817,8834,5.6
Claiborne,6/1/2015,6209,5730,479,7.7,157062,148816,8247,5.3
Claiborne,7/1/2015,6248,5781,467,7.5,156997,148830,8167,5.2
Claiborne,8/1/2015,6133,5720,413,6.7,157172,149181,7992,5.1
Claiborne,9/1/2015,6025,5626,399,6.6,156733,148826,7907,5
Claiborne,10/1/2015,6071,5655,416,6.9,157167,149246,7922,5
Claiborne,11/1/2015,6015,5623,392,6.5,157463,149463,8000,5.1
Claiborne,12/1/2015,6016,5639,377,6.3,158035,150128,7907,5
Claiborne,1/1/2016,6041,5633,408,6.8,158280,150653,7627,4.8
Claiborne,2/1/2016,5976,5601,375,6.3,158640,150939,7702,4.9
Claiborne,3/1/2016,6025,5626,399,6.6,159179,151218,7961,5
Claiborne,4/1/2016,5942,5561,381,6.4,159141,151074,8067,5.1
Claiborne,5/1/2016,5963,5577,386,6.5,158784,151132,7652,4.8
Claiborne,6/1/2016,6074,5628,446,7.3,158967,151223,7744,4.9
Claiborne,7/1/2016,6058,5619,439,7.2,159194,151554,7641,4.8
Claiborne,8/1/2016,6001,5584,417,6.9,159562,151779,7784,4.9
Claiborne,9/1/2016,5911,5494,417,7.1,159714,151761,7953,5
Claiborne,10/1/2016,5830,5451,379,6.5,159605,151793,7811,4.9
Claiborne,11/1/2016,5803,5455,348,6,159506,151954,7553,4.7
Claiborne,12/1/2016,5765,5415,350,6.1,159678,152157,7521,4.7
Claiborne,1/1/2017,5748,5369,379,6.6,159620,152152,7468,4.7
Claiborne,2/1/2017,5755,5417,338,5.9,159859,152480,7379,4.6
Claiborne,3/1/2017,5799,5469,330,5.7,160137,153065,7073,4.4
Claiborne,4/1/2017,5857,5533,324,5.5,160345,153255,7089,4.4
Claiborne,5/1/2017,5845,5534,311,5.3,160068,153069,7000,4.4
Claiborne,6/1/2017,5991,5642,349,5.8,160192,153318,6873,4.3
Claiborne,7/1/2017,5987,5658,329,5.5,160462,153569,6892,4.3
Claiborne,8/1/2017,5886,5575,311,5.3,160586,153503,7082,4.4
Claiborne,9/1/2017,5871,5579,292,5,161140,154286,6854,4.3
Claiborne,10/1/2017,5810,5549,261,4.5,160309,153609,6700,4.2
Claiborne,11/1/2017,5805,5543,262,4.5,160579,153805,6774,4.2
Claiborne,12/1/2017,5855,5593,262,4.5,160535,153904,6632,4.1
Claiborne,1/1/2018,5786,5502,284,4.9,160914,154425,6489,4
Claiborne,2/1/2018,5791,5509,282,4.9,161778,155197,6581,4.1
Claiborne,3/1/2018,5833,5550,283,4.9,161686,155214,6472,4
Claiborne,4/1/2018,5817,5540,277,4.8,161771,155312,6459,4
Claiborne,5/1/2018,5788,5490,298,5.1,161848,155652,6196,3.8
Claiborne,6/1/2018,5910,5547,363,6.1,162210,155762,6447,4
Claiborne,7/1/2018,5915,5568,347,5.9,162341,156146,6195,3.8
Claiborne,8/1/2018,5820,5503,317,5.4,161660,155504,6156,3.8
Claiborne,9/1/2018,5732,5441,291,5.1,162087,156015,6073,3.7
Claiborne,10/1/2018,5742,5468,274,4.8,162602,156391,6211,3.8
Claiborne,11/1/2018,5758,5484,274,4.8,162836,156721,6115,3.8
Claiborne,12/1/2018,5761,5478,283,4.9,163206,156817,6389,3.9
Claiborne,1/1/2019,5778,5459,319,5.5,162963,156487,6475,4
Claiborne,2/1/2019,5782,5497,285,4.9,162999,156863,6136,3.8
Claiborne,3/1/2019,5806,5534,272,4.7,162904,156701,6202,3.8
Claiborne,4/1/2019,5745,5494,251,4.4,162586,156625,5961,3.7
Claiborne,5/1/2019,5762,5493,269,4.7,162751,156821,5930,3.6
Claiborne,6/1/2019,5862,5523,339,5.8,163168,157232,5935,3.6
Claiborne,7/1/2019,5896,5556,340,5.8,163590,157529,6061,3.7
Claiborne,8/1/2019,5876,5551,325,5.5,163774,157829,5945,3.6
Claiborne,9/1/2019,5833,5521,312,5.3,164092,158339,5753,3.5
Claiborne,10/1/2019,5868,5524,344,5.9,164416,158545,5871,3.6
Claiborne,11/1/2019,5774,5410,364,6.3,164496,158629,5868,3.6
Claiborne,12/1/2019,5782,5445,337,5.8,164699,158845,5853,3.6
Claiborne,1/1/2020,5506,5163,343,6.2,164377,158508,5869,3.6
Claiborne,2/1/2020,5460,5150,310,5.7,164467,158714,5753,3.5
Claiborne,3/1/2020,5612,5115,497,8.9,162559,155353,7206,4.4
Claiborne,4/1/2020,5119,4763,356,7,156269,133185,23084,14.8
Claiborne,5/1/2020,5219,4833,386,7.4,158101,137173,20929,13.2
Claiborne,6/1/2020,5400,4976,424,7.9,159994,142342,17652,11
Claiborne,7/1/2020,5391,4978,413,7.7,160132,143779,16352,10.2
Claiborne,8/1/2020,5437,5049,388,7.1,160706,147245,13461,8.4
Claiborne,9/1/2020,5489,5078,411,7.5,160174,147620,12554,7.8
Claiborne,10/1/2020,5500,5126,374,6.8,161003,149931,11072,6.9
Claiborne,11/1/2020,5447,5112,335,6.2,160629,149934,10694,6.7
Claiborne,12/1/2020,5487,5143,344,6.3,160745,149975,10770,6.7
Claiborne,1/1/2021,5415,5047,368,6.8,160088,149852,10236,6.4
Claiborne,2/1/2021,5460,5111,349,6.4,160184,150189,9995,6.2
Claiborne,3/1/2021,5451,5134,317,5.8,160400,150644,9756,6.1
Claiborne,4/1/2021,5427,5143,284,5.2,160843,151081,9762,6.1
Claiborne,5/1/2021,5384,5089,295,5.5,160800,151535,9266,5.8
Claiborne,6/1/2021,5461,5124,337,6.2,161197,151734,9462,5.9
Claiborne,7/1/2021,5443,5148,295,5.4,161504,152773,8731,5.4
Claiborne,8/1/2021,5376,5117,259,4.8,161527,153250,8276,5.1
Claiborne,9/1/2021,5469,5244,225,4.1,161495,153843,7652,4.7
Claiborne,10/1/2021,5401,5186,215,4,161754,154475,7279,4.5
Claiborne,11/1/2021,5353,5170,183,3.4,162281,155530,6751,4.2
Claiborne,12/1/2021,5382,5212,170,3.2,162497,156099,6398,3.9
Claiborne,1/1/2022,5332,5108,224,4.2,163627,157115,6512,4
Claiborne,2/1/2022,5325,5121,204,3.8,163899,157598,6301,3.8
Claiborne,3/1/2022,5372,5180,192,3.6,164220,158206,6014,3.7
Claiborne,4/1/2022,5364,5190,174,3.2,163893,157891,6002,3.7
Claiborne,5/1/2022,5351,5155,196,3.7,164362,158378,5983,3.6
Claiborne,6/1/2022,5477,5220,257,4.7,164046,158094,5951,3.6
Claiborne,7/1/2022,5508,5254,254,4.6,164026,158258,5768,3.5
Claiborne,8/1/2022,5411,5170,241,4.5,164654,158735,5919,3.6
Claiborne,9/1/2022,5371,5174,197,3.7,164602,158810,5792,3.5
Claiborne,10/1/2022,5340,5154,186,3.5,164648,158684,5964,3.6
Claiborne,11/1/2022,5306,5135,171,3.2,164450,158507,5943,3.6
Claiborne,12/1/2022,5340,5166,174,3.3,165025,159259,5766,3.5
Claiborne,1/1/2023,5335,5135,200,3.7,165964,160217,5747,3.5
Claiborne,2/1/2023,5350,5157,193,3.6,166358,160395,5962,3.6
Claiborne,3/1/2023,5382,5200,182,3.4,166651,160812,5839,3.5
Claiborne,4/1/2023,5397,5230,167,3.1,166725,160974,5751,3.4
Claiborne,5/1/2023,5378,5167,211,3.9,166886,160796,6089,3.6
Claiborne,6/1/2023,5453,5225,228,4.2,166937,160979,5958,3.6
Claiborne,7/1/2023,5442,5227,215,4,167103,161183,5920,3.5
Claiborne,8/1/2023,5426,5198,228,4.2,167759,161475,6284,3.7
Claiborne,9/1/2023,5374,5141,233,4.3,167767,161442,6326,3.8
Claiborne,10/1/2023,5387,5140,247,4.6,167690,161211,6479,3.9
Claiborne,11/1/2023,5390,5143,247,4.6,168140,161886,6254,3.7
Claiborne,12/1/2023,5371,5135,236,4.4,167439,161124,6315,3.8
Claiborne,1/1/2024,5370,5099,271,5,167339,161190,6149,3.7
Claiborne,2/1/2024,5356,5084,272,5.1,167475,161013,6462,3.9
Claiborne,3/1/2024,5421,5142,279,5.1,167922,161425,6497,3.9
Claiborne,4/1/2024,5392,5148,244,4.5,167988,161495,6492,3.9
Claiborne,5/1/2024,5344,5090,254,4.8,167799,161164,6635,4
Claiborne,6/1/2024,5443,5144,299,5.5,168005,161155,6849,4.1
Claiborne,7/1/2024,5478,5177,301,5.5,168315,161219,7097,4.2
Claiborne,8/1/2024,5416,5126,290,5.4,168496,161425,7071,4.2
Claiborne,9/1/2024,5370,5098,272,5.1,168703,161802,6901,4.1
Claiborne,10/1/2024,5346,5074,272,5.1,168428,161456,6972,4.1
Claiborne,11/1/2024,5320,5037,283,5.3,168304,161183,7121,4.2
Claiborne,12/1/2024,5307,5056,251,4.7,168547,161661,6886,4.1
Claiborne,1/1/2025,4266,3990,276,6.5,170744,163895,6849,4
Claiborne,2/1/2025,4238,3977,261,6.2,170359,163307,7052,4.1
Concordia,1/1/1990,8109,7237,872,10.8,125833,119081,6752,5.4
Concordia,2/1/1990,8082,7252,830,10.3,125710,119059,6651,5.3
Concordia,3/1/1990,8121,7394,727,9,125801,119203,6598,5.2
Concordia,4/1/1990,8264,7479,785,9.5,125649,118852,6797,5.4
Concordia,5/1/1990,8252,7443,809,9.8,125893,119151,6742,5.4
Concordia,6/1/1990,8453,7505,948,11.2,125573,118983,6590,5.2
Concordia,7/1/1990,8531,7566,965,11.3,125732,118810,6922,5.5
Concordia,8/1/1990,8419,7526,893,10.6,125990,118802,7188,5.7
Concordia,9/1/1990,8569,7640,929,10.8,125892,118524,7368,5.9
Concordia,10/1/1990,8411,7696,715,8.5,125995,118536,7459,5.9
Concordia,11/1/1990,8605,7702,903,10.5,126070,118306,7764,6.2
Concordia,12/1/1990,8598,7524,1074,12.5,126142,118241,7901,6.3
Concordia,1/1/1991,8808,7143,1665,18.9,125955,117940,8015,6.4
Concordia,2/1/1991,8561,7106,1455,17,126020,117755,8265,6.6
Concordia,3/1/1991,8539,7179,1360,15.9,126238,117652,8586,6.8
Concordia,4/1/1991,8495,7238,1257,14.8,126548,118109,8439,6.7
Concordia,5/1/1991,8575,7158,1417,16.5,126176,117440,8736,6.9
Concordia,6/1/1991,8869,7261,1608,18.1,126331,117639,8692,6.9
Concordia,7/1/1991,8863,7435,1428,16.1,126154,117568,8586,6.8
Concordia,8/1/1991,8625,7437,1188,13.8,126150,117484,8666,6.9
Concordia,9/1/1991,8583,7265,1318,15.4,126650,117928,8722,6.9
Concordia,10/1/1991,8365,7291,1074,12.8,126642,117800,8842,7
Concordia,11/1/1991,8292,7324,968,11.7,126701,117770,8931,7
Concordia,12/1/1991,8413,7239,1174,14,126664,117466,9198,7.3
Concordia,1/1/1992,8703,7200,1503,17.3,127261,117978,9283,7.3
Concordia,2/1/1992,8565,7302,1263,14.7,127207,117753,9454,7.4
Concordia,3/1/1992,8575,7431,1144,13.3,127604,118144,9460,7.4
Concordia,4/1/1992,8480,7422,1058,12.5,127841,118426,9415,7.4
Concordia,5/1/1992,8408,7349,1059,12.6,128119,118375,9744,7.6
Concordia,6/1/1992,8698,7356,1342,15.4,128459,118419,10040,7.8
Concordia,7/1/1992,8974,7744,1230,13.7,128563,118713,9850,7.7
Concordia,8/1/1992,8774,7828,946,10.8,128613,118826,9787,7.6
Concordia,9/1/1992,8567,7759,808,9.4,128501,118720,9781,7.6
Concordia,10/1/1992,8602,7795,807,9.4,128026,118628,9398,7.3
Concordia,11/1/1992,8527,7641,886,10.4,128441,118876,9565,7.4
Concordia,12/1/1992,8459,7480,979,11.6,128554,118997,9557,7.4
Concordia,1/1/1993,8338,7155,1183,14.2,128400,119075,9325,7.3
Concordia,2/1/1993,8195,7226,969,11.8,128458,119275,9183,7.1
Concordia,3/1/1993,8461,7523,938,11.1,128598,119542,9056,7
Concordia,4/1/1993,8455,7591,864,10.2,128584,119474,9110,7.1
Concordia,5/1/1993,8350,7520,830,9.9,129264,120115,9149,7.1
Concordia,6/1/1993,8561,7546,1015,11.9,129411,120290,9121,7
Concordia,7/1/1993,8529,7611,918,10.8,129397,120467,8930,6.9
Concordia,8/1/1993,8389,7555,834,9.9,129619,120856,8763,6.8
Concordia,9/1/1993,8328,7512,816,9.8,129268,120554,8714,6.7
Concordia,10/1/1993,8303,7560,743,8.9,129573,120823,8750,6.8
Concordia,11/1/1993,8282,7531,751,9.1,129711,121169,8542,6.6
Concordia,12/1/1993,8337,7465,872,10.5,129941,121464,8477,6.5
Concordia,1/1/1994,8506,7380,1126,13.2,130596,121966,8630,6.6
Concordia,2/1/1994,8546,7442,1104,12.9,130669,122086,8583,6.6
Concordia,3/1/1994,8540,7493,1047,12.3,130400,121930,8470,6.5
Concordia,4/1/1994,8412,7522,890,10.6,130621,122290,8331,6.4
Concordia,5/1/1994,8450,7492,958,11.3,130779,122864,7915,6.1
Concordia,6/1/1994,8510,7465,1045,12.3,130561,122634,7927,6.1
Concordia,7/1/1994,8598,7582,1016,11.8,130652,122706,7946,6.1
Concordia,8/1/1994,8489,7573,916,10.8,131275,123342,7933,6
Concordia,9/1/1994,8487,7596,891,10.5,131421,123687,7734,5.9
Concordia,10/1/1994,8361,7476,885,10.6,131744,124112,7632,5.8
Concordia,11/1/1994,8223,7458,765,9.3,131891,124516,7375,5.6
Concordia,12/1/1994,8183,7355,828,10.1,131951,124721,7230,5.5
Concordia,1/1/1995,8347,7227,1120,13.4,132038,124663,7375,5.6
Concordia,2/1/1995,8288,7298,990,11.9,132115,124928,7187,5.4
Concordia,3/1/1995,8300,7328,972,11.7,132108,124955,7153,5.4
Concordia,4/1/1995,8175,7357,818,10,132590,124945,7645,5.8
Concordia,5/1/1995,8038,7263,775,9.6,131851,124421,7430,5.6
Concordia,6/1/1995,8336,7359,977,11.7,131949,124522,7427,5.6
Concordia,7/1/1995,8365,7438,927,11.1,132343,124816,7527,5.7
Concordia,8/1/1995,8409,7439,970,11.5,132336,124852,7484,5.7
Concordia,9/1/1995,8252,7518,734,8.9,132611,125133,7478,5.6
Concordia,10/1/1995,8287,7545,742,9,132716,125388,7328,5.5
Concordia,11/1/1995,8199,7423,776,9.5,132614,125188,7426,5.6
Concordia,12/1/1995,8155,7311,844,10.3,132511,125088,7423,5.6
Concordia,1/1/1996,8032,6885,1147,14.3,132616,125125,7491,5.6
Concordia,2/1/1996,7816,6872,944,12.1,132952,125639,7313,5.5
Concordia,3/1/1996,7821,6950,871,11.1,133180,125862,7318,5.5
Concordia,4/1/1996,7937,7077,860,10.8,133409,125994,7415,5.6
Concordia,5/1/1996,7981,6997,984,12.3,133667,126244,7423,5.6
Concordia,6/1/1996,8057,7101,956,11.9,133697,126602,7095,5.3
Concordia,7/1/1996,8222,7279,943,11.5,134284,126947,7337,5.5
Concordia,8/1/1996,8039,7118,921,11.5,134054,127172,6882,5.1
Concordia,9/1/1996,8120,7136,984,12.1,134515,127536,6979,5.2
Concordia,10/1/1996,8130,7162,968,11.9,134921,127890,7031,5.2
Concordia,11/1/1996,7952,7111,841,10.6,135007,127771,7236,5.4
Concordia,12/1/1996,8015,7078,937,11.7,135113,127860,7253,5.4
Concordia,1/1/1997,8543,7274,1269,14.9,135456,128298,7158,5.3
Concordia,2/1/1997,8229,7255,974,11.8,135400,128298,7102,5.2
Concordia,3/1/1997,8259,7300,959,11.6,135891,128891,7000,5.2
Concordia,4/1/1997,8168,7334,834,10.2,136016,129143,6873,5.1
Concordia,5/1/1997,8098,7262,836,10.3,136119,129464,6655,4.9
Concordia,6/1/1997,8292,7071,1221,14.7,136211,129412,6799,5
Concordia,7/1/1997,8310,7229,1081,13,136477,129822,6655,4.9
Concordia,8/1/1997,8163,7212,951,11.7,136618,130010,6608,4.8
Concordia,9/1/1997,8078,7199,879,10.9,136675,130019,6656,4.9
Concordia,10/1/1997,7963,7210,753,9.5,136633,130179,6454,4.7
Concordia,11/1/1997,7910,7227,683,8.6,136961,130653,6308,4.6
Concordia,12/1/1997,8293,7194,1099,13.3,137155,130679,6476,4.7
Concordia,1/1/1998,8613,7184,1429,16.6,137095,130726,6368,4.6
Concordia,2/1/1998,8370,7204,1166,13.9,137112,130807,6306,4.6
Concordia,3/1/1998,8494,7275,1219,14.4,137236,130814,6422,4.7
Concordia,4/1/1998,8440,7212,1228,14.5,137150,131209,5941,4.3
Concordia,5/1/1998,8489,7301,1188,14,137372,131325,6047,4.4
Concordia,6/1/1998,8616,7369,1247,14.5,137455,131244,6212,4.5
Concordia,7/1/1998,8511,7361,1150,13.5,137588,131329,6259,4.5
Concordia,8/1/1998,8519,7329,1190,14,137570,131390,6179,4.5
Concordia,9/1/1998,8432,7209,1223,14.5,138286,131986,6300,4.6
Concordia,10/1/1998,8338,7240,1098,13.2,138279,131999,6280,4.5
Concordia,11/1/1998,8164,7171,993,12.2,138381,132280,6100,4.4
Concordia,12/1/1998,8246,7118,1128,13.7,138634,132602,6032,4.4
Concordia,1/1/1999,8391,7078,1313,15.6,139003,133027,5976,4.3
Concordia,2/1/1999,8175,7108,1067,13.1,138967,132856,6111,4.4
Concordia,3/1/1999,8382,7304,1078,12.9,138730,132947,5783,4.2
Concordia,4/1/1999,8235,7309,926,11.2,138959,132955,6004,4.3
Concordia,5/1/1999,8151,7290,861,10.6,139107,133311,5796,4.2
Concordia,6/1/1999,8363,7238,1125,13.5,139329,133378,5951,4.3
Concordia,7/1/1999,8331,7319,1012,12.1,139439,133414,6025,4.3
Concordia,8/1/1999,8432,7361,1071,12.7,139430,133591,5838,4.2
Concordia,9/1/1999,8459,7334,1125,13.3,139622,133707,5915,4.2
Concordia,10/1/1999,8348,7393,955,11.4,139771,133993,5778,4.1
Concordia,11/1/1999,8125,7387,738,9.1,140025,134309,5716,4.1
Concordia,12/1/1999,8023,7319,704,8.8,140177,134523,5653,4
Concordia,1/1/2000,7898,7121,777,9.8,142267,136559,5708,4
Concordia,2/1/2000,7858,7092,766,9.7,142456,136598,5858,4.1
Concordia,3/1/2000,7906,7136,770,9.7,142434,136701,5733,4
Concordia,4/1/2000,7720,7158,562,7.3,142751,137270,5481,3.8
Concordia,5/1/2000,7709,7040,669,8.7,142388,136630,5758,4
Concordia,6/1/2000,7757,7066,691,8.9,142591,136940,5651,4
Concordia,7/1/2000,7686,7119,567,7.4,142278,136531,5747,4
Concordia,8/1/2000,7726,7137,589,7.6,142514,136662,5853,4.1
Concordia,9/1/2000,7670,7101,569,7.4,142518,136893,5625,3.9
Concordia,10/1/2000,7629,7098,531,7,142622,137088,5534,3.9
Concordia,11/1/2000,7558,7019,539,7.1,142962,137322,5639,3.9
Concordia,12/1/2000,7584,6992,592,7.8,143248,137614,5634,3.9
Concordia,1/1/2001,7551,6795,756,10,143800,137778,6023,4.2
Concordia,2/1/2001,7625,6886,739,9.7,143701,137612,6089,4.2
Concordia,3/1/2001,7682,6831,851,11.1,143924,137783,6141,4.3
Concordia,4/1/2001,7530,6887,643,8.5,143569,137299,6271,4.4
Concordia,5/1/2001,7423,6766,657,8.9,143318,137092,6226,4.3
Concordia,6/1/2001,7495,6794,701,9.4,143357,136873,6484,4.5
Concordia,7/1/2001,7529,6870,659,8.8,143654,137071,6583,4.6
Concordia,8/1/2001,7601,6886,715,9.4,143284,136241,7042,4.9
Concordia,9/1/2001,7625,6898,727,9.5,143989,136846,7142,5
Concordia,10/1/2001,7550,6883,667,8.8,144086,136392,7694,5.3
Concordia,11/1/2001,7575,6855,720,9.5,144240,136238,8003,5.5
Concordia,12/1/2001,7505,6760,745,9.9,144305,136047,8258,5.7
Concordia,1/1/2002,7451,6618,833,11.2,143883,135701,8182,5.7
Concordia,2/1/2002,7413,6673,740,10,144653,136438,8215,5.7
Concordia,3/1/2002,7577,6691,886,11.7,144481,136177,8304,5.7
Concordia,4/1/2002,7547,6758,789,10.5,144725,136126,8599,5.9
Concordia,5/1/2002,7356,6683,673,9.1,144938,136539,8399,5.8
Concordia,6/1/2002,7606,6822,784,10.3,144808,136415,8393,5.8
Concordia,7/1/2002,7634,6987,647,8.5,144803,136413,8390,5.8
Concordia,8/1/2002,7643,6960,683,8.9,145009,136705,8304,5.7
Concordia,9/1/2002,7559,6883,676,8.9,145552,137302,8251,5.7
Concordia,10/1/2002,7658,6973,685,8.9,145314,137008,8307,5.7
Concordia,11/1/2002,7508,6809,699,9.3,145041,136521,8520,5.9
Concordia,12/1/2002,7504,6744,760,10.1,145066,136426,8640,6
Concordia,1/1/2003,7556,6609,947,12.5,145937,137417,8520,5.8
Concordia,2/1/2003,7361,6484,877,11.9,146100,137482,8618,5.9
Concordia,3/1/2003,7407,6487,920,12.4,146022,137434,8588,5.9
Concordia,4/1/2003,7475,6597,878,11.7,146474,137633,8842,6
Concordia,5/1/2003,7251,6513,738,10.2,146500,137544,8957,6.1
Concordia,6/1/2003,7489,6550,939,12.5,147056,137790,9266,6.3
Concordia,7/1/2003,7286,6525,761,10.4,146485,137474,9011,6.2
Concordia,8/1/2003,7252,6370,882,12.2,146445,137549,8896,6.1
Concordia,9/1/2003,7155,6341,814,11.4,146530,137609,8921,6.1
Concordia,10/1/2003,7268,6540,728,10,146716,137984,8732,6
Concordia,11/1/2003,7112,6476,636,8.9,147000,138424,8576,5.8
Concordia,12/1/2003,7091,6423,668,9.4,146729,138411,8317,5.7
Concordia,1/1/2004,7088,6292,796,11.2,146842,138472,8370,5.7
Concordia,2/1/2004,6978,6304,674,9.7,146709,138542,8167,5.6
Concordia,3/1/2004,7074,6336,738,10.4,146944,138453,8491,5.8
Concordia,4/1/2004,7222,6522,700,9.7,146850,138680,8170,5.6
Concordia,5/1/2004,7108,6456,652,9.2,147065,138852,8212,5.6
Concordia,6/1/2004,7301,6482,819,11.2,147460,139174,8286,5.6
Concordia,7/1/2004,7269,6553,716,9.9,147692,139556,8136,5.5
Concordia,8/1/2004,7221,6597,624,8.6,147564,139573,7990,5.4
Concordia,9/1/2004,7238,6558,680,9.4,147415,139487,7927,5.4
Concordia,10/1/2004,7420,6692,728,9.8,147793,139732,8061,5.5
Concordia,11/1/2004,7305,6666,639,8.7,148162,140231,7932,5.4
Concordia,12/1/2004,7202,6546,656,9.1,148059,140125,7934,5.4
Concordia,1/1/2005,7121,6357,764,10.7,148029,140245,7784,5.3
Concordia,2/1/2005,7010,6329,681,9.7,148364,140385,7980,5.4
Concordia,3/1/2005,7068,6395,673,9.5,148391,140654,7737,5.2
Concordia,4/1/2005,7180,6550,630,8.8,148926,141254,7672,5.2
Concordia,5/1/2005,7051,6503,548,7.8,149261,141609,7651,5.1
Concordia,6/1/2005,7162,6498,664,9.3,149238,141714,7524,5
Concordia,7/1/2005,7015,6441,574,8.2,149432,142026,7406,5
Concordia,8/1/2005,6999,6382,617,8.8,149779,142434,7345,4.9
Concordia,9/1/2005,8200,6906,1294,15.8,149954,142401,7553,5
Concordia,10/1/2005,8241,7121,1120,13.6,150001,142548,7453,5
Concordia,11/1/2005,8192,7092,1100,13.4,150065,142499,7566,5
Concordia,12/1/2005,7760,7033,727,9.4,150030,142752,7279,4.9
Concordia,1/1/2006,7465,6875,590,7.9,150214,143150,7064,4.7
Concordia,2/1/2006,7256,6807,449,6.2,150641,143457,7184,4.8
Concordia,3/1/2006,7253,6827,426,5.9,150813,143741,7072,4.7
Concordia,4/1/2006,7322,6929,393,5.4,150881,143761,7120,4.7
Concordia,5/1/2006,7393,6997,396,5.4,151069,144089,6980,4.6
Concordia,6/1/2006,7561,7054,507,6.7,151354,144353,7001,4.6
Concordia,7/1/2006,7503,7030,473,6.3,151377,144202,7175,4.7
Concordia,8/1/2006,7357,6944,413,5.6,151716,144625,7091,4.7
Concordia,9/1/2006,7342,6931,411,5.6,151662,144815,6847,4.5
Concordia,10/1/2006,7344,6938,406,5.5,152041,145314,6727,4.4
Concordia,11/1/2006,7386,6984,402,5.4,152406,145534,6872,4.5
Concordia,12/1/2006,7404,6926,478,6.5,152732,145970,6762,4.4
Concordia,1/1/2007,7460,6941,519,7,153144,146028,7116,4.6
Concordia,2/1/2007,7479,6954,525,7,152983,146057,6927,4.5
Concordia,3/1/2007,7468,7024,444,5.9,153051,146320,6731,4.4
Concordia,4/1/2007,7379,6959,420,5.7,152435,145586,6850,4.5
Concordia,5/1/2007,7259,6901,358,4.9,152670,145903,6766,4.4
Concordia,6/1/2007,7397,6912,485,6.6,153041,146063,6979,4.6
Concordia,7/1/2007,7278,6805,473,6.5,153054,145905,7149,4.7
Concordia,8/1/2007,7256,6849,407,5.6,152749,145682,7067,4.6
Concordia,9/1/2007,7337,6935,402,5.5,153414,146244,7170,4.7
Concordia,10/1/2007,7311,6938,373,5.1,153183,145946,7237,4.7
Concordia,11/1/2007,7285,6975,310,4.3,153835,146595,7240,4.7
Concordia,12/1/2007,7338,6923,415,5.7,153918,146273,7645,5
Concordia,1/1/2008,7555,7018,537,7.1,154063,146378,7685,5
Concordia,2/1/2008,7505,7031,474,6.3,153653,146156,7497,4.9
Concordia,3/1/2008,7562,7116,446,5.9,153908,146086,7822,5.1
Concordia,4/1/2008,7564,7150,414,5.5,153769,146132,7637,5
Concordia,5/1/2008,7534,7127,407,5.4,154303,145908,8395,5.4
Concordia,6/1/2008,7658,7066,592,7.7,154313,145737,8575,5.6
Concordia,7/1/2008,7794,7057,737,9.5,154469,145532,8937,5.8
Concordia,8/1/2008,7628,7029,599,7.9,154641,145203,9438,6.1
Concordia,9/1/2008,7679,7095,584,7.6,154570,145076,9494,6.1
Concordia,10/1/2008,7609,7088,521,6.8,154876,144802,10074,6.5
Concordia,11/1/2008,7537,7063,474,6.3,154639,144100,10538,6.8
Concordia,12/1/2008,7539,6901,638,8.5,154655,143369,11286,7.3
Concordia,1/1/2009,7581,6716,865,11.4,154210,142152,12058,7.8
Concordia,2/1/2009,7473,6665,808,10.8,154538,141640,12898,8.3
Concordia,3/1/2009,7420,6659,761,10.3,154133,140707,13426,8.7
Concordia,4/1/2009,7521,6732,789,10.5,154509,140656,13853,9
Concordia,5/1/2009,7490,6740,750,10,154747,140248,14499,9.4
Concordia,6/1/2009,7730,6792,938,12.1,154716,140009,14707,9.5
Concordia,7/1/2009,7847,6767,1080,13.8,154502,139901,14601,9.5
Concordia,8/1/2009,7587,6742,845,11.1,154307,139492,14814,9.6
Concordia,9/1/2009,7520,6707,813,10.8,153827,138818,15009,9.8
Concordia,10/1/2009,7416,6694,722,9.7,153784,138432,15352,10
Concordia,11/1/2009,7354,6689,665,9,153878,138659,15219,9.9
Concordia,12/1/2009,7465,6669,796,10.7,153111,138013,15098,9.9
Concordia,1/1/2010,7634,6843,791,10.4,153484,138438,15046,9.8
Concordia,2/1/2010,7730,7024,706,9.1,153694,138581,15113,9.8
Concordia,3/1/2010,7816,7112,704,9,153954,138751,15202,9.9
Concordia,4/1/2010,7846,7195,651,8.3,154622,139297,15325,9.9
Concordia,5/1/2010,7908,7201,707,8.9,154091,139241,14849,9.6
Concordia,6/1/2010,7966,7131,835,10.5,153616,139141,14474,9.4
Concordia,7/1/2010,8026,7208,818,10.2,153691,139179,14512,9.4
Concordia,8/1/2010,8117,7333,784,9.7,154086,139438,14648,9.5
Concordia,9/1/2010,7974,7246,728,9.1,153975,139396,14579,9.5
Concordia,10/1/2010,7876,7197,679,8.6,153635,139119,14516,9.4
Concordia,11/1/2010,7849,7162,687,8.8,154125,139044,15081,9.8
Concordia,12/1/2010,7800,7108,692,8.9,153650,139301,14348,9.3
Concordia,1/1/2011,7677,6928,749,9.8,153263,139250,14013,9.1
Concordia,2/1/2011,7724,7001,723,9.4,153214,139394,13820,9
Concordia,3/1/2011,7727,7049,678,8.8,153376,139639,13737,9
Concordia,4/1/2011,7802,7150,652,8.4,153543,139586,13957,9.1
Concordia,5/1/2011,7802,7087,715,9.2,153479,139624,13855,9
Concordia,6/1/2011,7930,7106,824,10.4,153346,139384,13962,9.1
Concordia,7/1/2011,8004,7226,778,9.7,153288,139524,13763,9
Concordia,8/1/2011,7968,7247,721,9,153760,139942,13818,9
Concordia,9/1/2011,7965,7267,698,8.8,154131,140183,13948,9
Concordia,10/1/2011,7858,7183,675,8.6,153961,140368,13594,8.8
Concordia,11/1/2011,7822,7195,627,8,154128,140826,13302,8.6
Concordia,12/1/2011,7839,7194,645,8.2,153995,140902,13093,8.5
Concordia,1/1/2012,7659,6928,731,9.5,154381,141584,12797,8.3
Concordia,2/1/2012,7676,7001,675,8.8,154671,141858,12813,8.3
Concordia,3/1/2012,7688,7040,648,8.4,154749,142036,12713,8.2
Concordia,4/1/2012,7791,7187,604,7.8,154545,141899,12646,8.2
Concordia,5/1/2012,7878,7241,637,8.1,154866,142206,12660,8.2
Concordia,6/1/2012,8076,7317,759,9.4,155083,142391,12692,8.2
Concordia,7/1/2012,8193,7429,764,9.3,154948,142292,12656,8.2
Concordia,8/1/2012,7983,7327,656,8.2,154763,142291,12471,8.1
Concordia,9/1/2012,7912,7287,625,7.9,155160,143044,12115,7.8
Concordia,10/1/2012,7855,7251,604,7.7,155554,143431,12124,7.8
Concordia,11/1/2012,7801,7241,560,7.2,155338,143333,12005,7.7
Concordia,12/1/2012,7865,7231,634,8.1,155628,143330,12298,7.9
Concordia,1/1/2013,7762,7024,738,9.5,155763,143292,12471,8
Concordia,2/1/2013,7752,7095,657,8.5,155312,143362,11950,7.7
Concordia,3/1/2013,7694,7039,655,8.5,155005,143316,11689,7.5
Concordia,4/1/2013,7706,7093,613,8,155394,143635,11760,7.6
Concordia,5/1/2013,7817,7172,645,8.3,155536,143882,11654,7.5
Concordia,6/1/2013,8004,7257,747,9.3,155749,143999,11751,7.5
Concordia,7/1/2013,8004,7294,710,8.9,155599,144264,11335,7.3
Concordia,8/1/2013,7862,7223,639,8.1,155605,144326,11279,7.2
Concordia,9/1/2013,7846,7229,617,7.9,155687,144418,11270,7.2
Concordia,10/1/2013,7780,7211,569,7.3,154673,143537,11136,7.2
Concordia,11/1/2013,7705,7193,512,6.6,155265,144479,10787,6.9
Concordia,12/1/2013,7680,7184,496,6.5,155182,144778,10404,6.7
Concordia,1/1/2014,7533,6967,566,7.5,155352,145150,10202,6.6
Concordia,2/1/2014,7533,6992,541,7.2,155483,145134,10349,6.7
Concordia,3/1/2014,7543,6980,563,7.5,156028,145648,10380,6.7
Concordia,4/1/2014,7531,7007,524,7,155369,145667,9702,6.2
Concordia,5/1/2014,7611,7009,602,7.9,155684,145825,9859,6.3
Concordia,6/1/2014,7875,7131,744,9.4,155707,146247,9460,6.1
Concordia,7/1/2014,8020,7229,791,9.9,156007,146399,9608,6.2
Concordia,8/1/2014,7887,7127,760,9.6,156130,146530,9599,6.1
Concordia,9/1/2014,7869,7139,730,9.3,156040,146778,9262,5.9
Concordia,10/1/2014,7740,7075,665,8.6,156417,147427,8990,5.7
Concordia,11/1/2014,7697,7036,661,8.6,156494,147404,9090,5.8
Concordia,12/1/2014,7653,7005,648,8.5,156332,147615,8717,5.6
Concordia,1/1/2015,7567,6869,698,9.2,157030,148145,8885,5.7
Concordia,2/1/2015,7512,6872,640,8.5,156644,148045,8599,5.5
Concordia,3/1/2015,7546,6877,669,8.9,156643,148128,8515,5.4
Concordia,4/1/2015,7519,6855,664,8.8,157060,148511,8550,5.4
Concordia,5/1/2015,7612,6916,696,9.1,157651,148817,8834,5.6
Concordia,6/1/2015,7775,7021,754,9.7,157062,148816,8247,5.3
Concordia,7/1/2015,7709,6979,730,9.5,156997,148830,8167,5.2
Concordia,8/1/2015,7494,6861,633,8.4,157172,149181,7992,5.1
Concordia,9/1/2015,7394,6788,606,8.2,156733,148826,7907,5
Concordia,10/1/2015,7329,6760,569,7.8,157167,149246,7922,5
Concordia,11/1/2015,7303,6757,546,7.5,157463,149463,8000,5.1
Concordia,12/1/2015,7267,6737,530,7.3,158035,150128,7907,5
Concordia,1/1/2016,7279,6673,606,8.3,158280,150653,7627,4.8
Concordia,2/1/2016,7180,6612,568,7.9,158640,150939,7702,4.9
Concordia,3/1/2016,7227,6634,593,8.2,159179,151218,7961,5
Concordia,4/1/2016,7242,6664,578,8,159141,151074,8067,5.1
Concordia,5/1/2016,7297,6724,573,7.9,158784,151132,7652,4.8
Concordia,6/1/2016,7463,6781,682,9.1,158967,151223,7744,4.9
Concordia,7/1/2016,7450,6770,680,9.1,159194,151554,7641,4.8
Concordia,8/1/2016,7280,6637,643,8.8,159562,151779,7784,4.9
Concordia,9/1/2016,7277,6665,612,8.4,159714,151761,7953,5
Concordia,10/1/2016,7090,6544,546,7.7,159605,151793,7811,4.9
Concordia,11/1/2016,7140,6612,528,7.4,159506,151954,7553,4.7
Concordia,12/1/2016,7053,6501,552,7.8,159678,152157,7521,4.7
Concordia,1/1/2017,7208,6552,656,9.1,159620,152152,7468,4.7
Concordia,2/1/2017,7176,6578,598,8.3,159859,152480,7379,4.6
Concordia,3/1/2017,7210,6628,582,8.1,160137,153065,7073,4.4
Concordia,4/1/2017,7173,6610,563,7.8,160345,153255,7089,4.4
Concordia,5/1/2017,7273,6708,565,7.8,160068,153069,7000,4.4
Concordia,6/1/2017,7461,6796,665,8.9,160192,153318,6873,4.3
Concordia,7/1/2017,7268,6657,611,8.4,160462,153569,6892,4.3
Concordia,8/1/2017,7108,6534,574,8.1,160586,153503,7082,4.4
Concordia,9/1/2017,7032,6506,526,7.5,161140,154286,6854,4.3
Concordia,10/1/2017,6967,6496,471,6.8,160309,153609,6700,4.2
Concordia,11/1/2017,6954,6501,453,6.5,160579,153805,6774,4.2
Concordia,12/1/2017,6918,6450,468,6.8,160535,153904,6632,4.1
Concordia,1/1/2018,6928,6424,504,7.3,160914,154425,6489,4
Concordia,2/1/2018,6886,6414,472,6.9,161778,155197,6581,4.1
Concordia,3/1/2018,6939,6479,460,6.6,161686,155214,6472,4
Concordia,4/1/2018,6972,6527,445,6.4,161771,155312,6459,4
Concordia,5/1/2018,7110,6642,468,6.6,161848,155652,6196,3.8
Concordia,6/1/2018,7269,6663,606,8.3,162210,155762,6447,4
Concordia,7/1/2018,7231,6643,588,8.1,162341,156146,6195,3.8
Concordia,8/1/2018,7025,6522,503,7.2,161660,155504,6156,3.8
Concordia,9/1/2018,6964,6501,463,6.6,162087,156015,6073,3.7
Concordia,10/1/2018,6914,6488,426,6.2,162602,156391,6211,3.8
Concordia,11/1/2018,6890,6481,409,5.9,162836,156721,6115,3.8
Concordia,12/1/2018,6821,6398,423,6.2,163206,156817,6389,3.9
Concordia,1/1/2019,6813,6336,477,7,162963,156487,6475,4
Concordia,2/1/2019,6778,6355,423,6.2,162999,156863,6136,3.8
Concordia,3/1/2019,6752,6367,385,5.7,162904,156701,6202,3.8
Concordia,4/1/2019,6828,6468,360,5.3,162586,156625,5961,3.7
Concordia,5/1/2019,6928,6539,389,5.6,162751,156821,5930,3.6
Concordia,6/1/2019,7027,6511,516,7.3,163168,157232,5935,3.6
Concordia,7/1/2019,7065,6545,520,7.4,163590,157529,6061,3.7
Concordia,8/1/2019,7207,6743,464,6.4,163774,157829,5945,3.6
Concordia,9/1/2019,7230,6806,424,5.9,164092,158339,5753,3.5
Concordia,10/1/2019,7088,6684,404,5.7,164416,158545,5871,3.6
Concordia,11/1/2019,7020,6604,416,5.9,164496,158629,5868,3.6
Concordia,12/1/2019,6958,6535,423,6.1,164699,158845,5853,3.6
Concordia,1/1/2020,6902,6446,456,6.6,164377,158508,5869,3.6
Concordia,2/1/2020,6830,6431,399,5.8,164467,158714,5753,3.5
Concordia,3/1/2020,7048,6373,675,9.6,162559,155353,7206,4.4
Concordia,4/1/2020,6503,5842,661,10.2,156269,133185,23084,14.8
Concordia,5/1/2020,6624,5929,695,10.5,158101,137173,20929,13.2
Concordia,6/1/2020,6790,6038,752,11.1,159994,142342,17652,11
Concordia,7/1/2020,6809,6047,762,11.2,160132,143779,16352,10.2
Concordia,8/1/2020,6917,6304,613,8.9,160706,147245,13461,8.4
Concordia,9/1/2020,7016,6397,619,8.8,160174,147620,12554,7.8
Concordia,10/1/2020,6993,6457,536,7.7,161003,149931,11072,6.9
Concordia,11/1/2020,6857,6387,470,6.9,160629,149934,10694,6.7
Concordia,12/1/2020,6882,6388,494,7.2,160745,149975,10770,6.7
Concordia,1/1/2021,6806,6275,531,7.8,160088,149852,10236,6.4
Concordia,2/1/2021,6765,6276,489,7.2,160184,150189,9995,6.2
Concordia,3/1/2021,6862,6386,476,6.9,160400,150644,9756,6.1
Concordia,4/1/2021,6896,6464,432,6.3,160843,151081,9762,6.1
Concordia,5/1/2021,6883,6444,439,6.4,160800,151535,9266,5.8
Concordia,6/1/2021,6995,6492,503,7.2,161197,151734,9462,5.9
Concordia,7/1/2021,6912,6434,478,6.9,161504,152773,8731,5.4
Concordia,8/1/2021,6866,6455,411,6,161527,153250,8276,5.1
Concordia,9/1/2021,6945,6596,349,5,161495,153843,7652,4.7
Concordia,10/1/2021,6761,6449,312,4.6,161754,154475,7279,4.5
Concordia,11/1/2021,6728,6442,286,4.3,162281,155530,6751,4.2
Concordia,12/1/2021,6786,6515,271,4,162497,156099,6398,3.9
Concordia,1/1/2022,6861,6517,344,5,163627,157115,6512,4
Concordia,2/1/2022,6861,6547,314,4.6,163899,157598,6301,3.8
Concordia,3/1/2022,6962,6660,302,4.3,164220,158206,6014,3.7
Concordia,4/1/2022,7043,6760,283,4,163893,157891,6002,3.7
Concordia,5/1/2022,7023,6721,302,4.3,164362,158378,5983,3.6
Concordia,6/1/2022,7085,6696,389,5.5,164046,158094,5951,3.6
Concordia,7/1/2022,7046,6646,400,5.7,164026,158258,5768,3.5
Concordia,8/1/2022,6900,6547,353,5.1,164654,158735,5919,3.6
Concordia,9/1/2022,6863,6551,312,4.5,164602,158810,5792,3.5
Concordia,10/1/2022,6787,6499,288,4.2,164648,158684,5964,3.6
Concordia,11/1/2022,6752,6475,277,4.1,164450,158507,5943,3.6
Concordia,12/1/2022,6801,6515,286,4.2,165025,159259,5766,3.5
Concordia,1/1/2023,6835,6492,343,5,165964,160217,5747,3.5
Concordia,2/1/2023,6814,6503,311,4.6,166358,160395,5962,3.6
Concordia,3/1/2023,6836,6542,294,4.3,166651,160812,5839,3.5
Concordia,4/1/2023,6911,6646,265,3.8,166725,160974,5751,3.4
Concordia,5/1/2023,6925,6623,302,4.4,166886,160796,6089,3.6
Concordia,6/1/2023,7010,6612,398,5.7,166937,160979,5958,3.6
Concordia,7/1/2023,6956,6607,349,5,167103,161183,5920,3.5
Concordia,8/1/2023,6867,6533,334,4.9,167759,161475,6284,3.7
Concordia,9/1/2023,6866,6535,331,4.8,167767,161442,6326,3.8
Concordia,10/1/2023,6843,6504,339,5,167690,161211,6479,3.9
Concordia,11/1/2023,6868,6541,327,4.8,168140,161886,6254,3.7
Concordia,12/1/2023,6848,6507,341,5,167439,161124,6315,3.8
Concordia,1/1/2024,6850,6459,391,5.7,167339,161190,6149,3.7
Concordia,2/1/2024,6769,6379,390,5.8,167475,161013,6462,3.9
Concordia,3/1/2024,6894,6505,389,5.6,167922,161425,6497,3.9
Concordia,4/1/2024,6944,6588,356,5.1,167988,161495,6492,3.9
Concordia,5/1/2024,6924,6540,384,5.5,167799,161164,6635,4
Concordia,6/1/2024,7141,6661,480,6.7,168005,161155,6849,4.1
Concordia,7/1/2024,7154,6675,479,6.7,168315,161219,7097,4.2
Concordia,8/1/2024,7076,6639,437,6.2,168496,161425,7071,4.2
Concordia,9/1/2024,7065,6656,409,5.8,168703,161802,6901,4.1
Concordia,10/1/2024,7030,6603,427,6.1,168428,161456,6972,4.1
Concordia,11/1/2024,6963,6545,418,6,168304,161183,7121,4.2
Concordia,12/1/2024,6947,6549,398,5.7,168547,161661,6886,4.1
Concordia,1/1/2025,6387,5982,405,6.3,170744,163895,6849,4
Concordia,2/1/2025,6322,5941,381,6,170359,163307,7052,4.1
De Soto,1/1/1990,10074,9021,1053,10.5,125833,119081,6752,5.4
De Soto,2/1/1990,9819,8929,890,9.1,125710,119059,6651,5.3
De Soto,3/1/1990,9935,9127,808,8.1,125801,119203,6598,5.2
De Soto,4/1/1990,9831,9029,802,8.2,125649,118852,6797,5.4
De Soto,5/1/1990,9997,9207,790,7.9,125893,119151,6742,5.4
De Soto,6/1/1990,10079,9218,861,8.5,125573,118983,6590,5.2
De Soto,7/1/1990,10065,9265,800,7.9,125732,118810,6922,5.5
De Soto,8/1/1990,10046,9278,768,7.6,125990,118802,7188,5.7
De Soto,9/1/1990,9914,9062,852,8.6,125892,118524,7368,5.9
De Soto,10/1/1990,9594,8814,780,8.1,125995,118536,7459,5.9
De Soto,11/1/1990,9573,8736,837,8.7,126070,118306,7764,6.2
De Soto,12/1/1990,9524,8632,892,9.4,126142,118241,7901,6.3
De Soto,1/1/1991,9736,8569,1167,12,125955,117940,8015,6.4
De Soto,2/1/1991,9618,8521,1097,11.4,126020,117755,8265,6.6
De Soto,3/1/1991,9833,8603,1230,12.5,126238,117652,8586,6.8
De Soto,4/1/1991,9891,8787,1104,11.2,126548,118109,8439,6.7
De Soto,5/1/1991,10094,8820,1274,12.6,126176,117440,8736,6.9
De Soto,6/1/1991,10235,8859,1376,13.4,126331,117639,8692,6.9
De Soto,7/1/1991,10060,8946,1114,11.1,126154,117568,8586,6.8
De Soto,8/1/1991,9932,8820,1112,11.2,126150,117484,8666,6.9
De Soto,9/1/1991,9989,8843,1146,11.5,126650,117928,8722,6.9
De Soto,10/1/1991,9603,8524,1079,11.2,126642,117800,8842,7
De Soto,11/1/1991,9539,8538,1001,10.5,126701,117770,8931,7
De Soto,12/1/1991,9447,8425,1022,10.8,126664,117466,9198,7.3
De Soto,1/1/1992,9983,8721,1262,12.6,127261,117978,9283,7.3
De Soto,2/1/1992,10231,8921,1310,12.8,127207,117753,9454,7.4
De Soto,3/1/1992,10160,8919,1241,12.2,127604,118144,9460,7.4
De Soto,4/1/1992,10197,9209,988,9.7,127841,118426,9415,7.4
De Soto,5/1/1992,10077,9024,1053,10.4,128119,118375,9744,7.6
De Soto,6/1/1992,10327,9068,1259,12.2,128459,118419,10040,7.8
De Soto,7/1/1992,10510,9450,1060,10.1,128563,118713,9850,7.7
De Soto,8/1/1992,10330,9312,1018,9.9,128613,118826,9787,7.6
De Soto,9/1/1992,10396,9345,1051,10.1,128501,118720,9781,7.6
De Soto,10/1/1992,10200,9240,960,9.4,128026,118628,9398,7.3
De Soto,11/1/1992,10143,9211,932,9.2,128441,118876,9565,7.4
De Soto,12/1/1992,9890,8968,922,9.3,128554,118997,9557,7.4
De Soto,1/1/1993,9970,8873,1097,11,128400,119075,9325,7.3
De Soto,2/1/1993,10096,9133,963,9.5,128458,119275,9183,7.1
De Soto,3/1/1993,10795,9857,938,8.7,128598,119542,9056,7
De Soto,4/1/1993,9994,9078,916,9.2,128584,119474,9110,7.1
De Soto,5/1/1993,10184,9289,895,8.8,129264,120115,9149,7.1
De Soto,6/1/1993,10303,9266,1037,10.1,129411,120290,9121,7
De Soto,7/1/1993,10153,9247,906,8.9,129397,120467,8930,6.9
De Soto,8/1/1993,10066,9182,884,8.8,129619,120856,8763,6.8
De Soto,9/1/1993,9980,9144,836,8.4,129268,120554,8714,6.7
De Soto,10/1/1993,9969,9118,851,8.5,129573,120823,8750,6.8
De Soto,11/1/1993,10020,9257,763,7.6,129711,121169,8542,6.6
De Soto,12/1/1993,9817,9072,745,7.6,129941,121464,8477,6.5
De Soto,1/1/1994,10001,9092,909,9.1,130596,121966,8630,6.6
De Soto,2/1/1994,10089,9295,794,7.9,130669,122086,8583,6.6
De Soto,3/1/1994,10615,9795,820,7.7,130400,121930,8470,6.5
De Soto,4/1/1994,10146,9378,768,7.6,130621,122290,8331,6.4
De Soto,5/1/1994,10110,9346,764,7.6,130779,122864,7915,6.1
De Soto,6/1/1994,10204,9299,905,8.9,130561,122634,7927,6.1
De Soto,7/1/1994,10350,9424,926,8.9,130652,122706,7946,6.1
De Soto,8/1/1994,10311,9369,942,9.1,131275,123342,7933,6
De Soto,9/1/1994,10152,9289,863,8.5,131421,123687,7734,5.9
De Soto,10/1/1994,10368,9535,833,8,131744,124112,7632,5.8
De Soto,11/1/1994,10333,9523,810,7.8,131891,124516,7375,5.6
De Soto,12/1/1994,10399,9699,700,6.7,131951,124721,7230,5.5
De Soto,1/1/1995,11463,10634,829,7.2,132038,124663,7375,5.6
De Soto,2/1/1995,11816,11073,743,6.3,132115,124928,7187,5.4
De Soto,3/1/1995,12190,11358,832,6.8,132108,124955,7153,5.4
De Soto,4/1/1995,12144,11318,826,6.8,132590,124945,7645,5.8
De Soto,5/1/1995,12184,11412,772,6.3,131851,124421,7430,5.6
De Soto,6/1/1995,12554,11713,841,6.7,131949,124522,7427,5.6
De Soto,7/1/1995,10722,9956,766,7.1,132343,124816,7527,5.7
De Soto,8/1/1995,10666,9893,773,7.2,132336,124852,7484,5.7
De Soto,9/1/1995,10719,9871,848,7.9,132611,125133,7478,5.6
De Soto,10/1/1995,10695,9967,728,6.8,132716,125388,7328,5.5
De Soto,11/1/1995,10372,9574,798,7.7,132614,125188,7426,5.6
De Soto,12/1/1995,10348,9460,888,8.6,132511,125088,7423,5.6
De Soto,1/1/1996,10779,9707,1072,9.9,132616,125125,7491,5.6
De Soto,2/1/1996,10672,9704,968,9.1,132952,125639,7313,5.5
De Soto,3/1/1996,10942,9845,1097,10,133180,125862,7318,5.5
De Soto,4/1/1996,10792,9818,974,9,133409,125994,7415,5.6
De Soto,5/1/1996,10588,9522,1066,10.1,133667,126244,7423,5.6
De Soto,6/1/1996,10723,9618,1105,10.3,133697,126602,7095,5.3
De Soto,7/1/1996,11236,10210,1026,9.1,134284,126947,7337,5.5
De Soto,8/1/1996,11026,10069,957,8.7,134054,127172,6882,5.1
De Soto,9/1/1996,11038,10136,902,8.2,134515,127536,6979,5.2
De Soto,10/1/1996,10747,9913,834,7.8,134921,127890,7031,5.2
De Soto,11/1/1996,10808,10017,791,7.3,135007,127771,7236,5.4
De Soto,12/1/1996,10647,9881,766,7.2,135113,127860,7253,5.4
De Soto,1/1/1997,10716,9729,987,9.2,135456,128298,7158,5.3
De Soto,2/1/1997,11091,9793,1298,11.7,135400,128298,7102,5.2
De Soto,3/1/1997,11389,9954,1435,12.6,135891,128891,7000,5.2
De Soto,4/1/1997,11023,10060,963,8.7,136016,129143,6873,5.1
De Soto,5/1/1997,11245,10193,1052,9.4,136119,129464,6655,4.9
De Soto,6/1/1997,11184,10101,1083,9.7,136211,129412,6799,5
De Soto,7/1/1997,11136,10176,960,8.6,136477,129822,6655,4.9
De Soto,8/1/1997,11186,10249,937,8.4,136618,130010,6608,4.8
De Soto,9/1/1997,10701,9847,854,8,136675,130019,6656,4.9
De Soto,10/1/1997,10922,10167,755,6.9,136633,130179,6454,4.7
De Soto,11/1/1997,10757,10128,629,5.8,136961,130653,6308,4.6
De Soto,12/1/1997,10275,9641,634,6.2,137155,130679,6476,4.7
De Soto,1/1/1998,10392,9657,735,7.1,137095,130726,6368,4.6
De Soto,2/1/1998,10358,9732,626,6,137112,130807,6306,4.6
De Soto,3/1/1998,10472,9788,684,6.5,137236,130814,6422,4.7
De Soto,4/1/1998,10599,9934,665,6.3,137150,131209,5941,4.3
De Soto,5/1/1998,10975,10250,725,6.6,137372,131325,6047,4.4
De Soto,6/1/1998,11097,10077,1020,9.2,137455,131244,6212,4.5
De Soto,7/1/1998,11176,10208,968,8.7,137588,131329,6259,4.5
De Soto,8/1/1998,10929,10174,755,6.9,137570,131390,6179,4.5
De Soto,9/1/1998,10806,10039,767,7.1,138286,131986,6300,4.6
De Soto,10/1/1998,10958,10283,675,6.2,138279,131999,6280,4.5
De Soto,11/1/1998,10797,10192,605,5.6,138381,132280,6100,4.4
De Soto,12/1/1998,10794,10198,596,5.5,138634,132602,6032,4.4
De Soto,1/1/1999,11108,10383,725,6.5,139003,133027,5976,4.3
De Soto,2/1/1999,10943,10323,620,5.7,138967,132856,6111,4.4
De Soto,3/1/1999,11020,10457,563,5.1,138730,132947,5783,4.2
De Soto,4/1/1999,11153,10596,557,5,138959,132955,6004,4.3
De Soto,5/1/1999,11165,10606,559,5,139107,133311,5796,4.2
De Soto,6/1/1999,11456,10716,740,6.5,139329,133378,5951,4.3
De Soto,7/1/1999,11505,10758,747,6.5,139439,133414,6025,4.3
De Soto,8/1/1999,11381,10652,729,6.4,139430,133591,5838,4.2
De Soto,9/1/1999,11241,10490,751,6.7,139622,133707,5915,4.2
De Soto,10/1/1999,11128,10416,712,6.4,139771,133993,5778,4.1
De Soto,11/1/1999,10917,10289,628,5.8,140025,134309,5716,4.1
De Soto,12/1/1999,10709,10123,586,5.5,140177,134523,5653,4
De Soto,1/1/2000,10743,10050,693,6.5,142267,136559,5708,4
De Soto,2/1/2000,10697,10073,624,5.8,142456,136598,5858,4.1
De Soto,3/1/2000,10736,10133,603,5.6,142434,136701,5733,4
De Soto,4/1/2000,10667,10120,547,5.1,142751,137270,5481,3.8
De Soto,5/1/2000,10601,9993,608,5.7,142388,136630,5758,4
De Soto,6/1/2000,10757,10082,675,6.3,142591,136940,5651,4
De Soto,7/1/2000,10841,10196,645,5.9,142278,136531,5747,4
De Soto,8/1/2000,10825,10154,671,6.2,142514,136662,5853,4.1
De Soto,9/1/2000,10692,10052,640,6,142518,136893,5625,3.9
De Soto,10/1/2000,10842,10170,672,6.2,142622,137088,5534,3.9
De Soto,11/1/2000,10796,10119,677,6.3,142962,137322,5639,3.9
De Soto,12/1/2000,10781,10096,685,6.4,143248,137614,5634,3.9
De Soto,1/1/2001,10939,10088,851,7.8,143800,137778,6023,4.2
De Soto,2/1/2001,10813,10132,681,6.3,143701,137612,6089,4.2
De Soto,3/1/2001,10839,10137,702,6.5,143924,137783,6141,4.3
De Soto,4/1/2001,10819,10126,693,6.4,143569,137299,6271,4.4
De Soto,5/1/2001,10680,10014,666,6.2,143318,137092,6226,4.3
De Soto,6/1/2001,10862,10122,740,6.8,143357,136873,6484,4.5
De Soto,7/1/2001,10832,10162,670,6.2,143654,137071,6583,4.6
De Soto,8/1/2001,10731,10031,700,6.5,143284,136241,7042,4.9
De Soto,9/1/2001,10703,9937,766,7.2,143989,136846,7142,5
De Soto,10/1/2001,10655,9937,718,6.7,144086,136392,7694,5.3
De Soto,11/1/2001,10607,9860,747,7,144240,136238,8003,5.5
De Soto,12/1/2001,10603,9790,813,7.7,144305,136047,8258,5.7
De Soto,1/1/2002,10712,9699,1013,9.5,143883,135701,8182,5.7
De Soto,2/1/2002,10657,9830,827,7.8,144653,136438,8215,5.7
De Soto,3/1/2002,10727,9824,903,8.4,144481,136177,8304,5.7
De Soto,4/1/2002,10728,9872,856,8,144725,136126,8599,5.9
De Soto,5/1/2002,10634,9815,819,7.7,144938,136539,8399,5.8
De Soto,6/1/2002,11064,9912,1152,10.4,144808,136415,8393,5.8
De Soto,7/1/2002,10823,10006,817,7.5,144803,136413,8390,5.8
De Soto,8/1/2002,10790,9980,810,7.5,145009,136705,8304,5.7
De Soto,9/1/2002,10749,9952,797,7.4,145552,137302,8251,5.7
De Soto,10/1/2002,10828,9926,902,8.3,145314,137008,8307,5.7
De Soto,11/1/2002,10841,9843,998,9.2,145041,136521,8520,5.9
De Soto,12/1/2002,10669,9796,873,8.2,145066,136426,8640,6
De Soto,1/1/2003,10617,9659,958,9,145937,137417,8520,5.8
De Soto,2/1/2003,10584,9715,869,8.2,146100,137482,8618,5.9
De Soto,3/1/2003,10710,9752,958,8.9,146022,137434,8588,5.9
De Soto,4/1/2003,10752,9795,957,8.9,146474,137633,8842,6
De Soto,5/1/2003,10745,9811,934,8.7,146500,137544,8957,6.1
De Soto,6/1/2003,11014,9939,1075,9.8,147056,137790,9266,6.3
De Soto,7/1/2003,10986,10031,955,8.7,146485,137474,9011,6.2
De Soto,8/1/2003,10952,9989,963,8.8,146445,137549,8896,6.1
De Soto,9/1/2003,10815,9928,887,8.2,146530,137609,8921,6.1
De Soto,10/1/2003,10750,9990,760,7.1,146716,137984,8732,6
De Soto,11/1/2003,10804,10050,754,7,147000,138424,8576,5.8
De Soto,12/1/2003,10848,10075,773,7.1,146729,138411,8317,5.7
De Soto,1/1/2004,10808,9921,887,8.2,146842,138472,8370,5.7
De Soto,2/1/2004,10736,9960,776,7.2,146709,138542,8167,5.6
De Soto,3/1/2004,10865,9988,877,8.1,146944,138453,8491,5.8
De Soto,4/1/2004,10920,10115,805,7.4,146850,138680,8170,5.6
De Soto,5/1/2004,10940,10100,840,7.7,147065,138852,8212,5.6
De Soto,6/1/2004,11164,10245,919,8.2,147460,139174,8286,5.6
De Soto,7/1/2004,11229,10388,841,7.5,147692,139556,8136,5.5
De Soto,8/1/2004,11061,10330,731,6.6,147564,139573,7990,5.4
De Soto,9/1/2004,11015,10297,718,6.5,147415,139487,7927,5.4
De Soto,10/1/2004,11010,10337,673,6.1,147793,139732,8061,5.5
De Soto,11/1/2004,11021,10353,668,6.1,148162,140231,7932,5.4
De Soto,12/1/2004,11191,10370,821,7.3,148059,140125,7934,5.4
De Soto,1/1/2005,11176,10279,897,8,148029,140245,7784,5.3
De Soto,2/1/2005,11033,10305,728,6.6,148364,140385,7980,5.4
De Soto,3/1/2005,11063,10365,698,6.3,148391,140654,7737,5.2
De Soto,4/1/2005,11123,10456,667,6,148926,141254,7672,5.2
De Soto,5/1/2005,11139,10442,697,6.3,149261,141609,7651,5.1
De Soto,6/1/2005,11291,10490,801,7.1,149238,141714,7524,5
De Soto,7/1/2005,11340,10525,815,7.2,149432,142026,7406,5
De Soto,8/1/2005,11279,10530,749,6.6,149779,142434,7345,4.9
De Soto,9/1/2005,12027,11217,810,6.7,149954,142401,7553,5
De Soto,10/1/2005,12139,11401,738,6.1,150001,142548,7453,5
De Soto,11/1/2005,12148,11358,790,6.5,150065,142499,7566,5
De Soto,12/1/2005,12137,11248,889,7.3,150030,142752,7279,4.9
De Soto,1/1/2006,11524,11016,508,4.4,150214,143150,7064,4.7
De Soto,2/1/2006,11444,11027,417,3.6,150641,143457,7184,4.8
De Soto,3/1/2006,11459,11008,451,3.9,150813,143741,7072,4.7
De Soto,4/1/2006,11385,10930,455,4,150881,143761,7120,4.7
De Soto,5/1/2006,11471,10957,514,4.5,151069,144089,6980,4.6
De Soto,6/1/2006,11657,11071,586,5,151354,144353,7001,4.6
De Soto,7/1/2006,11611,11048,563,4.8,151377,144202,7175,4.7
De Soto,8/1/2006,11464,10932,532,4.6,151716,144625,7091,4.7
De Soto,9/1/2006,11396,10795,601,5.3,151662,144815,6847,4.5
De Soto,10/1/2006,11410,10816,594,5.2,152041,145314,6727,4.4
De Soto,11/1/2006,11392,10805,587,5.2,152406,145534,6872,4.5
De Soto,12/1/2006,11286,10750,536,4.7,152732,145970,6762,4.4
De Soto,1/1/2007,11196,10532,664,5.9,153144,146028,7116,4.6
De Soto,2/1/2007,11168,10606,562,5,152983,146057,6927,4.5
De Soto,3/1/2007,11285,10715,570,5.1,153051,146320,6731,4.4
De Soto,4/1/2007,11359,10768,591,5.2,152435,145586,6850,4.5
De Soto,5/1/2007,11354,10732,622,5.5,152670,145903,6766,4.4
De Soto,6/1/2007,11518,10851,667,5.8,153041,146063,6979,4.6
De Soto,7/1/2007,11606,10963,643,5.5,153054,145905,7149,4.7
De Soto,8/1/2007,11480,10884,596,5.2,152749,145682,7067,4.6
De Soto,9/1/2007,11450,10808,642,5.6,153414,146244,7170,4.7
De Soto,10/1/2007,11455,10793,662,5.8,153183,145946,7237,4.7
De Soto,11/1/2007,11594,10892,702,6.1,153835,146595,7240,4.7
De Soto,12/1/2007,11534,10874,660,5.7,153918,146273,7645,5
De Soto,1/1/2008,11598,10714,884,7.6,154063,146378,7685,5
De Soto,2/1/2008,11580,10771,809,7,153653,146156,7497,4.9
De Soto,3/1/2008,11633,10819,814,7,153908,146086,7822,5.1
De Soto,4/1/2008,11644,10901,743,6.4,153769,146132,7637,5
De Soto,5/1/2008,11627,10853,774,6.7,154303,145908,8395,5.4
De Soto,6/1/2008,11926,10994,932,7.8,154313,145737,8575,5.6
De Soto,7/1/2008,11962,11111,851,7.1,154469,145532,8937,5.8
De Soto,8/1/2008,12035,11251,784,6.5,154641,145203,9438,6.1
De Soto,9/1/2008,12018,11291,727,6,154570,145076,9494,6.1
De Soto,10/1/2008,11641,10883,758,6.5,154876,144802,10074,6.5
De Soto,11/1/2008,11576,10813,763,6.6,154639,144100,10538,6.8
De Soto,12/1/2008,11479,10737,742,6.5,154655,143369,11286,7.3
De Soto,1/1/2009,11497,10505,992,8.6,154210,142152,12058,7.8
De Soto,2/1/2009,11428,10484,944,8.3,154538,141640,12898,8.3
De Soto,3/1/2009,11476,10525,951,8.3,154133,140707,13426,8.7
De Soto,4/1/2009,11610,10662,948,8.2,154509,140656,13853,9
De Soto,5/1/2009,11490,10552,938,8.2,154747,140248,14499,9.4
De Soto,6/1/2009,11763,10674,1089,9.3,154716,140009,14707,9.5
De Soto,7/1/2009,11869,10751,1118,9.4,154502,139901,14601,9.5
De Soto,8/1/2009,11594,10620,974,8.4,154307,139492,14814,9.6
De Soto,9/1/2009,11499,10569,930,8.1,153827,138818,15009,9.8
De Soto,10/1/2009,11388,10503,885,7.8,153784,138432,15352,10
De Soto,11/1/2009,11467,10605,862,7.5,153878,138659,15219,9.9
De Soto,12/1/2009,11357,10474,883,7.8,153111,138013,15098,9.9
De Soto,1/1/2010,11186,10225,961,8.6,153484,138438,15046,9.8
De Soto,2/1/2010,11154,10267,887,8,153694,138581,15113,9.8
De Soto,3/1/2010,11233,10381,852,7.6,153954,138751,15202,9.9
De Soto,4/1/2010,11402,10550,852,7.5,154622,139297,15325,9.9
De Soto,5/1/2010,11432,10503,929,8.1,154091,139241,14849,9.6
De Soto,6/1/2010,11619,10594,1025,8.8,153616,139141,14474,9.4
De Soto,7/1/2010,11704,10677,1027,8.8,153691,139179,14512,9.4
De Soto,8/1/2010,11519,10526,993,8.6,154086,139438,14648,9.5
De Soto,9/1/2010,11438,10470,968,8.5,153975,139396,14579,9.5
De Soto,10/1/2010,11479,10528,951,8.3,153635,139119,14516,9.4
De Soto,11/1/2010,11405,10481,924,8.1,154125,139044,15081,9.8
De Soto,12/1/2010,11313,10443,870,7.7,153650,139301,14348,9.3
De Soto,1/1/2011,11203,10217,986,8.8,153263,139250,14013,9.1
De Soto,2/1/2011,11177,10285,892,8,153214,139394,13820,9
De Soto,3/1/2011,11231,10365,866,7.7,153376,139639,13737,9
De Soto,4/1/2011,11229,10410,819,7.3,153543,139586,13957,9.1
De Soto,5/1/2011,11256,10380,876,7.8,153479,139624,13855,9
De Soto,6/1/2011,11355,10394,961,8.5,153346,139384,13962,9.1
De Soto,7/1/2011,11438,10523,915,8,153288,139524,13763,9
De Soto,8/1/2011,11516,10458,1058,9.2,153760,139942,13818,9
De Soto,9/1/2011,11298,10417,881,7.8,154131,140183,13948,9
De Soto,10/1/2011,11237,10387,850,7.6,153961,140368,13594,8.8
De Soto,11/1/2011,11223,10432,791,7,154128,140826,13302,8.6
De Soto,12/1/2011,11224,10354,870,7.8,153995,140902,13093,8.5
De Soto,1/1/2012,11216,10208,1008,9,154381,141584,12797,8.3
De Soto,2/1/2012,11203,10263,940,8.4,154671,141858,12813,8.3
De Soto,3/1/2012,11227,10307,920,8.2,154749,142036,12713,8.2
De Soto,4/1/2012,11246,10370,876,7.8,154545,141899,12646,8.2
De Soto,5/1/2012,11329,10343,986,8.7,154866,142206,12660,8.2
De Soto,6/1/2012,11479,10369,1110,9.7,155083,142391,12692,8.2
De Soto,7/1/2012,11515,10433,1082,9.4,154948,142292,12656,8.2
De Soto,8/1/2012,11279,10288,991,8.8,154763,142291,12471,8.1
De Soto,9/1/2012,11166,10214,952,8.5,155160,143044,12115,7.8
De Soto,10/1/2012,11182,10268,914,8.2,155554,143431,12124,7.8
De Soto,11/1/2012,11078,10237,841,7.6,155338,143333,12005,7.7
De Soto,12/1/2012,11050,10153,897,8.1,155628,143330,12298,7.9
De Soto,1/1/2013,11019,9960,1059,9.6,155763,143292,12471,8
De Soto,2/1/2013,10968,9967,1001,9.1,155312,143362,11950,7.7
De Soto,3/1/2013,10989,10012,977,8.9,155005,143316,11689,7.5
De Soto,4/1/2013,11072,10147,925,8.4,155394,143635,11760,7.6
De Soto,5/1/2013,11078,10142,936,8.4,155536,143882,11654,7.5
De Soto,6/1/2013,11264,10198,1066,9.5,155749,143999,11751,7.5
De Soto,7/1/2013,11239,10247,992,8.8,155599,144264,11335,7.3
De Soto,8/1/2013,11035,10087,948,8.6,155605,144326,11279,7.2
De Soto,9/1/2013,10950,10034,916,8.4,155687,144418,11270,7.2
De Soto,10/1/2013,10836,9990,846,7.8,154673,143537,11136,7.2
De Soto,11/1/2013,10848,10065,783,7.2,155265,144479,10787,6.9
De Soto,12/1/2013,10757,10040,717,6.7,155182,144778,10404,6.7
De Soto,1/1/2014,10784,10010,774,7.2,155352,145150,10202,6.6
De Soto,2/1/2014,10799,10054,745,6.9,155483,145134,10349,6.7
De Soto,3/1/2014,10894,10127,767,7,156028,145648,10380,6.7
De Soto,4/1/2014,10883,10180,703,6.5,155369,145667,9702,6.2
De Soto,5/1/2014,10949,10143,806,7.4,155684,145825,9859,6.3
De Soto,6/1/2014,11144,10225,919,8.2,155707,146247,9460,6.1
De Soto,7/1/2014,11304,10321,983,8.7,156007,146399,9608,6.2
De Soto,8/1/2014,11216,10207,1009,9,156130,146530,9599,6.1
De Soto,9/1/2014,11191,10177,1014,9.1,156040,146778,9262,5.9
De Soto,10/1/2014,11193,10246,947,8.5,156417,147427,8990,5.7
De Soto,11/1/2014,11215,10250,965,8.6,156494,147404,9090,5.8
De Soto,12/1/2014,11130,10229,901,8.1,156332,147615,8717,5.6
De Soto,1/1/2015,11126,10121,1005,9,157030,148145,8885,5.7
De Soto,2/1/2015,11053,10150,903,8.2,156644,148045,8599,5.5
De Soto,3/1/2015,11081,10189,892,8,156643,148128,8515,5.4
De Soto,4/1/2015,11110,10254,856,7.7,157060,148511,8550,5.4
De Soto,5/1/2015,11065,10188,877,7.9,157651,148817,8834,5.6
De Soto,6/1/2015,11175,10220,955,8.5,157062,148816,8247,5.3
De Soto,7/1/2015,11199,10264,935,8.3,156997,148830,8167,5.2
De Soto,8/1/2015,10997,10151,846,7.7,157172,149181,7992,5.1
De Soto,9/1/2015,10922,10067,855,7.8,156733,148826,7907,5
De Soto,10/1/2015,10860,10039,821,7.6,157167,149246,7922,5
De Soto,11/1/2015,10828,10071,757,7,157463,149463,8000,5.1
De Soto,12/1/2015,10800,10082,718,6.6,158035,150128,7907,5
De Soto,1/1/2016,10897,10067,830,7.6,158280,150653,7627,4.8
De Soto,2/1/2016,10954,10142,812,7.4,158640,150939,7702,4.9
De Soto,3/1/2016,11000,10175,825,7.5,159179,151218,7961,5
De Soto,4/1/2016,10931,10167,764,7,159141,151074,8067,5.1
De Soto,5/1/2016,10903,10135,768,7,158784,151132,7652,4.8
De Soto,6/1/2016,11082,10184,898,8.1,158967,151223,7744,4.9
De Soto,7/1/2016,11030,10172,858,7.8,159194,151554,7641,4.8
De Soto,8/1/2016,10865,10042,823,7.6,159562,151779,7784,4.9
De Soto,9/1/2016,10803,9994,809,7.5,159714,151761,7953,5
De Soto,10/1/2016,10730,9975,755,7,159605,151793,7811,4.9
De Soto,11/1/2016,10757,10037,720,6.7,159506,151954,7553,4.7
De Soto,12/1/2016,10675,9979,696,6.5,159678,152157,7521,4.7
De Soto,1/1/2017,10752,9981,771,7.2,159620,152152,7468,4.7
De Soto,2/1/2017,10708,10011,697,6.5,159859,152480,7379,4.6
De Soto,3/1/2017,10799,10113,686,6.4,160137,153065,7073,4.4
De Soto,4/1/2017,10761,10106,655,6.1,160345,153255,7089,4.4
De Soto,5/1/2017,10690,10033,657,6.1,160068,153069,7000,4.4
De Soto,6/1/2017,10879,10160,719,6.6,160192,153318,6873,4.3
De Soto,7/1/2017,10936,10249,687,6.3,160462,153569,6892,4.3
De Soto,8/1/2017,10819,10145,674,6.2,160586,153503,7082,4.4
De Soto,9/1/2017,10819,10190,629,5.8,161140,154286,6854,4.3
De Soto,10/1/2017,10707,10137,570,5.3,160309,153609,6700,4.2
De Soto,11/1/2017,10696,10151,545,5.1,160579,153805,6774,4.2
De Soto,12/1/2017,10680,10144,536,5,160535,153904,6632,4.1
De Soto,1/1/2018,10807,10213,594,5.5,160914,154425,6489,4
De Soto,2/1/2018,10861,10284,577,5.3,161778,155197,6581,4.1
De Soto,3/1/2018,10893,10319,574,5.3,161686,155214,6472,4
De Soto,4/1/2018,10905,10351,554,5.1,161771,155312,6459,4
De Soto,5/1/2018,10917,10300,617,5.7,161848,155652,6196,3.8
De Soto,6/1/2018,11092,10328,764,6.9,162210,155762,6447,4
De Soto,7/1/2018,11113,10406,707,6.4,162341,156146,6195,3.8
De Soto,8/1/2018,10885,10221,664,6.1,161660,155504,6156,3.8
De Soto,9/1/2018,10794,10186,608,5.6,162087,156015,6073,3.7
De Soto,10/1/2018,10827,10220,607,5.6,162602,156391,6211,3.8
De Soto,11/1/2018,10802,10238,564,5.2,162836,156721,6115,3.8
De Soto,12/1/2018,10748,10192,556,5.2,163206,156817,6389,3.9
De Soto,1/1/2019,10858,10202,656,6,162963,156487,6475,4
De Soto,2/1/2019,10863,10293,570,5.2,162999,156863,6136,3.8
De Soto,3/1/2019,10906,10351,555,5.1,162904,156701,6202,3.8
De Soto,4/1/2019,10840,10318,522,4.8,162586,156625,5961,3.7
De Soto,5/1/2019,10846,10273,573,5.3,162751,156821,5930,3.6
De Soto,6/1/2019,10990,10305,685,6.2,163168,157232,5935,3.6
De Soto,7/1/2019,11078,10374,704,6.4,163590,157529,6061,3.7
De Soto,8/1/2019,10968,10286,682,6.2,163774,157829,5945,3.6
De Soto,9/1/2019,10954,10295,659,6,164092,158339,5753,3.5
De Soto,10/1/2019,10923,10262,661,6.1,164416,158545,5871,3.6
De Soto,11/1/2019,10925,10276,649,5.9,164496,158629,5868,3.6
De Soto,12/1/2019,10835,10211,624,5.8,164699,158845,5853,3.6
De Soto,1/1/2020,10902,10231,671,6.2,164377,158508,5869,3.6
De Soto,2/1/2020,10828,10276,552,5.1,164467,158714,5753,3.5
De Soto,3/1/2020,11094,10169,925,8.3,162559,155353,7206,4.4
De Soto,4/1/2020,9889,8964,925,9.4,156269,133185,23084,14.8
De Soto,5/1/2020,10044,9099,945,9.4,158101,137173,20929,13.2
De Soto,6/1/2020,10559,9565,994,9.4,159994,142342,17652,11
De Soto,7/1/2020,10653,9696,957,9,160132,143779,16352,10.2
De Soto,8/1/2020,10636,9812,824,7.7,160706,147245,13461,8.4
De Soto,9/1/2020,10696,9864,832,7.8,160174,147620,12554,7.8
De Soto,10/1/2020,10767,10027,740,6.9,161003,149931,11072,6.9
De Soto,11/1/2020,10697,10038,659,6.2,160629,149934,10694,6.7
De Soto,12/1/2020,10647,9962,685,6.4,160745,149975,10770,6.7
De Soto,1/1/2021,10554,9866,688,6.5,160088,149852,10236,6.4
De Soto,2/1/2021,10577,9928,649,6.1,160184,150189,9995,6.2
De Soto,3/1/2021,10639,10024,615,5.8,160400,150644,9756,6.1
De Soto,4/1/2021,10630,10057,573,5.4,160843,151081,9762,6.1
De Soto,5/1/2021,10583,10018,565,5.3,160800,151535,9266,5.8
De Soto,6/1/2021,10809,10136,673,6.2,161197,151734,9462,5.9
De Soto,7/1/2021,10795,10220,575,5.3,161504,152773,8731,5.4
De Soto,8/1/2021,10643,10125,518,4.9,161527,153250,8276,5.1
De Soto,9/1/2021,10845,10385,460,4.2,161495,153843,7652,4.7
De Soto,10/1/2021,10668,10243,425,4,161754,154475,7279,4.5
De Soto,11/1/2021,10695,10311,384,3.6,162281,155530,6751,4.2
De Soto,12/1/2021,10670,10327,343,3.2,162497,156099,6398,3.9
De Soto,1/1/2022,10724,10296,428,4,163627,157115,6512,4
De Soto,2/1/2022,10763,10358,405,3.8,163899,157598,6301,3.8
De Soto,3/1/2022,10819,10429,390,3.6,164220,158206,6014,3.7
De Soto,4/1/2022,10808,10444,364,3.4,163893,157891,6002,3.7
De Soto,5/1/2022,10804,10408,396,3.7,164362,158378,5983,3.6
De Soto,6/1/2022,11009,10496,513,4.7,164046,158094,5951,3.6
De Soto,7/1/2022,11014,10542,472,4.3,164026,158258,5768,3.5
De Soto,8/1/2022,10822,10368,454,4.2,164654,158735,5919,3.6
De Soto,9/1/2022,10806,10381,425,3.9,164602,158810,5792,3.5
De Soto,10/1/2022,10782,10399,383,3.6,164648,158684,5964,3.6
De Soto,11/1/2022,10801,10428,373,3.5,164450,158507,5943,3.6
De Soto,12/1/2022,10769,10396,373,3.5,165025,159259,5766,3.5
De Soto,1/1/2023,10816,10368,448,4.1,165964,160217,5747,3.5
De Soto,2/1/2023,10875,10457,418,3.8,166358,160395,5962,3.6
De Soto,3/1/2023,10897,10500,397,3.6,166651,160812,5839,3.5
De Soto,4/1/2023,10928,10570,358,3.3,166725,160974,5751,3.4
De Soto,5/1/2023,10871,10455,416,3.8,166886,160796,6089,3.6
De Soto,6/1/2023,11016,10525,491,4.5,166937,160979,5958,3.6
De Soto,7/1/2023,11014,10561,453,4.1,167103,161183,5920,3.5
De Soto,8/1/2023,10878,10381,497,4.6,167759,161475,6284,3.7
De Soto,9/1/2023,10864,10354,510,4.7,167767,161442,6326,3.8
De Soto,10/1/2023,10866,10368,498,4.6,167690,161211,6479,3.9
De Soto,11/1/2023,10880,10394,486,4.5,168140,161886,6254,3.7
De Soto,12/1/2023,10805,10324,481,4.5,167439,161124,6315,3.8
De Soto,1/1/2024,10801,10268,533,4.9,167339,161190,6149,3.7
De Soto,2/1/2024,10780,10260,520,4.8,167475,161013,6462,3.9
De Soto,3/1/2024,10910,10393,517,4.7,167922,161425,6497,3.9
De Soto,4/1/2024,10881,10419,462,4.2,167988,161495,6492,3.9
De Soto,5/1/2024,10797,10293,504,4.7,167799,161164,6635,4
De Soto,6/1/2024,11037,10437,600,5.4,168005,161155,6849,4.1
De Soto,7/1/2024,11077,10483,594,5.4,168315,161219,7097,4.2
De Soto,8/1/2024,10907,10329,578,5.3,168496,161425,7071,4.2
De Soto,9/1/2024,10889,10325,564,5.2,168703,161802,6901,4.1
De Soto,10/1/2024,10911,10326,585,5.4,168428,161456,6972,4.1
De Soto,11/1/2024,10876,10316,560,5.1,168304,161183,7121,4.2
De Soto,12/1/2024,10834,10312,522,4.8,168547,161661,6886,4.1
De Soto,1/1/2025,10828,10291,537,5,170744,163895,6849,4
De Soto,2/1/2025,10871,10356,515,4.7,170359,163307,7052,4.1
East Baton Rouge,1/1/1990,188019,179649,8370,4.5,125833,119081,6752,5.4
East Baton Rouge,2/1/1990,190028,182403,7625,4,125710,119059,6651,5.3
East Baton Rouge,3/1/1990,191481,183809,7672,4,125801,119203,6598,5.2
East Baton Rouge,4/1/1990,191496,183798,7698,4,125649,118852,6797,5.4
East Baton Rouge,5/1/1990,191868,183472,8396,4.4,125893,119151,6742,5.4
East Baton Rouge,6/1/1990,196477,185483,10994,5.6,125573,118983,6590,5.2
East Baton Rouge,7/1/1990,197681,187153,10528,5.3,125732,118810,6922,5.5
East Baton Rouge,8/1/1990,194882,183850,11032,5.7,125990,118802,7188,5.7
East Baton Rouge,9/1/1990,195125,183622,11503,5.9,125892,118524,7368,5.9
East Baton Rouge,10/1/1990,196369,185889,10480,5.3,125995,118536,7459,5.9
East Baton Rouge,11/1/1990,196792,186980,9812,5,126070,118306,7764,6.2
East Baton Rouge,12/1/1990,196401,186430,9971,5.1,126142,118241,7901,6.3
East Baton Rouge,1/1/1991,191333,181268,10065,5.3,125955,117940,8015,6.4
East Baton Rouge,2/1/1991,193711,184195,9516,4.9,126020,117755,8265,6.6
East Baton Rouge,3/1/1991,195032,185741,9291,4.8,126238,117652,8586,6.8
East Baton Rouge,4/1/1991,197134,187396,9738,4.9,126548,118109,8439,6.7
East Baton Rouge,5/1/1991,195333,184667,10666,5.5,126176,117440,8736,6.9
East Baton Rouge,6/1/1991,201194,187972,13222,6.6,126331,117639,8692,6.9
East Baton Rouge,7/1/1991,203020,190849,12171,6,126154,117568,8586,6.8
East Baton Rouge,8/1/1991,198480,186821,11659,5.9,126150,117484,8666,6.9
East Baton Rouge,9/1/1991,200550,189413,11137,5.6,126650,117928,8722,6.9
East Baton Rouge,10/1/1991,199617,189098,10519,5.3,126642,117800,8842,7
East Baton Rouge,11/1/1991,199038,189503,9535,4.8,126701,117770,8931,7
East Baton Rouge,12/1/1991,197501,188596,8905,4.5,126664,117466,9198,7.3
East Baton Rouge,1/1/1992,194404,184730,9674,5,127261,117978,9283,7.3
East Baton Rouge,2/1/1992,196567,188135,8432,4.3,127207,117753,9454,7.4
East Baton Rouge,3/1/1992,198234,189896,8338,4.2,127604,118144,9460,7.4
East Baton Rouge,4/1/1992,198755,190725,8030,4,127841,118426,9415,7.4
East Baton Rouge,5/1/1992,198153,189416,8737,4.4,128119,118375,9744,7.6
East Baton Rouge,6/1/1992,204056,192896,11160,5.5,128459,118419,10040,7.8
East Baton Rouge,7/1/1992,211463,200980,10483,5,128563,118713,9850,7.7
East Baton Rouge,8/1/1992,208731,198006,10725,5.1,128613,118826,9787,7.6
East Baton Rouge,9/1/1992,206499,196382,10117,4.9,128501,118720,9781,7.6
East Baton Rouge,10/1/1992,205505,196286,9219,4.5,128026,118628,9398,7.3
East Baton Rouge,11/1/1992,204327,195649,8678,4.2,128441,118876,9565,7.4
East Baton Rouge,12/1/1992,198157,189587,8570,4.3,128554,118997,9557,7.4
East Baton Rouge,1/1/1993,193566,183994,9572,4.9,128400,119075,9325,7.3
East Baton Rouge,2/1/1993,195680,187111,8569,4.4,128458,119275,9183,7.1
East Baton Rouge,3/1/1993,195983,187291,8692,4.4,128598,119542,9056,7
East Baton Rouge,4/1/1993,197043,188183,8860,4.5,128584,119474,9110,7.1
East Baton Rouge,5/1/1993,197505,187830,9675,4.9,129264,120115,9149,7.1
East Baton Rouge,6/1/1993,200430,188872,11558,5.8,129411,120290,9121,7
East Baton Rouge,7/1/1993,201124,190169,10955,5.4,129397,120467,8930,6.9
East Baton Rouge,8/1/1993,197958,186853,11105,5.6,129619,120856,8763,6.8
East Baton Rouge,9/1/1993,198166,187338,10828,5.5,129268,120554,8714,6.7
East Baton Rouge,10/1/1993,199391,188608,10783,5.4,129573,120823,8750,6.8
East Baton Rouge,11/1/1993,199989,189928,10061,5,129711,121169,8542,6.6
East Baton Rouge,12/1/1993,197709,188072,9637,4.9,129941,121464,8477,6.5
East Baton Rouge,1/1/1994,195043,183550,11493,5.9,130596,121966,8630,6.6
East Baton Rouge,2/1/1994,197551,187255,10296,5.2,130669,122086,8583,6.6
East Baton Rouge,3/1/1994,197634,187222,10412,5.3,130400,121930,8470,6.5
East Baton Rouge,4/1/1994,196527,185992,10535,5.4,130621,122290,8331,6.4
East Baton Rouge,5/1/1994,196542,185997,10545,5.4,130779,122864,7915,6.1
East Baton Rouge,6/1/1994,201687,188350,13337,6.6,130561,122634,7927,6.1
East Baton Rouge,7/1/1994,203265,190506,12759,6.3,130652,122706,7946,6.1
East Baton Rouge,8/1/1994,202628,189414,13214,6.5,131275,123342,7933,6
East Baton Rouge,9/1/1994,203972,191637,12335,6,131421,123687,7734,5.9
East Baton Rouge,10/1/1994,203651,191829,11822,5.8,131744,124112,7632,5.8
East Baton Rouge,11/1/1994,203290,192758,10532,5.2,131891,124516,7375,5.6
East Baton Rouge,12/1/1994,200214,190946,9268,4.6,131951,124721,7230,5.5
East Baton Rouge,1/1/1995,196702,185859,10843,5.5,132038,124663,7375,5.6
East Baton Rouge,2/1/1995,198069,188885,9184,4.6,132115,124928,7187,5.4
East Baton Rouge,3/1/1995,199502,190244,9258,4.6,132108,124955,7153,5.4
East Baton Rouge,4/1/1995,199760,189925,9835,4.9,132590,124945,7645,5.8
East Baton Rouge,5/1/1995,197857,188259,9598,4.9,131851,124421,7430,5.6
East Baton Rouge,6/1/1995,201687,189847,11840,5.9,131949,124522,7427,5.6
East Baton Rouge,7/1/1995,204013,193297,10716,5.3,132343,124816,7527,5.7
East Baton Rouge,8/1/1995,201081,189905,11176,5.6,132336,124852,7484,5.7
East Baton Rouge,9/1/1995,201560,190549,11011,5.5,132611,125133,7478,5.6
East Baton Rouge,10/1/1995,202953,192872,10081,5,132716,125388,7328,5.5
East Baton Rouge,11/1/1995,203096,194041,9055,4.5,132614,125188,7426,5.6
East Baton Rouge,12/1/1995,199474,190814,8660,4.3,132511,125088,7423,5.6
East Baton Rouge,1/1/1996,195472,185311,10161,5.2,132616,125125,7491,5.6
East Baton Rouge,2/1/1996,198341,189564,8777,4.4,132952,125639,7313,5.5
East Baton Rouge,3/1/1996,200261,191789,8472,4.2,133180,125862,7318,5.5
East Baton Rouge,4/1/1996,199411,190747,8664,4.3,133409,125994,7415,5.6
East Baton Rouge,5/1/1996,200357,191021,9336,4.7,133667,126244,7423,5.6
East Baton Rouge,6/1/1996,205020,193429,11591,5.7,133697,126602,7095,5.3
East Baton Rouge,7/1/1996,205981,194718,11263,5.5,134284,126947,7337,5.5
East Baton Rouge,8/1/1996,203880,193322,10558,5.2,134054,127172,6882,5.1
East Baton Rouge,9/1/1996,205733,195139,10594,5.1,134515,127536,6979,5.2
East Baton Rouge,10/1/1996,207181,197283,9898,4.8,134921,127890,7031,5.2
East Baton Rouge,11/1/1996,206730,197780,8950,4.3,135007,127771,7236,5.4
East Baton Rouge,12/1/1996,203473,195152,8321,4.1,135113,127860,7253,5.4
East Baton Rouge,1/1/1997,197108,187921,9187,4.7,135456,128298,7158,5.3
East Baton Rouge,2/1/1997,198568,190341,8227,4.1,135400,128298,7102,5.2
East Baton Rouge,3/1/1997,201807,193066,8741,4.3,135891,128891,7000,5.2
East Baton Rouge,4/1/1997,200577,192084,8493,4.2,136016,129143,6873,5.1
East Baton Rouge,5/1/1997,199034,189954,9080,4.6,136119,129464,6655,4.9
East Baton Rouge,6/1/1997,203236,190980,12256,6,136211,129412,6799,5
East Baton Rouge,7/1/1997,203935,192586,11349,5.6,136477,129822,6655,4.9
East Baton Rouge,8/1/1997,201381,190670,10711,5.3,136618,130010,6608,4.8
East Baton Rouge,9/1/1997,202465,192078,10387,5.1,136675,130019,6656,4.9
East Baton Rouge,10/1/1997,203684,194415,9269,4.6,136633,130179,6454,4.7
East Baton Rouge,11/1/1997,204152,196132,8020,3.9,136961,130653,6308,4.6
East Baton Rouge,12/1/1997,202975,195470,7505,3.7,137155,130679,6476,4.7
East Baton Rouge,1/1/1998,196630,188229,8401,4.3,137095,130726,6368,4.6
East Baton Rouge,2/1/1998,198718,191616,7102,3.6,137112,130807,6306,4.6
East Baton Rouge,3/1/1998,200855,192868,7987,4,137236,130814,6422,4.7
East Baton Rouge,4/1/1998,202374,194888,7486,3.7,137150,131209,5941,4.3
East Baton Rouge,5/1/1998,202494,194215,8279,4.1,137372,131325,6047,4.4
East Baton Rouge,6/1/1998,205067,195040,10027,4.9,137455,131244,6212,4.5
East Baton Rouge,7/1/1998,206329,196964,9365,4.5,137588,131329,6259,4.5
East Baton Rouge,8/1/1998,205271,195754,9517,4.6,137570,131390,6179,4.5
East Baton Rouge,9/1/1998,205911,196912,8999,4.4,138286,131986,6300,4.6
East Baton Rouge,10/1/1998,206784,199281,7503,3.6,138279,131999,6280,4.5
East Baton Rouge,11/1/1998,206426,199904,6522,3.2,138381,132280,6100,4.4
East Baton Rouge,12/1/1998,205708,199535,6173,3,138634,132602,6032,4.4
East Baton Rouge,1/1/1999,200720,193451,7269,3.6,139003,133027,5976,4.3
East Baton Rouge,2/1/1999,203289,196889,6400,3.1,138967,132856,6111,4.4
East Baton Rouge,3/1/1999,203071,197042,6029,3,138730,132947,5783,4.2
East Baton Rouge,4/1/1999,204113,198114,5999,2.9,138959,132955,6004,4.3
East Baton Rouge,5/1/1999,203212,197104,6108,3,139107,133311,5796,4.2
East Baton Rouge,6/1/1999,207464,199146,8318,4,139329,133378,5951,4.3
East Baton Rouge,7/1/1999,209006,200931,8075,3.9,139439,133414,6025,4.3
East Baton Rouge,8/1/1999,208240,200302,7938,3.8,139430,133591,5838,4.2
East Baton Rouge,9/1/1999,209440,201239,8201,3.9,139622,133707,5915,4.2
East Baton Rouge,10/1/1999,210620,203161,7459,3.5,139771,133993,5778,4.1
East Baton Rouge,11/1/1999,210955,204564,6391,3,140025,134309,5716,4.1
East Baton Rouge,12/1/1999,209645,203630,6015,2.9,140177,134523,5653,4
East Baton Rouge,1/1/2000,205654,196397,9257,4.5,142267,136559,5708,4
East Baton Rouge,2/1/2000,206586,198581,8005,3.9,142456,136598,5858,4.1
East Baton Rouge,3/1/2000,207872,199372,8500,4.1,142434,136701,5733,4
East Baton Rouge,4/1/2000,209126,201541,7585,3.6,142751,137270,5481,3.8
East Baton Rouge,5/1/2000,206491,197754,8737,4.2,142388,136630,5758,4
East Baton Rouge,6/1/2000,210138,199252,10886,5.2,142591,136940,5651,4
East Baton Rouge,7/1/2000,205135,194943,10192,5,142278,136531,5747,4
East Baton Rouge,8/1/2000,205004,194771,10233,5,142514,136662,5853,4.1
East Baton Rouge,9/1/2000,204638,194753,9885,4.8,142518,136893,5625,3.9
East Baton Rouge,10/1/2000,204872,195364,9508,4.6,142622,137088,5534,3.9
East Baton Rouge,11/1/2000,205035,195815,9220,4.5,142962,137322,5639,3.9
East Baton Rouge,12/1/2000,204384,195628,8756,4.3,143248,137614,5634,3.9
East Baton Rouge,1/1/2001,203087,192413,10674,5.3,143800,137778,6023,4.2
East Baton Rouge,2/1/2001,201727,192643,9084,4.5,143701,137612,6089,4.2
East Baton Rouge,3/1/2001,202128,192488,9640,4.8,143924,137783,6141,4.3
East Baton Rouge,4/1/2001,203203,193693,9510,4.7,143569,137299,6271,4.4
East Baton Rouge,5/1/2001,202463,192898,9565,4.7,143318,137092,6226,4.3
East Baton Rouge,6/1/2001,205451,193551,11900,5.8,143357,136873,6484,4.5
East Baton Rouge,7/1/2001,202727,191854,10873,5.4,143654,137071,6583,4.6
East Baton Rouge,8/1/2001,201050,190279,10771,5.4,143284,136241,7042,4.9
East Baton Rouge,9/1/2001,202131,191104,11027,5.5,143989,136846,7142,5
East Baton Rouge,10/1/2001,204927,194025,10902,5.3,144086,136392,7694,5.3
East Baton Rouge,11/1/2001,204449,193735,10714,5.2,144240,136238,8003,5.5
East Baton Rouge,12/1/2001,203366,192958,10408,5.1,144305,136047,8258,5.7
East Baton Rouge,1/1/2002,198147,186867,11280,5.7,143883,135701,8182,5.7
East Baton Rouge,2/1/2002,198676,189271,9405,4.7,144653,136438,8215,5.7
East Baton Rouge,3/1/2002,198624,188889,9735,4.9,144481,136177,8304,5.7
East Baton Rouge,4/1/2002,200515,190788,9727,4.9,144725,136126,8599,5.9
East Baton Rouge,5/1/2002,199100,189003,10097,5.1,144938,136539,8399,5.8
East Baton Rouge,6/1/2002,202973,190425,12548,6.2,144808,136415,8393,5.8
East Baton Rouge,7/1/2002,201058,189644,11414,5.7,144803,136413,8390,5.8
East Baton Rouge,8/1/2002,200459,189345,11114,5.5,145009,136705,8304,5.7
East Baton Rouge,9/1/2002,201479,190630,10849,5.4,145552,137302,8251,5.7
East Baton Rouge,10/1/2002,202614,192247,10367,5.1,145314,137008,8307,5.7
East Baton Rouge,11/1/2002,201421,190918,10503,5.2,145041,136521,8520,5.9
East Baton Rouge,12/1/2002,199947,189463,10484,5.2,145066,136426,8640,6
East Baton Rouge,1/1/2003,198345,186492,11853,6,145937,137417,8520,5.8
East Baton Rouge,2/1/2003,200317,189854,10463,5.2,146100,137482,8618,5.9
East Baton Rouge,3/1/2003,200465,189445,11020,5.5,146022,137434,8588,5.9
East Baton Rouge,4/1/2003,202618,192028,10590,5.2,146474,137633,8842,6
East Baton Rouge,5/1/2003,201171,189785,11386,5.7,146500,137544,8957,6.1
East Baton Rouge,6/1/2003,204255,189482,14773,7.2,147056,137790,9266,6.3
East Baton Rouge,7/1/2003,204219,190835,13384,6.6,146485,137474,9011,6.2
East Baton Rouge,8/1/2003,201932,189493,12439,6.2,146445,137549,8896,6.1
East Baton Rouge,9/1/2003,201598,189753,11845,5.9,146530,137609,8921,6.1
East Baton Rouge,10/1/2003,203588,192646,10942,5.4,146716,137984,8732,6
East Baton Rouge,11/1/2003,202686,192167,10519,5.2,147000,138424,8576,5.8
East Baton Rouge,12/1/2003,201126,190845,10281,5.1,146729,138411,8317,5.7
East Baton Rouge,1/1/2004,200244,188101,12143,6.1,146842,138472,8370,5.7
East Baton Rouge,2/1/2004,201245,191088,10157,5,146709,138542,8167,5.6
East Baton Rouge,3/1/2004,203349,192515,10834,5.3,146944,138453,8491,5.8
East Baton Rouge,4/1/2004,203369,192981,10388,5.1,146850,138680,8170,5.6
East Baton Rouge,5/1/2004,201353,190343,11010,5.5,147065,138852,8212,5.6
East Baton Rouge,6/1/2004,205601,192288,13313,6.5,147460,139174,8286,5.6
East Baton Rouge,7/1/2004,205521,193231,12290,6,147692,139556,8136,5.5
East Baton Rouge,8/1/2004,203689,192566,11123,5.5,147564,139573,7990,5.4
East Baton Rouge,9/1/2004,203501,192496,11005,5.4,147415,139487,7927,5.4
East Baton Rouge,10/1/2004,205080,194356,10724,5.2,147793,139732,8061,5.5
East Baton Rouge,11/1/2004,205988,195672,10316,5,148162,140231,7932,5.4
East Baton Rouge,12/1/2004,204611,194421,10190,5,148059,140125,7934,5.4
East Baton Rouge,1/1/2005,200489,189151,11338,5.7,148029,140245,7784,5.3
East Baton Rouge,2/1/2005,201962,191743,10219,5.1,148364,140385,7980,5.4
East Baton Rouge,3/1/2005,203214,193238,9976,4.9,148391,140654,7737,5.2
East Baton Rouge,4/1/2005,206143,196298,9845,4.8,148926,141254,7672,5.2
East Baton Rouge,5/1/2005,203750,193258,10492,5.1,149261,141609,7651,5.1
East Baton Rouge,6/1/2005,206399,193945,12454,6,149238,141714,7524,5
East Baton Rouge,7/1/2005,206483,195092,11391,5.5,149432,142026,7406,5
East Baton Rouge,8/1/2005,205744,195121,10623,5.2,149779,142434,7345,4.9
East Baton Rouge,9/1/2005,239166,210168,28998,12.1,149954,142401,7553,5
East Baton Rouge,10/1/2005,239093,213954,25139,10.5,150001,142548,7453,5
East Baton Rouge,11/1/2005,238842,214205,24637,10.3,150065,142499,7566,5
East Baton Rouge,12/1/2005,225349,211662,13687,6.1,150030,142752,7279,4.9
East Baton Rouge,1/1/2006,217323,206555,10768,5,150214,143150,7064,4.7
East Baton Rouge,2/1/2006,217467,209137,8330,3.8,150641,143457,7184,4.8
East Baton Rouge,3/1/2006,218134,209655,8479,3.9,150813,143741,7072,4.7
East Baton Rouge,4/1/2006,216834,208793,8041,3.7,150881,143761,7120,4.7
East Baton Rouge,5/1/2006,215669,207173,8496,3.9,151069,144089,6980,4.6
East Baton Rouge,6/1/2006,215963,205924,10039,4.6,151354,144353,7001,4.6
East Baton Rouge,7/1/2006,212959,204039,8920,4.2,151377,144202,7175,4.7
East Baton Rouge,8/1/2006,213375,204647,8728,4.1,151716,144625,7091,4.7
East Baton Rouge,9/1/2006,213613,204865,8748,4.1,151662,144815,6847,4.5
East Baton Rouge,10/1/2006,215996,207465,8531,3.9,152041,145314,6727,4.4
East Baton Rouge,11/1/2006,215788,207419,8369,3.9,152406,145534,6872,4.5
East Baton Rouge,12/1/2006,215453,207655,7798,3.6,152732,145970,6762,4.4
East Baton Rouge,1/1/2007,212201,203092,9109,4.3,153144,146028,7116,4.6
East Baton Rouge,2/1/2007,213316,205407,7909,3.7,152983,146057,6927,4.5
East Baton Rouge,3/1/2007,215834,207739,8095,3.8,153051,146320,6731,4.4
East Baton Rouge,4/1/2007,216171,208228,7943,3.7,152435,145586,6850,4.5
East Baton Rouge,5/1/2007,216365,207734,8631,4,152670,145903,6766,4.4
East Baton Rouge,6/1/2007,219594,209206,10388,4.7,153041,146063,6979,4.6
East Baton Rouge,7/1/2007,220402,210796,9606,4.4,153054,145905,7149,4.7
East Baton Rouge,8/1/2007,217449,208626,8823,4.1,152749,145682,7067,4.6
East Baton Rouge,9/1/2007,218697,210001,8696,4,153414,146244,7170,4.7
East Baton Rouge,10/1/2007,219358,211732,7626,3.5,153183,145946,7237,4.7
East Baton Rouge,11/1/2007,220257,212748,7509,3.4,153835,146595,7240,4.7
East Baton Rouge,12/1/2007,219383,211558,7825,3.6,153918,146273,7645,5
East Baton Rouge,1/1/2008,212865,203940,8925,4.2,154063,146378,7685,5
East Baton Rouge,2/1/2008,213147,205671,7476,3.5,153653,146156,7497,4.9
East Baton Rouge,3/1/2008,215280,207111,8169,3.8,153908,146086,7822,5.1
East Baton Rouge,4/1/2008,216321,209051,7270,3.4,153769,146132,7637,5
East Baton Rouge,5/1/2008,216091,207675,8416,3.9,154303,145908,8395,5.4
East Baton Rouge,6/1/2008,220652,209931,10721,4.9,154313,145737,8575,5.6
East Baton Rouge,7/1/2008,220503,210094,10409,4.7,154469,145532,8937,5.8
East Baton Rouge,8/1/2008,218662,207888,10774,4.9,154641,145203,9438,6.1
East Baton Rouge,9/1/2008,220222,208265,11957,5.4,154570,145076,9494,6.1
East Baton Rouge,10/1/2008,221670,210815,10855,4.9,154876,144802,10074,6.5
East Baton Rouge,11/1/2008,221088,210689,10399,4.7,154639,144100,10538,6.8
East Baton Rouge,12/1/2008,220443,209651,10792,4.9,154655,143369,11286,7.3
East Baton Rouge,1/1/2009,216394,203794,12600,5.8,154210,142152,12058,7.8
East Baton Rouge,2/1/2009,217604,205507,12097,5.6,154538,141640,12898,8.3
East Baton Rouge,3/1/2009,218905,206449,12456,5.7,154133,140707,13426,8.7
East Baton Rouge,4/1/2009,219650,207608,12042,5.5,154509,140656,13853,9
East Baton Rouge,5/1/2009,218876,205690,13186,6,154747,140248,14499,9.4
East Baton Rouge,6/1/2009,221702,206103,15599,7,154716,140009,14707,9.5
East Baton Rouge,7/1/2009,223049,208435,14614,6.6,154502,139901,14601,9.5
East Baton Rouge,8/1/2009,221256,206714,14542,6.6,154307,139492,14814,9.6
East Baton Rouge,9/1/2009,220963,207404,13559,6.1,153827,138818,15009,9.8
East Baton Rouge,10/1/2009,220366,206788,13578,6.2,153784,138432,15352,10
East Baton Rouge,11/1/2009,220261,207452,12809,5.8,153878,138659,15219,9.9
East Baton Rouge,12/1/2009,217163,204139,13024,6,153111,138013,15098,9.9
East Baton Rouge,1/1/2010,219917,204675,15242,6.9,153484,138438,15046,9.8
East Baton Rouge,2/1/2010,219366,205539,13827,6.3,153694,138581,15113,9.8
East Baton Rouge,3/1/2010,221302,207164,14138,6.4,153954,138751,15202,9.9
East Baton Rouge,4/1/2010,222118,208107,14011,6.3,154622,139297,15325,9.9
East Baton Rouge,5/1/2010,221707,206402,15305,6.9,154091,139241,14849,9.6
East Baton Rouge,6/1/2010,224642,207018,17624,7.8,153616,139141,14474,9.4
East Baton Rouge,7/1/2010,224103,206750,17353,7.7,153691,139179,14512,9.4
East Baton Rouge,8/1/2010,223767,206513,17254,7.7,154086,139438,14648,9.5
East Baton Rouge,9/1/2010,223363,206644,16719,7.5,153975,139396,14579,9.5
East Baton Rouge,10/1/2010,223730,207522,16208,7.2,153635,139119,14516,9.4
East Baton Rouge,11/1/2010,223519,207470,16049,7.2,154125,139044,15081,9.8
East Baton Rouge,12/1/2010,221710,206351,15359,6.9,153650,139301,14348,9.3
East Baton Rouge,1/1/2011,221066,204024,17042,7.7,153263,139250,14013,9.1
East Baton Rouge,2/1/2011,221624,206038,15586,7,153214,139394,13820,9
East Baton Rouge,3/1/2011,223022,207488,15534,7,153376,139639,13737,9
East Baton Rouge,4/1/2011,222558,207771,14787,6.6,153543,139586,13957,9.1
East Baton Rouge,5/1/2011,221637,206046,15591,7,153479,139624,13855,9
East Baton Rouge,6/1/2011,223100,205157,17943,8,153346,139384,13962,9.1
East Baton Rouge,7/1/2011,222520,205351,17169,7.7,153288,139524,13763,9
East Baton Rouge,8/1/2011,220272,203952,16320,7.4,153760,139942,13818,9
East Baton Rouge,9/1/2011,222703,206750,15953,7.2,154131,140183,13948,9
East Baton Rouge,10/1/2011,224091,208948,15143,6.8,153961,140368,13594,8.8
East Baton Rouge,11/1/2011,223081,208906,14175,6.4,154128,140826,13302,8.6
East Baton Rouge,12/1/2011,221208,207174,14034,6.3,153995,140902,13093,8.5
East Baton Rouge,1/1/2012,220581,205067,15514,7,154381,141584,12797,8.3
East Baton Rouge,2/1/2012,222010,207507,14503,6.5,154671,141858,12813,8.3
East Baton Rouge,3/1/2012,223881,209550,14331,6.4,154749,142036,12713,8.2
East Baton Rouge,4/1/2012,223420,210081,13339,6,154545,141899,12646,8.2
East Baton Rouge,5/1/2012,223232,208643,14589,6.5,154866,142206,12660,8.2
East Baton Rouge,6/1/2012,226215,208874,17341,7.7,155083,142391,12692,8.2
East Baton Rouge,7/1/2012,223967,207697,16270,7.3,154948,142292,12656,8.2
East Baton Rouge,8/1/2012,222737,208100,14637,6.6,154763,142291,12471,8.1
East Baton Rouge,9/1/2012,224114,210887,13227,5.9,155160,143044,12115,7.8
East Baton Rouge,10/1/2012,225554,212686,12868,5.7,155554,143431,12124,7.8
East Baton Rouge,11/1/2012,224131,212407,11724,5.2,155338,143333,12005,7.7
East Baton Rouge,12/1/2012,222881,210190,12691,5.7,155628,143330,12298,7.9
East Baton Rouge,1/1/2013,221895,206776,15119,6.8,155763,143292,12471,8
East Baton Rouge,2/1/2013,222642,209361,13281,6,155312,143362,11950,7.7
East Baton Rouge,3/1/2013,224940,211708,13232,5.9,155005,143316,11689,7.5
East Baton Rouge,4/1/2013,226845,213915,12930,5.7,155394,143635,11760,7.6
East Baton Rouge,5/1/2013,227221,213145,14076,6.2,155536,143882,11654,7.5
East Baton Rouge,6/1/2013,229660,213165,16495,7.2,155749,143999,11751,7.5
East Baton Rouge,7/1/2013,228142,213182,14960,6.6,155599,144264,11335,7.3
East Baton Rouge,8/1/2013,226291,212446,13845,6.1,155605,144326,11279,7.2
East Baton Rouge,9/1/2013,227361,214288,13073,5.7,155687,144418,11270,7.2
East Baton Rouge,10/1/2013,227146,214798,12348,5.4,154673,143537,11136,7.2
East Baton Rouge,11/1/2013,227156,215943,11213,4.9,155265,144479,10787,6.9
East Baton Rouge,12/1/2013,223674,213399,10275,4.6,155182,144778,10404,6.7
East Baton Rouge,1/1/2014,221960,210564,11396,5.1,155352,145150,10202,6.6
East Baton Rouge,2/1/2014,223957,213173,10784,4.8,155483,145134,10349,6.7
East Baton Rouge,3/1/2014,227269,215938,11331,5,156028,145648,10380,6.7
East Baton Rouge,4/1/2014,228002,217316,10686,4.7,155369,145667,9702,6.2
East Baton Rouge,5/1/2014,229904,217468,12436,5.4,155684,145825,9859,6.3
East Baton Rouge,6/1/2014,231962,217457,14505,6.3,155707,146247,9460,6.1
East Baton Rouge,7/1/2014,233422,218192,15230,6.5,156007,146399,9608,6.2
East Baton Rouge,8/1/2014,233414,218455,14959,6.4,156130,146530,9599,6.1
East Baton Rouge,9/1/2014,234622,220446,14176,6,156040,146778,9262,5.9
East Baton Rouge,10/1/2014,237539,223732,13807,5.8,156417,147427,8990,5.7
East Baton Rouge,11/1/2014,235812,222034,13778,5.8,156494,147404,9090,5.8
East Baton Rouge,12/1/2014,232377,219541,12836,5.5,156332,147615,8717,5.6
East Baton Rouge,1/1/2015,231253,216980,14273,6.2,157030,148145,8885,5.7
East Baton Rouge,2/1/2015,231864,218975,12889,5.6,156644,148045,8599,5.5
East Baton Rouge,3/1/2015,233500,220891,12609,5.4,156643,148128,8515,5.4
East Baton Rouge,4/1/2015,234507,222177,12330,5.3,157060,148511,8550,5.4
East Baton Rouge,5/1/2015,235255,222106,13149,5.6,157651,148817,8834,5.6
East Baton Rouge,6/1/2015,235894,221446,14448,6.1,157062,148816,8247,5.3
East Baton Rouge,7/1/2015,235963,222201,13762,5.8,156997,148830,8167,5.2
East Baton Rouge,8/1/2015,234084,221334,12750,5.4,157172,149181,7992,5.1
East Baton Rouge,9/1/2015,233659,221613,12046,5.2,156733,148826,7907,5
East Baton Rouge,10/1/2015,235246,223660,11586,4.9,157167,149246,7922,5
East Baton Rouge,11/1/2015,234523,223682,10841,4.6,157463,149463,8000,5.1
East Baton Rouge,12/1/2015,231349,221328,10021,4.3,158035,150128,7907,5
East Baton Rouge,1/1/2016,228911,217079,11832,5.2,158280,150653,7627,4.8
East Baton Rouge,2/1/2016,230977,220051,10926,4.7,158640,150939,7702,4.9
East Baton Rouge,3/1/2016,233478,222297,11181,4.8,159179,151218,7961,5
East Baton Rouge,4/1/2016,233089,222236,10853,4.7,159141,151074,8067,5.1
East Baton Rouge,5/1/2016,231768,220411,11357,4.9,158784,151132,7652,4.8
East Baton Rouge,6/1/2016,234633,220635,13998,6,158967,151223,7744,4.9
East Baton Rouge,7/1/2016,234765,221262,13503,5.8,159194,151554,7641,4.8
East Baton Rouge,8/1/2016,230243,217368,12875,5.6,159562,151779,7784,4.9
East Baton Rouge,9/1/2016,232989,219649,13340,5.7,159714,151761,7953,5
East Baton Rouge,10/1/2016,233667,221998,11669,5,159605,151793,7811,4.9
East Baton Rouge,11/1/2016,231849,220961,10888,4.7,159506,151954,7553,4.7
East Baton Rouge,12/1/2016,228443,217983,10460,4.6,159678,152157,7521,4.7
East Baton Rouge,1/1/2017,228598,216690,11908,5.2,159620,152152,7468,4.7
East Baton Rouge,2/1/2017,231256,220670,10586,4.6,159859,152480,7379,4.6
East Baton Rouge,3/1/2017,232234,221988,10246,4.4,160137,153065,7073,4.4
East Baton Rouge,4/1/2017,231993,221988,10005,4.3,160345,153255,7089,4.4
East Baton Rouge,5/1/2017,229491,219565,9926,4.3,160068,153069,7000,4.4
East Baton Rouge,6/1/2017,231120,219449,11671,5,160192,153318,6873,4.3
East Baton Rouge,7/1/2017,232478,221077,11401,4.9,160462,153569,6892,4.3
East Baton Rouge,8/1/2017,232056,221125,10931,4.7,160586,153503,7082,4.4
East Baton Rouge,9/1/2017,233412,223539,9873,4.2,161140,154286,6854,4.3
East Baton Rouge,10/1/2017,232750,224148,8602,3.7,160309,153609,6700,4.2
East Baton Rouge,11/1/2017,232661,224020,8641,3.7,160579,153805,6774,4.2
East Baton Rouge,12/1/2017,230185,222079,8106,3.5,160535,153904,6632,4.1
East Baton Rouge,1/1/2018,225935,216607,9328,4.1,160914,154425,6489,4
East Baton Rouge,2/1/2018,228953,220129,8824,3.9,161778,155197,6581,4.1
East Baton Rouge,3/1/2018,232022,222902,9120,3.9,161686,155214,6472,4
East Baton Rouge,4/1/2018,231720,222651,9069,3.9,161771,155312,6459,4
East Baton Rouge,5/1/2018,229744,220193,9551,4.2,161848,155652,6196,3.8
East Baton Rouge,6/1/2018,233629,220987,12642,5.4,162210,155762,6447,4
East Baton Rouge,7/1/2018,233466,221497,11969,5.1,162341,156146,6195,3.8
East Baton Rouge,8/1/2018,230209,219377,10832,4.7,161660,155504,6156,3.8
East Baton Rouge,9/1/2018,231108,221193,9915,4.3,162087,156015,6073,3.7
East Baton Rouge,10/1/2018,232853,223272,9581,4.1,162602,156391,6211,3.8
East Baton Rouge,11/1/2018,233130,224305,8825,3.8,162836,156721,6115,3.8
East Baton Rouge,12/1/2018,231149,222308,8841,3.8,163206,156817,6389,3.9
East Baton Rouge,1/1/2019,229098,218509,10589,4.6,162963,156487,6475,4
East Baton Rouge,2/1/2019,230242,221500,8742,3.8,162999,156863,6136,3.8
East Baton Rouge,3/1/2019,230834,222671,8163,3.5,162904,156701,6202,3.8
East Baton Rouge,4/1/2019,229529,221855,7674,3.3,162586,156625,5961,3.7
East Baton Rouge,5/1/2019,228465,219469,8996,3.9,162751,156821,5930,3.6
East Baton Rouge,6/1/2019,230718,219116,11602,5,163168,157232,5935,3.6
East Baton Rouge,7/1/2019,229890,218460,11430,5,163590,157529,6061,3.7
East Baton Rouge,8/1/2019,228556,217667,10889,4.8,163774,157829,5945,3.6
East Baton Rouge,9/1/2019,229470,219335,10135,4.4,164092,158339,5753,3.5
East Baton Rouge,10/1/2019,230917,220786,10131,4.4,164416,158545,5871,3.6
East Baton Rouge,11/1/2019,231499,221762,9737,4.2,164496,158629,5868,3.6
East Baton Rouge,12/1/2019,227711,218478,9233,4.1,164699,158845,5853,3.6
East Baton Rouge,1/1/2020,224275,214293,9982,4.5,164377,158508,5869,3.6
East Baton Rouge,2/1/2020,224906,216860,8046,3.6,164467,158714,5753,3.5
East Baton Rouge,3/1/2020,228803,214044,14759,6.5,162559,155353,7206,4.4
East Baton Rouge,4/1/2020,212042,186055,25987,12.3,156269,133185,23084,14.8
East Baton Rouge,5/1/2020,217947,191468,26479,12.1,158101,137173,20929,13.2
East Baton Rouge,6/1/2020,223762,198067,25695,11.5,159994,142342,17652,11
East Baton Rouge,7/1/2020,225538,201173,24365,10.8,160132,143779,16352,10.2
East Baton Rouge,8/1/2020,225319,205909,19410,8.6,160706,147245,13461,8.4
East Baton Rouge,9/1/2020,228215,208742,19473,8.5,160174,147620,12554,7.8
East Baton Rouge,10/1/2020,230293,213350,16943,7.4,161003,149931,11072,6.9
East Baton Rouge,11/1/2020,227459,212776,14683,6.5,160629,149934,10694,6.7
East Baton Rouge,12/1/2020,225650,211105,14545,6.4,160745,149975,10770,6.7
East Baton Rouge,1/1/2021,223819,208691,15128,6.8,160088,149852,10236,6.4
East Baton Rouge,2/1/2021,225233,211463,13770,6.1,160184,150189,9995,6.2
East Baton Rouge,3/1/2021,226841,213774,13067,5.8,160400,150644,9756,6.1
East Baton Rouge,4/1/2021,228316,214821,13495,5.9,160843,151081,9762,6.1
East Baton Rouge,5/1/2021,227714,214131,13583,6,160800,151535,9266,5.8
East Baton Rouge,6/1/2021,227594,211831,15763,6.9,161197,151734,9462,5.9
East Baton Rouge,7/1/2021,227568,213634,13934,6.1,161504,152773,8731,5.4
East Baton Rouge,8/1/2021,226239,214308,11931,5.3,161527,153250,8276,5.1
East Baton Rouge,9/1/2021,230791,220363,10428,4.5,161495,153843,7652,4.7
East Baton Rouge,10/1/2021,230194,221106,9088,3.9,161754,154475,7279,4.5
East Baton Rouge,11/1/2021,231074,222849,8225,3.6,162281,155530,6751,4.2
East Baton Rouge,12/1/2021,228840,221520,7320,3.2,162497,156099,6398,3.9
East Baton Rouge,1/1/2022,229902,220772,9130,4,163627,157115,6512,4
East Baton Rouge,2/1/2022,232584,224501,8083,3.5,163899,157598,6301,3.8
East Baton Rouge,3/1/2022,233974,226277,7697,3.3,164220,158206,6014,3.7
East Baton Rouge,4/1/2022,232371,225219,7152,3.1,163893,157891,6002,3.7
East Baton Rouge,5/1/2022,231552,223857,7695,3.3,164362,158378,5983,3.6
East Baton Rouge,6/1/2022,232308,222261,10047,4.3,164046,158094,5951,3.6
East Baton Rouge,7/1/2022,232689,223292,9397,4,164026,158258,5768,3.5
East Baton Rouge,8/1/2022,232424,223516,8908,3.8,164654,158735,5919,3.6
East Baton Rouge,9/1/2022,231774,224059,7715,3.3,164602,158810,5792,3.5
East Baton Rouge,10/1/2022,231807,224722,7085,3.1,164648,158684,5964,3.6
East Baton Rouge,11/1/2022,231753,224902,6851,3,164450,158507,5943,3.6
East Baton Rouge,12/1/2022,230217,223473,6744,2.9,165025,159259,5766,3.5
East Baton Rouge,1/1/2023,229273,221260,8013,3.5,165964,160217,5747,3.5
East Baton Rouge,2/1/2023,231742,224372,7370,3.2,166358,160395,5962,3.6
East Baton Rouge,3/1/2023,234012,226987,7025,3,166651,160812,5839,3.5
East Baton Rouge,4/1/2023,232694,226215,6479,2.8,166725,160974,5751,3.4
East Baton Rouge,5/1/2023,231672,223962,7710,3.3,166886,160796,6089,3.6
East Baton Rouge,6/1/2023,232060,222509,9551,4.1,166937,160979,5958,3.6
East Baton Rouge,7/1/2023,231973,223728,8245,3.6,167103,161183,5920,3.5
East Baton Rouge,8/1/2023,232669,224011,8658,3.7,167759,161475,6284,3.7
East Baton Rouge,9/1/2023,234136,225807,8329,3.6,167767,161442,6326,3.8
East Baton Rouge,10/1/2023,235430,226966,8464,3.6,167690,161211,6479,3.9
East Baton Rouge,11/1/2023,236267,228203,8064,3.4,168140,161886,6254,3.7
East Baton Rouge,12/1/2023,233270,225151,8119,3.5,167439,161124,6315,3.8
East Baton Rouge,1/1/2024,232673,223469,9204,4,167339,161190,6149,3.7
East Baton Rouge,2/1/2024,234345,225702,8643,3.7,167475,161013,6462,3.9
East Baton Rouge,3/1/2024,237503,229012,8491,3.6,167922,161425,6497,3.9
East Baton Rouge,4/1/2024,236513,228678,7835,3.3,167988,161495,6492,3.9
East Baton Rouge,5/1/2024,234989,226713,8276,3.5,167799,161164,6635,4
East Baton Rouge,6/1/2024,235480,224693,10787,4.6,168005,161155,6849,4.1
East Baton Rouge,7/1/2024,236176,225498,10678,4.5,168315,161219,7097,4.2
East Baton Rouge,8/1/2024,235449,224989,10460,4.4,168496,161425,7071,4.2
East Baton Rouge,9/1/2024,234212,224590,9622,4.1,168703,161802,6901,4.1
East Baton Rouge,10/1/2024,235495,225971,9524,4,168428,161456,6972,4.1
East Baton Rouge,11/1/2024,235355,226156,9199,3.9,168304,161183,7121,4.2
East Baton Rouge,12/1/2024,233513,224955,8558,3.7,168547,161661,6886,4.1
East Baton Rouge,1/1/2025,221576,212316,9260,4.2,170744,163895,6849,4
East Baton Rouge,2/1/2025,223688,214876,8812,3.9,170359,163307,7052,4.1
East Carroll,1/1/1990,3172,2573,599,18.9,125833,119081,6752,5.4
East Carroll,2/1/1990,3041,2510,531,17.5,125710,119059,6651,5.3
East Carroll,3/1/1990,3107,2608,499,16.1,125801,119203,6598,5.2
East Carroll,4/1/1990,3053,2620,433,14.2,125649,118852,6797,5.4
East Carroll,5/1/1990,3201,2737,464,14.5,125893,119151,6742,5.4
East Carroll,6/1/1990,3259,2766,493,15.1,125573,118983,6590,5.2
East Carroll,7/1/1990,3134,2756,378,12.1,125732,118810,6922,5.5
East Carroll,8/1/1990,3097,2767,330,10.7,125990,118802,7188,5.7
East Carroll,9/1/1990,3107,2851,256,8.2,125892,118524,7368,5.9
East Carroll,10/1/1990,3161,2933,228,7.2,125995,118536,7459,5.9
East Carroll,11/1/1990,3154,2784,370,11.7,126070,118306,7764,6.2
East Carroll,12/1/1990,3184,2645,539,16.9,126142,118241,7901,6.3
East Carroll,1/1/1991,3238,2518,720,22.2,125955,117940,8015,6.4
East Carroll,2/1/1991,3331,2563,768,23.1,126020,117755,8265,6.6
East Carroll,3/1/1991,3359,2637,722,21.5,126238,117652,8586,6.8
East Carroll,4/1/1991,3444,2750,694,20.2,126548,118109,8439,6.7
East Carroll,5/1/1991,3517,2800,717,20.4,126176,117440,8736,6.9
East Carroll,6/1/1991,3573,2869,704,19.7,126331,117639,8692,6.9
East Carroll,7/1/1991,3539,2987,552,15.6,126154,117568,8586,6.8
East Carroll,8/1/1991,3386,2956,430,12.7,126150,117484,8666,6.9
East Carroll,9/1/1991,3217,2853,364,11.3,126650,117928,8722,6.9
East Carroll,10/1/1991,3355,3054,301,9,126642,117800,8842,7
East Carroll,11/1/1991,3459,3006,453,13.1,126701,117770,8931,7
East Carroll,12/1/1991,3569,2900,669,18.7,126664,117466,9198,7.3
East Carroll,1/1/1992,3722,2859,863,23.2,127261,117978,9283,7.3
East Carroll,2/1/1992,3634,2912,722,19.9,127207,117753,9454,7.4
East Carroll,3/1/1992,3677,2995,682,18.5,127604,118144,9460,7.4
East Carroll,4/1/1992,3600,3027,573,15.9,127841,118426,9415,7.4
East Carroll,5/1/1992,3651,3060,591,16.2,128119,118375,9744,7.6
East Carroll,6/1/1992,3665,3044,621,16.9,128459,118419,10040,7.8
East Carroll,7/1/1992,3752,3262,490,13.1,128563,118713,9850,7.7
East Carroll,8/1/1992,3625,3204,421,11.6,128613,118826,9787,7.6
East Carroll,9/1/1992,3589,3238,351,9.8,128501,118720,9781,7.6
East Carroll,10/1/1992,3404,3151,253,7.4,128026,118628,9398,7.3
East Carroll,11/1/1992,3501,3132,369,10.5,128441,118876,9565,7.4
East Carroll,12/1/1992,3530,2993,537,15.2,128554,118997,9557,7.4
East Carroll,1/1/1993,3565,2978,587,16.5,128400,119075,9325,7.3
East Carroll,2/1/1993,3506,2963,543,15.5,128458,119275,9183,7.1
East Carroll,3/1/1993,3651,3084,567,15.5,128598,119542,9056,7
East Carroll,4/1/1993,3538,3001,537,15.2,128584,119474,9110,7.1
East Carroll,5/1/1993,3564,3039,525,14.7,129264,120115,9149,7.1
East Carroll,6/1/1993,3676,3061,615,16.7,129411,120290,9121,7
East Carroll,7/1/1993,3450,2953,497,14.4,129397,120467,8930,6.9
East Carroll,8/1/1993,3487,2981,506,14.5,129619,120856,8763,6.8
East Carroll,9/1/1993,3227,2862,365,11.3,129268,120554,8714,6.7
East Carroll,10/1/1993,3187,2896,291,9.1,129573,120823,8750,6.8
East Carroll,11/1/1993,3166,2883,283,8.9,129711,121169,8542,6.6
East Carroll,12/1/1993,3429,2884,545,15.9,129941,121464,8477,6.5
East Carroll,1/1/1994,3657,2879,778,21.3,130596,121966,8630,6.6
East Carroll,2/1/1994,3715,2950,765,20.6,130669,122086,8583,6.6
East Carroll,3/1/1994,3898,3130,768,19.7,130400,121930,8470,6.5
East Carroll,4/1/1994,3758,3084,674,17.9,130621,122290,8331,6.4
East Carroll,5/1/1994,3600,3046,554,15.4,130779,122864,7915,6.1
East Carroll,6/1/1994,3539,2930,609,17.2,130561,122634,7927,6.1
East Carroll,7/1/1994,3364,2793,571,17,130652,122706,7946,6.1
East Carroll,8/1/1994,3318,2781,537,16.2,131275,123342,7933,6
East Carroll,9/1/1994,3188,2786,402,12.6,131421,123687,7734,5.9
East Carroll,10/1/1994,3294,2964,330,10,131744,124112,7632,5.8
East Carroll,11/1/1994,3305,2959,346,10.5,131891,124516,7375,5.6
East Carroll,12/1/1994,3413,2846,567,16.6,131951,124721,7230,5.5
East Carroll,1/1/1995,3572,2845,727,20.4,132038,124663,7375,5.6
East Carroll,2/1/1995,3378,2845,533,15.8,132115,124928,7187,5.4
East Carroll,3/1/1995,3442,2902,540,15.7,132108,124955,7153,5.4
East Carroll,4/1/1995,3349,2873,476,14.2,132590,124945,7645,5.8
East Carroll,5/1/1995,3341,2880,461,13.8,131851,124421,7430,5.6
East Carroll,6/1/1995,3571,2998,573,16,131949,124522,7427,5.6
East Carroll,7/1/1995,3386,2900,486,14.4,132343,124816,7527,5.7
East Carroll,8/1/1995,3364,2916,448,13.3,132336,124852,7484,5.7
East Carroll,9/1/1995,3291,2914,377,11.5,132611,125133,7478,5.6
East Carroll,10/1/1995,3211,2893,318,9.9,132716,125388,7328,5.5
East Carroll,11/1/1995,3145,2698,447,14.2,132614,125188,7426,5.6
East Carroll,12/1/1995,3105,2593,512,16.5,132511,125088,7423,5.6
East Carroll,1/1/1996,3213,2603,610,19,132616,125125,7491,5.6
East Carroll,2/1/1996,3182,2606,576,18.1,132952,125639,7313,5.5
East Carroll,3/1/1996,3240,2702,538,16.6,133180,125862,7318,5.5
East Carroll,4/1/1996,3330,2787,543,16.3,133409,125994,7415,5.6
East Carroll,5/1/1996,3154,2623,531,16.8,133667,126244,7423,5.6
East Carroll,6/1/1996,3315,2707,608,18.3,133697,126602,7095,5.3
East Carroll,7/1/1996,3404,2856,548,16.1,134284,126947,7337,5.5
East Carroll,8/1/1996,3119,2664,455,14.6,134054,127172,6882,5.1
East Carroll,9/1/1996,3049,2697,352,11.5,134515,127536,6979,5.2
East Carroll,10/1/1996,2943,2678,265,9,134921,127890,7031,5.2
East Carroll,11/1/1996,2923,2536,387,13.2,135007,127771,7236,5.4
East Carroll,12/1/1996,2919,2459,460,15.8,135113,127860,7253,5.4
East Carroll,1/1/1997,2984,2476,508,17,135456,128298,7158,5.3
East Carroll,2/1/1997,3084,2567,517,16.8,135400,128298,7102,5.2
East Carroll,3/1/1997,3154,2636,518,16.4,135891,128891,7000,5.2
East Carroll,4/1/1997,3041,2572,469,15.4,136016,129143,6873,5.1
East Carroll,5/1/1997,3029,2601,428,14.1,136119,129464,6655,4.9
East Carroll,6/1/1997,3274,2727,547,16.7,136211,129412,6799,5
East Carroll,7/1/1997,3277,2814,463,14.1,136477,129822,6655,4.9
East Carroll,8/1/1997,3134,2725,409,13.1,136618,130010,6608,4.8
East Carroll,9/1/1997,3103,2737,366,11.8,136675,130019,6656,4.9
East Carroll,10/1/1997,2932,2644,288,9.8,136633,130179,6454,4.7
East Carroll,11/1/1997,2871,2596,275,9.6,136961,130653,6308,4.6
East Carroll,12/1/1997,3020,2580,440,14.6,137155,130679,6476,4.7
East Carroll,1/1/1998,3201,2574,627,19.6,137095,130726,6368,4.6
East Carroll,2/1/1998,3056,2578,478,15.6,137112,130807,6306,4.6
East Carroll,3/1/1998,3065,2577,488,15.9,137236,130814,6422,4.7
East Carroll,4/1/1998,2918,2572,346,11.9,137150,131209,5941,4.3
East Carroll,5/1/1998,2964,2640,324,10.9,137372,131325,6047,4.4
East Carroll,6/1/1998,3174,2690,484,15.2,137455,131244,6212,4.5
East Carroll,7/1/1998,3251,2780,471,14.5,137588,131329,6259,4.5
East Carroll,8/1/1998,3244,2741,503,15.5,137570,131390,6179,4.5
East Carroll,9/1/1998,3079,2703,376,12.2,138286,131986,6300,4.6
East Carroll,10/1/1998,2968,2670,298,10,138279,131999,6280,4.5
East Carroll,11/1/1998,2936,2654,282,9.6,138381,132280,6100,4.4
East Carroll,12/1/1998,3037,2653,384,12.6,138634,132602,6032,4.4
East Carroll,1/1/1999,3128,2581,547,17.5,139003,133027,5976,4.3
East Carroll,2/1/1999,2933,2461,472,16.1,138967,132856,6111,4.4
East Carroll,3/1/1999,2983,2574,409,13.7,138730,132947,5783,4.2
East Carroll,4/1/1999,2966,2599,367,12.4,138959,132955,6004,4.3
East Carroll,5/1/1999,2881,2570,311,10.8,139107,133311,5796,4.2
East Carroll,6/1/1999,3105,2676,429,13.8,139329,133378,5951,4.3
East Carroll,7/1/1999,3145,2744,401,12.8,139439,133414,6025,4.3
East Carroll,8/1/1999,3150,2770,380,12.1,139430,133591,5838,4.2
East Carroll,9/1/1999,3014,2712,302,10,139622,133707,5915,4.2
East Carroll,10/1/1999,2973,2700,273,9.2,139771,133993,5778,4.1
East Carroll,11/1/1999,2919,2671,248,8.5,140025,134309,5716,4.1
East Carroll,12/1/1999,2946,2596,350,11.9,140177,134523,5653,4
East Carroll,1/1/2000,3021,2684,337,11.2,142267,136559,5708,4
East Carroll,2/1/2000,2959,2650,309,10.4,142456,136598,5858,4.1
East Carroll,3/1/2000,2982,2696,286,9.6,142434,136701,5733,4
East Carroll,4/1/2000,3080,2817,263,8.5,142751,137270,5481,3.8
East Carroll,5/1/2000,3003,2753,250,8.3,142388,136630,5758,4
East Carroll,6/1/2000,3081,2773,308,10,142591,136940,5651,4
East Carroll,7/1/2000,3154,2864,290,9.2,142278,136531,5747,4
East Carroll,8/1/2000,3165,2838,327,10.3,142514,136662,5853,4.1
East Carroll,9/1/2000,3133,2875,258,8.2,142518,136893,5625,3.9
East Carroll,10/1/2000,3141,2904,237,7.5,142622,137088,5534,3.9
East Carroll,11/1/2000,3147,2853,294,9.3,142962,137322,5639,3.9
East Carroll,12/1/2000,3204,2882,322,10,143248,137614,5634,3.9
East Carroll,1/1/2001,3098,2663,435,14,143800,137778,6023,4.2
East Carroll,2/1/2001,3092,2696,396,12.8,143701,137612,6089,4.2
East Carroll,3/1/2001,3252,2832,420,12.9,143924,137783,6141,4.3
East Carroll,4/1/2001,3041,2695,346,11.4,143569,137299,6271,4.4
East Carroll,5/1/2001,3033,2686,347,11.4,143318,137092,6226,4.3
East Carroll,6/1/2001,3075,2684,391,12.7,143357,136873,6484,4.5
East Carroll,7/1/2001,3105,2711,394,12.7,143654,137071,6583,4.6
East Carroll,8/1/2001,3130,2737,393,12.6,143284,136241,7042,4.9
East Carroll,9/1/2001,3124,2811,313,10,143989,136846,7142,5
East Carroll,10/1/2001,3210,2931,279,8.7,144086,136392,7694,5.3
East Carroll,11/1/2001,3116,2809,307,9.9,144240,136238,8003,5.5
East Carroll,12/1/2001,3029,2678,351,11.6,144305,136047,8258,5.7
East Carroll,1/1/2002,3128,2669,459,14.7,143883,135701,8182,5.7
East Carroll,2/1/2002,3048,2676,372,12.2,144653,136438,8215,5.7
East Carroll,3/1/2002,3104,2712,392,12.6,144481,136177,8304,5.7
East Carroll,4/1/2002,3042,2668,374,12.3,144725,136126,8599,5.9
East Carroll,5/1/2002,3061,2720,341,11.1,144938,136539,8399,5.8
East Carroll,6/1/2002,3099,2678,421,13.6,144808,136415,8393,5.8
East Carroll,7/1/2002,3056,2677,379,12.4,144803,136413,8390,5.8
East Carroll,8/1/2002,3118,2738,380,12.2,145009,136705,8304,5.7
East Carroll,9/1/2002,3032,2733,299,9.9,145552,137302,8251,5.7
East Carroll,10/1/2002,3209,2928,281,8.8,145314,137008,8307,5.7
East Carroll,11/1/2002,3135,2829,306,9.8,145041,136521,8520,5.9
East Carroll,12/1/2002,3100,2762,338,10.9,145066,136426,8640,6
East Carroll,1/1/2003,3146,2687,459,14.6,145937,137417,8520,5.8
East Carroll,2/1/2003,2995,2555,440,14.7,146100,137482,8618,5.9
East Carroll,3/1/2003,3091,2621,470,15.2,146022,137434,8588,5.9
East Carroll,4/1/2003,3087,2692,395,12.8,146474,137633,8842,6
East Carroll,5/1/2003,3126,2725,401,12.8,146500,137544,8957,6.1
East Carroll,6/1/2003,3198,2705,493,15.4,147056,137790,9266,6.3
East Carroll,7/1/2003,3112,2662,450,14.5,146485,137474,9011,6.2
East Carroll,8/1/2003,3136,2731,405,12.9,146445,137549,8896,6.1
East Carroll,9/1/2003,3097,2768,329,10.6,146530,137609,8921,6.1
East Carroll,10/1/2003,3217,2924,293,9.1,146716,137984,8732,6
East Carroll,11/1/2003,3192,2862,330,10.3,147000,138424,8576,5.8
East Carroll,12/1/2003,3042,2677,365,12,146729,138411,8317,5.7
East Carroll,1/1/2004,3087,2595,492,15.9,146842,138472,8370,5.7
East Carroll,2/1/2004,2995,2584,411,13.7,146709,138542,8167,5.6
East Carroll,3/1/2004,2997,2576,421,14,146944,138453,8491,5.8
East Carroll,4/1/2004,2958,2587,371,12.5,146850,138680,8170,5.6
East Carroll,5/1/2004,2945,2582,363,12.3,147065,138852,8212,5.6
East Carroll,6/1/2004,2997,2548,449,15,147460,139174,8286,5.6
East Carroll,7/1/2004,3089,2652,437,14.1,147692,139556,8136,5.5
East Carroll,8/1/2004,3113,2702,411,13.2,147564,139573,7990,5.4
East Carroll,9/1/2004,2990,2622,368,12.3,147415,139487,7927,5.4
East Carroll,10/1/2004,3148,2799,349,11.1,147793,139732,8061,5.5
East Carroll,11/1/2004,3035,2695,340,11.2,148162,140231,7932,5.4
East Carroll,12/1/2004,2882,2513,369,12.8,148059,140125,7934,5.4
East Carroll,1/1/2005,2924,2467,457,15.6,148029,140245,7784,5.3
East Carroll,2/1/2005,2770,2379,391,14.1,148364,140385,7980,5.4
East Carroll,3/1/2005,2721,2343,378,13.9,148391,140654,7737,5.2
East Carroll,4/1/2005,2802,2469,333,11.9,148926,141254,7672,5.2
East Carroll,5/1/2005,2867,2532,335,11.7,149261,141609,7651,5.1
East Carroll,6/1/2005,2931,2573,358,12.2,149238,141714,7524,5
East Carroll,7/1/2005,2941,2575,366,12.4,149432,142026,7406,5
East Carroll,8/1/2005,2862,2533,329,11.5,149779,142434,7345,4.9
East Carroll,9/1/2005,3182,2674,508,16,149954,142401,7553,5
East Carroll,10/1/2005,3271,2845,426,13,150001,142548,7453,5
East Carroll,11/1/2005,3109,2689,420,13.5,150065,142499,7566,5
East Carroll,12/1/2005,2922,2608,314,10.7,150030,142752,7279,4.9
East Carroll,1/1/2006,3146,2853,293,9.3,150214,143150,7064,4.7
East Carroll,2/1/2006,3155,2898,257,8.1,150641,143457,7184,4.8
East Carroll,3/1/2006,3176,2931,245,7.7,150813,143741,7072,4.7
East Carroll,4/1/2006,3245,3006,239,7.4,150881,143761,7120,4.7
East Carroll,5/1/2006,3154,2916,238,7.5,151069,144089,6980,4.6
East Carroll,6/1/2006,3139,2874,265,8.4,151354,144353,7001,4.6
East Carroll,7/1/2006,3140,2863,277,8.8,151377,144202,7175,4.7
East Carroll,8/1/2006,3104,2846,258,8.3,151716,144625,7091,4.7
East Carroll,9/1/2006,3196,2967,229,7.2,151662,144815,6847,4.5
East Carroll,10/1/2006,3238,3019,219,6.8,152041,145314,6727,4.4
East Carroll,11/1/2006,3144,2916,228,7.3,152406,145534,6872,4.5
East Carroll,12/1/2006,3048,2808,240,7.9,152732,145970,6762,4.4
East Carroll,1/1/2007,3040,2729,311,10.2,153144,146028,7116,4.6
East Carroll,2/1/2007,3103,2804,299,9.6,152983,146057,6927,4.5
East Carroll,3/1/2007,3050,2791,259,8.5,153051,146320,6731,4.4
East Carroll,4/1/2007,3009,2752,257,8.5,152435,145586,6850,4.5
East Carroll,5/1/2007,2921,2672,249,8.5,152670,145903,6766,4.4
East Carroll,6/1/2007,2944,2635,309,10.5,153041,146063,6979,4.6
East Carroll,7/1/2007,3035,2671,364,12,153054,145905,7149,4.7
East Carroll,8/1/2007,3080,2772,308,10,152749,145682,7067,4.6
East Carroll,9/1/2007,3221,2922,299,9.3,153414,146244,7170,4.7
East Carroll,10/1/2007,3199,2943,256,8,153183,145946,7237,4.7
East Carroll,11/1/2007,3175,2933,242,7.6,153835,146595,7240,4.7
East Carroll,12/1/2007,3099,2793,306,9.9,153918,146273,7645,5
East Carroll,1/1/2008,3268,2928,340,10.4,154063,146378,7685,5
East Carroll,2/1/2008,3194,2899,295,9.2,153653,146156,7497,4.9
East Carroll,3/1/2008,3284,3008,276,8.4,153908,146086,7822,5.1
East Carroll,4/1/2008,3029,2777,252,8.3,153769,146132,7637,5
East Carroll,5/1/2008,2967,2723,244,8.2,154303,145908,8395,5.4
East Carroll,6/1/2008,2923,2622,301,10.3,154313,145737,8575,5.6
East Carroll,7/1/2008,2982,2652,330,11.1,154469,145532,8937,5.8
East Carroll,8/1/2008,3007,2670,337,11.2,154641,145203,9438,6.1
East Carroll,9/1/2008,2965,2665,300,10.1,154570,145076,9494,6.1
East Carroll,10/1/2008,3081,2774,307,10,154876,144802,10074,6.5
East Carroll,11/1/2008,3122,2795,327,10.5,154639,144100,10538,6.8
East Carroll,12/1/2008,2920,2550,370,12.7,154655,143369,11286,7.3
East Carroll,1/1/2009,3026,2561,465,15.4,154210,142152,12058,7.8
East Carroll,2/1/2009,2958,2566,392,13.3,154538,141640,12898,8.3
East Carroll,3/1/2009,2967,2602,365,12.3,154133,140707,13426,8.7
East Carroll,4/1/2009,3021,2656,365,12.1,154509,140656,13853,9
East Carroll,5/1/2009,3102,2738,364,11.7,154747,140248,14499,9.4
East Carroll,6/1/2009,3096,2692,404,13,154716,140009,14707,9.5
East Carroll,7/1/2009,3059,2661,398,13,154502,139901,14601,9.5
East Carroll,8/1/2009,2962,2602,360,12.2,154307,139492,14814,9.6
East Carroll,9/1/2009,2919,2543,376,12.9,153827,138818,15009,9.8
East Carroll,10/1/2009,2929,2565,364,12.4,153784,138432,15352,10
East Carroll,11/1/2009,2970,2609,361,12.2,153878,138659,15219,9.9
East Carroll,12/1/2009,2931,2547,384,13.1,153111,138013,15098,9.9
East Carroll,1/1/2010,2433,2046,387,15.9,153484,138438,15046,9.8
East Carroll,2/1/2010,2474,2092,382,15.4,153694,138581,15113,9.8
East Carroll,3/1/2010,2490,2104,386,15.5,153954,138751,15202,9.9
East Carroll,4/1/2010,2436,2088,348,14.3,154622,139297,15325,9.9
East Carroll,5/1/2010,2478,2096,382,15.4,154091,139241,14849,9.6
East Carroll,6/1/2010,2530,2076,454,17.9,153616,139141,14474,9.4
East Carroll,7/1/2010,2585,2116,469,18.1,153691,139179,14512,9.4
East Carroll,8/1/2010,2524,2097,427,16.9,154086,139438,14648,9.5
East Carroll,9/1/2010,2466,2030,436,17.7,153975,139396,14579,9.5
East Carroll,10/1/2010,2409,2006,403,16.7,153635,139119,14516,9.4
East Carroll,11/1/2010,2386,1968,418,17.5,154125,139044,15081,9.8
East Carroll,12/1/2010,2356,1924,432,18.3,153650,139301,14348,9.3
East Carroll,1/1/2011,2347,1886,461,19.6,153263,139250,14013,9.1
East Carroll,2/1/2011,2350,1900,450,19.1,153214,139394,13820,9
East Carroll,3/1/2011,2299,1887,412,17.9,153376,139639,13737,9
East Carroll,4/1/2011,2333,1959,374,16,153543,139586,13957,9.1
East Carroll,5/1/2011,2333,1958,375,16.1,153479,139624,13855,9
East Carroll,6/1/2011,2406,1951,455,18.9,153346,139384,13962,9.1
East Carroll,7/1/2011,2413,1996,417,17.3,153288,139524,13763,9
East Carroll,8/1/2011,2405,2007,398,16.5,153760,139942,13818,9
East Carroll,9/1/2011,2325,1945,380,16.3,154131,140183,13948,9
East Carroll,10/1/2011,2284,1931,353,15.5,153961,140368,13594,8.8
East Carroll,11/1/2011,2255,1915,340,15.1,154128,140826,13302,8.6
East Carroll,12/1/2011,2304,1918,386,16.8,153995,140902,13093,8.5
East Carroll,1/1/2012,2227,1795,432,19.4,154381,141584,12797,8.3
East Carroll,2/1/2012,2261,1843,418,18.5,154671,141858,12813,8.3
East Carroll,3/1/2012,2210,1788,422,19.1,154749,142036,12713,8.2
East Carroll,4/1/2012,2083,1684,399,19.2,154545,141899,12646,8.2
East Carroll,5/1/2012,2107,1689,418,19.8,154866,142206,12660,8.2
East Carroll,6/1/2012,2183,1692,491,22.5,155083,142391,12692,8.2
East Carroll,7/1/2012,2267,1765,502,22.1,154948,142292,12656,8.2
East Carroll,8/1/2012,2162,1715,447,20.7,154763,142291,12471,8.1
East Carroll,9/1/2012,2212,1792,420,19,155160,143044,12115,7.8
East Carroll,10/1/2012,2201,1830,371,16.9,155554,143431,12124,7.8
East Carroll,11/1/2012,2163,1821,342,15.8,155338,143333,12005,7.7
East Carroll,12/1/2012,2166,1801,365,16.9,155628,143330,12298,7.9
East Carroll,1/1/2013,2304,1875,429,18.6,155763,143292,12471,8
East Carroll,2/1/2013,2302,1883,419,18.2,155312,143362,11950,7.7
East Carroll,3/1/2013,2226,1826,400,18,155005,143316,11689,7.5
East Carroll,4/1/2013,2240,1874,366,16.3,155394,143635,11760,7.6
East Carroll,5/1/2013,2297,1937,360,15.7,155536,143882,11654,7.5
East Carroll,6/1/2013,2363,1939,424,17.9,155749,143999,11751,7.5
East Carroll,7/1/2013,2350,1961,389,16.6,155599,144264,11335,7.3
East Carroll,8/1/2013,2280,1927,353,15.5,155605,144326,11279,7.2
East Carroll,9/1/2013,2241,1883,358,16,155687,144418,11270,7.2
East Carroll,10/1/2013,2203,1892,311,14.1,154673,143537,11136,7.2
East Carroll,11/1/2013,2167,1873,294,13.6,155265,144479,10787,6.9
East Carroll,12/1/2013,2177,1869,308,14.1,155182,144778,10404,6.7
East Carroll,1/1/2014,2184,1867,317,14.5,155352,145150,10202,6.6
East Carroll,2/1/2014,2185,1867,318,14.6,155483,145134,10349,6.7
East Carroll,3/1/2014,2134,1833,301,14.1,156028,145648,10380,6.7
East Carroll,4/1/2014,2141,1858,283,13.2,155369,145667,9702,6.2
East Carroll,5/1/2014,2154,1845,309,14.3,155684,145825,9859,6.3
East Carroll,6/1/2014,2229,1879,350,15.7,155707,146247,9460,6.1
East Carroll,7/1/2014,2288,1946,342,14.9,156007,146399,9608,6.2
East Carroll,8/1/2014,2249,1932,317,14.1,156130,146530,9599,6.1
East Carroll,9/1/2014,2243,1923,320,14.3,156040,146778,9262,5.9
East Carroll,10/1/2014,2225,1919,306,13.8,156417,147427,8990,5.7
East Carroll,11/1/2014,2208,1893,315,14.3,156494,147404,9090,5.8
East Carroll,12/1/2014,2218,1895,323,14.6,156332,147615,8717,5.6
East Carroll,1/1/2015,2257,1879,378,16.7,157030,148145,8885,5.7
East Carroll,2/1/2015,2230,1876,354,15.9,156644,148045,8599,5.5
East Carroll,3/1/2015,2162,1820,342,15.8,156643,148128,8515,5.4
East Carroll,4/1/2015,2166,1861,305,14.1,157060,148511,8550,5.4
East Carroll,5/1/2015,2204,1889,315,14.3,157651,148817,8834,5.6
East Carroll,6/1/2015,2272,1926,346,15.2,157062,148816,8247,5.3
East Carroll,7/1/2015,2257,1937,320,14.2,156997,148830,8167,5.2
East Carroll,8/1/2015,2214,1931,283,12.8,157172,149181,7992,5.1
East Carroll,9/1/2015,2205,1918,287,13,156733,148826,7907,5
East Carroll,10/1/2015,2168,1899,269,12.4,157167,149246,7922,5
East Carroll,11/1/2015,2154,1903,251,11.7,157463,149463,8000,5.1
East Carroll,12/1/2015,2155,1910,245,11.4,158035,150128,7907,5
East Carroll,1/1/2016,2152,1883,269,12.5,158280,150653,7627,4.8
East Carroll,2/1/2016,2162,1899,263,12.2,158640,150939,7702,4.9
East Carroll,3/1/2016,2117,1875,242,11.4,159179,151218,7961,5
East Carroll,4/1/2016,2122,1886,236,11.1,159141,151074,8067,5.1
East Carroll,5/1/2016,2154,1919,235,10.9,158784,151132,7652,4.8
East Carroll,6/1/2016,2202,1923,279,12.7,158967,151223,7744,4.9
East Carroll,7/1/2016,2204,1937,267,12.1,159194,151554,7641,4.8
East Carroll,8/1/2016,2153,1917,236,11,159562,151779,7784,4.9
East Carroll,9/1/2016,2163,1920,243,11.2,159714,151761,7953,5
East Carroll,10/1/2016,2086,1864,222,10.6,159605,151793,7811,4.9
East Carroll,11/1/2016,2075,1863,212,10.2,159506,151954,7553,4.7
East Carroll,12/1/2016,2058,1808,250,12.1,159678,152157,7521,4.7
East Carroll,1/1/2017,2094,1804,290,13.8,159620,152152,7468,4.7
East Carroll,2/1/2017,2043,1772,271,13.3,159859,152480,7379,4.6
East Carroll,3/1/2017,2051,1798,253,12.3,160137,153065,7073,4.4
East Carroll,4/1/2017,2072,1825,247,11.9,160345,153255,7089,4.4
East Carroll,5/1/2017,2103,1862,241,11.5,160068,153069,7000,4.4
East Carroll,6/1/2017,2160,1903,257,11.9,160192,153318,6873,4.3
East Carroll,7/1/2017,2123,1888,235,11.1,160462,153569,6892,4.3
East Carroll,8/1/2017,2062,1850,212,10.3,160586,153503,7082,4.4
East Carroll,9/1/2017,2010,1816,194,9.7,161140,154286,6854,4.3
East Carroll,10/1/2017,1988,1799,189,9.5,160309,153609,6700,4.2
East Carroll,11/1/2017,1980,1797,183,9.2,160579,153805,6774,4.2
East Carroll,12/1/2017,1948,1781,167,8.6,160535,153904,6632,4.1
East Carroll,1/1/2018,1965,1763,202,10.3,160914,154425,6489,4
East Carroll,2/1/2018,1966,1755,211,10.7,161778,155197,6581,4.1
East Carroll,3/1/2018,1979,1780,199,10.1,161686,155214,6472,4
East Carroll,4/1/2018,1952,1760,192,9.8,161771,155312,6459,4
East Carroll,5/1/2018,1949,1766,183,9.4,161848,155652,6196,3.8
East Carroll,6/1/2018,2015,1778,237,11.8,162210,155762,6447,4
East Carroll,7/1/2018,1968,1750,218,11.1,162341,156146,6195,3.8
East Carroll,8/1/2018,1961,1751,210,10.7,161660,155504,6156,3.8
East Carroll,9/1/2018,1913,1731,182,9.5,162087,156015,6073,3.7
East Carroll,10/1/2018,1922,1744,178,9.3,162602,156391,6211,3.8
East Carroll,11/1/2018,1914,1745,169,8.8,162836,156721,6115,3.8
East Carroll,12/1/2018,1910,1710,200,10.5,163206,156817,6389,3.9
East Carroll,1/1/2019,1906,1689,217,11.4,162963,156487,6475,4
East Carroll,2/1/2019,1889,1690,199,10.5,162999,156863,6136,3.8
East Carroll,3/1/2019,1859,1680,179,9.6,162904,156701,6202,3.8
East Carroll,4/1/2019,1844,1679,165,8.9,162586,156625,5961,3.7
East Carroll,5/1/2019,1855,1676,179,9.6,162751,156821,5930,3.6
East Carroll,6/1/2019,1902,1678,224,11.8,163168,157232,5935,3.6
East Carroll,7/1/2019,1916,1698,218,11.4,163590,157529,6061,3.7
East Carroll,8/1/2019,1922,1726,196,10.2,163774,157829,5945,3.6
East Carroll,9/1/2019,1914,1743,171,8.9,164092,158339,5753,3.5
East Carroll,10/1/2019,1897,1720,177,9.3,164416,158545,5871,3.6
East Carroll,11/1/2019,1865,1680,185,9.9,164496,158629,5868,3.6
East Carroll,12/1/2019,1844,1655,189,10.2,164699,158845,5853,3.6
East Carroll,1/1/2020,1803,1608,195,10.8,164377,158508,5869,3.6
East Carroll,2/1/2020,1787,1597,190,10.6,164467,158714,5753,3.5
East Carroll,3/1/2020,1877,1582,295,15.7,162559,155353,7206,4.4
East Carroll,4/1/2020,1651,1485,166,10.1,156269,133185,23084,14.8
East Carroll,5/1/2020,1725,1509,216,12.5,158101,137173,20929,13.2
East Carroll,6/1/2020,1776,1511,265,14.9,159994,142342,17652,11
East Carroll,7/1/2020,1775,1500,275,15.5,160132,143779,16352,10.2
East Carroll,8/1/2020,1818,1582,236,13,160706,147245,13461,8.4
East Carroll,9/1/2020,1872,1627,245,13.1,160174,147620,12554,7.8
East Carroll,10/1/2020,1869,1660,209,11.2,161003,149931,11072,6.9
East Carroll,11/1/2020,1809,1612,197,10.9,160629,149934,10694,6.7
East Carroll,12/1/2020,1828,1616,212,11.6,160745,149975,10770,6.7
East Carroll,1/1/2021,1788,1561,227,12.7,160088,149852,10236,6.4
East Carroll,2/1/2021,1770,1561,209,11.8,160184,150189,9995,6.2
East Carroll,3/1/2021,1768,1567,201,11.4,160400,150644,9756,6.1
East Carroll,4/1/2021,1759,1576,183,10.4,160843,151081,9762,6.1
East Carroll,5/1/2021,1723,1543,180,10.4,160800,151535,9266,5.8
East Carroll,6/1/2021,1750,1538,212,12.1,161197,151734,9462,5.9
East Carroll,7/1/2021,1758,1567,191,10.9,161504,152773,8731,5.4
East Carroll,8/1/2021,1737,1567,170,9.8,161527,153250,8276,5.1
East Carroll,9/1/2021,1739,1597,142,8.2,161495,153843,7652,4.7
East Carroll,10/1/2021,1678,1551,127,7.6,161754,154475,7279,4.5
East Carroll,11/1/2021,1665,1545,120,7.2,162281,155530,6751,4.2
East Carroll,12/1/2021,1686,1576,110,6.5,162497,156099,6398,3.9
East Carroll,1/1/2022,1629,1487,142,8.7,163627,157115,6512,4
East Carroll,2/1/2022,1619,1489,130,8,163899,157598,6301,3.8
East Carroll,3/1/2022,1615,1493,122,7.6,164220,158206,6014,3.7
East Carroll,4/1/2022,1627,1519,108,6.6,163893,157891,6002,3.7
East Carroll,5/1/2022,1636,1516,120,7.3,164362,158378,5983,3.6
East Carroll,6/1/2022,1681,1522,159,9.5,164046,158094,5951,3.6
East Carroll,7/1/2022,1692,1538,154,9.1,164026,158258,5768,3.5
East Carroll,8/1/2022,1653,1503,150,9.1,164654,158735,5919,3.6
East Carroll,9/1/2022,1634,1510,124,7.6,164602,158810,5792,3.5
East Carroll,10/1/2022,1656,1548,108,6.5,164648,158684,5964,3.6
East Carroll,11/1/2022,1648,1537,111,6.7,164450,158507,5943,3.6
East Carroll,12/1/2022,1666,1553,113,6.8,165025,159259,5766,3.5
East Carroll,1/1/2023,1681,1534,147,8.7,165964,160217,5747,3.5
East Carroll,2/1/2023,1694,1551,143,8.4,166358,160395,5962,3.6
East Carroll,3/1/2023,1705,1550,155,9.1,166651,160812,5839,3.5
East Carroll,4/1/2023,1685,1547,138,8.2,166725,160974,5751,3.4
East Carroll,5/1/2023,1691,1525,166,9.8,166886,160796,6089,3.6
East Carroll,6/1/2023,1743,1577,166,9.5,166937,160979,5958,3.6
East Carroll,7/1/2023,1708,1556,152,8.9,167103,161183,5920,3.5
East Carroll,8/1/2023,1669,1520,149,8.9,167759,161475,6284,3.7
East Carroll,9/1/2023,1635,1497,138,8.4,167767,161442,6326,3.8
East Carroll,10/1/2023,1653,1506,147,8.9,167690,161211,6479,3.9
East Carroll,11/1/2023,1647,1508,139,8.4,168140,161886,6254,3.7
East Carroll,12/1/2023,1652,1506,146,8.8,167439,161124,6315,3.8
East Carroll,1/1/2024,1644,1486,158,9.6,167339,161190,6149,3.7
East Carroll,2/1/2024,1592,1443,149,9.4,167475,161013,6462,3.9
East Carroll,3/1/2024,1594,1455,139,8.7,167922,161425,6497,3.9
East Carroll,4/1/2024,1612,1472,140,8.7,167988,161495,6492,3.9
East Carroll,5/1/2024,1603,1452,151,9.4,167799,161164,6635,4
East Carroll,6/1/2024,1722,1525,197,11.4,168005,161155,6849,4.1
East Carroll,7/1/2024,1732,1536,196,11.3,168315,161219,7097,4.2
East Carroll,8/1/2024,1699,1521,178,10.5,168496,161425,7071,4.2
East Carroll,9/1/2024,1721,1558,163,9.5,168703,161802,6901,4.1
East Carroll,10/1/2024,1721,1557,164,9.5,168428,161456,6972,4.1
East Carroll,11/1/2024,1684,1522,162,9.6,168304,161183,7121,4.2
East Carroll,12/1/2024,1686,1536,150,8.9,168547,161661,6886,4.1
East Carroll,1/1/2025,1203,1036,167,13.9,170744,163895,6849,4
East Carroll,2/1/2025,1140,984,156,13.7,170359,163307,7052,4.1
East Feliciana,1/1/1990,7105,6627,478,6.7,125833,119081,6752,5.4
East Feliciana,2/1/1990,7107,6658,449,6.3,125710,119059,6651,5.3
East Feliciana,3/1/1990,7085,6637,448,6.3,125801,119203,6598,5.2
East Feliciana,4/1/1990,7000,6604,396,5.7,125649,118852,6797,5.4
East Feliciana,5/1/1990,7092,6678,414,5.8,125893,119151,6742,5.4
East Feliciana,6/1/1990,7078,6632,446,6.3,125573,118983,6590,5.2
East Feliciana,7/1/1990,7318,6871,447,6.1,125732,118810,6922,5.5
East Feliciana,8/1/1990,7112,6669,443,6.2,125990,118802,7188,5.7
East Feliciana,9/1/1990,7184,6737,447,6.2,125892,118524,7368,5.9
East Feliciana,10/1/1990,7326,6920,406,5.5,125995,118536,7459,5.9
East Feliciana,11/1/1990,7273,6840,433,6,126070,118306,7764,6.2
East Feliciana,12/1/1990,7098,6677,421,5.9,126142,118241,7901,6.3
East Feliciana,1/1/1991,7157,6663,494,6.9,125955,117940,8015,6.4
East Feliciana,2/1/1991,7200,6686,514,7.1,126020,117755,8265,6.6
East Feliciana,3/1/1991,7377,6900,477,6.5,126238,117652,8586,6.8
East Feliciana,4/1/1991,7369,6902,467,6.3,126548,118109,8439,6.7
East Feliciana,5/1/1991,7416,6864,552,7.4,126176,117440,8736,6.9
East Feliciana,6/1/1991,7456,6854,602,8.1,126331,117639,8692,6.9
East Feliciana,7/1/1991,7623,7127,496,6.5,126154,117568,8586,6.8
East Feliciana,8/1/1991,7618,7057,561,7.4,126150,117484,8666,6.9
East Feliciana,9/1/1991,7683,7162,521,6.8,126650,117928,8722,6.9
East Feliciana,10/1/1991,7703,7203,500,6.5,126642,117800,8842,7
East Feliciana,11/1/1991,7669,7200,469,6.1,126701,117770,8931,7
East Feliciana,12/1/1991,7555,7079,476,6.3,126664,117466,9198,7.3
East Feliciana,1/1/1992,7485,6935,550,7.3,127261,117978,9283,7.3
East Feliciana,2/1/1992,7415,6931,484,6.5,127207,117753,9454,7.4
East Feliciana,3/1/1992,7373,6926,447,6.1,127604,118144,9460,7.4
East Feliciana,4/1/1992,7335,6903,432,5.9,127841,118426,9415,7.4
East Feliciana,5/1/1992,7295,6859,436,6,128119,118375,9744,7.6
East Feliciana,6/1/1992,7410,6876,534,7.2,128459,118419,10040,7.8
East Feliciana,7/1/1992,7686,7201,485,6.3,128563,118713,9850,7.7
East Feliciana,8/1/1992,7553,7045,508,6.7,128613,118826,9787,7.6
East Feliciana,9/1/1992,7536,7038,498,6.6,128501,118720,9781,7.6
East Feliciana,10/1/1992,7588,7156,432,5.7,128026,118628,9398,7.3
East Feliciana,11/1/1992,7623,7215,408,5.4,128441,118876,9565,7.4
East Feliciana,12/1/1992,7290,6876,414,5.7,128554,118997,9557,7.4
East Feliciana,1/1/1993,7409,6867,542,7.3,128400,119075,9325,7.3
East Feliciana,2/1/1993,7311,6831,480,6.6,128458,119275,9183,7.1
East Feliciana,3/1/1993,7377,6907,470,6.4,128598,119542,9056,7
East Feliciana,4/1/1993,7632,7153,479,6.3,128584,119474,9110,7.1
East Feliciana,5/1/1993,7623,7133,490,6.4,129264,120115,9149,7.1
East Feliciana,6/1/1993,7665,7097,568,7.4,129411,120290,9121,7
East Feliciana,7/1/1993,7903,7345,558,7.1,129397,120467,8930,6.9
East Feliciana,8/1/1993,7863,7257,606,7.7,129619,120856,8763,6.8
East Feliciana,9/1/1993,7802,7253,549,7,129268,120554,8714,6.7
East Feliciana,10/1/1993,7846,7319,527,6.7,129573,120823,8750,6.8
East Feliciana,11/1/1993,7800,7308,492,6.3,129711,121169,8542,6.6
East Feliciana,12/1/1993,7749,7235,514,6.6,129941,121464,8477,6.5
East Feliciana,1/1/1994,7858,7203,655,8.3,130596,121966,8630,6.6
East Feliciana,2/1/1994,7810,7201,609,7.8,130669,122086,8583,6.6
East Feliciana,3/1/1994,7848,7257,591,7.5,130400,121930,8470,6.5
East Feliciana,4/1/1994,7671,7116,555,7.2,130621,122290,8331,6.4
East Feliciana,5/1/1994,7587,7050,537,7.1,130779,122864,7915,6.1
East Feliciana,6/1/1994,7650,7019,631,8.2,130561,122634,7927,6.1
East Feliciana,7/1/1994,7725,7120,605,7.8,130652,122706,7946,6.1
East Feliciana,8/1/1994,7765,7131,634,8.2,131275,123342,7933,6
East Feliciana,9/1/1994,7833,7216,617,7.9,131421,123687,7734,5.9
East Feliciana,10/1/1994,7864,7248,616,7.8,131744,124112,7632,5.8
East Feliciana,11/1/1994,7762,7202,560,7.2,131891,124516,7375,5.6
East Feliciana,12/1/1994,7682,7134,548,7.1,131951,124721,7230,5.5
East Feliciana,1/1/1995,7624,7005,619,8.1,132038,124663,7375,5.6
East Feliciana,2/1/1995,7564,7064,500,6.6,132115,124928,7187,5.4
East Feliciana,3/1/1995,7598,7098,500,6.6,132108,124955,7153,5.4
East Feliciana,4/1/1995,7706,7182,524,6.8,132590,124945,7645,5.8
East Feliciana,5/1/1995,7646,7139,507,6.6,131851,124421,7430,5.6
East Feliciana,6/1/1995,7767,7177,590,7.6,131949,124522,7427,5.6
East Feliciana,7/1/1995,7832,7326,506,6.5,132343,124816,7527,5.7
East Feliciana,8/1/1995,7698,7170,528,6.9,132336,124852,7484,5.7
East Feliciana,9/1/1995,7675,7120,555,7.2,132611,125133,7478,5.6
East Feliciana,10/1/1995,7666,7156,510,6.7,132716,125388,7328,5.5
East Feliciana,11/1/1995,7531,7104,427,5.7,132614,125188,7426,5.6
East Feliciana,12/1/1995,7497,6979,518,6.9,132511,125088,7423,5.6
East Feliciana,1/1/1996,7626,7001,625,8.2,132616,125125,7491,5.6
East Feliciana,2/1/1996,7522,6992,530,7,132952,125639,7313,5.5
East Feliciana,3/1/1996,7583,7063,520,6.9,133180,125862,7318,5.5
East Feliciana,4/1/1996,7644,7098,546,7.1,133409,125994,7415,5.6
East Feliciana,5/1/1996,7464,6951,513,6.9,133667,126244,7423,5.6
East Feliciana,6/1/1996,7493,6941,552,7.4,133697,126602,7095,5.3
East Feliciana,7/1/1996,7710,7151,559,7.3,134284,126947,7337,5.5
East Feliciana,8/1/1996,7473,6959,514,6.9,134054,127172,6882,5.1
East Feliciana,9/1/1996,7447,6923,524,7,134515,127536,6979,5.2
East Feliciana,10/1/1996,7569,7061,508,6.7,134921,127890,7031,5.2
East Feliciana,11/1/1996,7507,7069,438,5.8,135007,127771,7236,5.4
East Feliciana,12/1/1996,7480,7022,458,6.1,135113,127860,7253,5.4
East Feliciana,1/1/1997,7491,7022,469,6.3,135456,128298,7158,5.3
East Feliciana,2/1/1997,7388,6938,450,6.1,135400,128298,7102,5.2
East Feliciana,3/1/1997,7473,7014,459,6.1,135891,128891,7000,5.2
East Feliciana,4/1/1997,7427,6992,435,5.9,136016,129143,6873,5.1
East Feliciana,5/1/1997,7414,6962,452,6.1,136119,129464,6655,4.9
East Feliciana,6/1/1997,7469,6927,542,7.3,136211,129412,6799,5
East Feliciana,7/1/1997,7648,7128,520,6.8,136477,129822,6655,4.9
East Feliciana,8/1/1997,7475,7028,447,6,136618,130010,6608,4.8
East Feliciana,9/1/1997,7392,6939,453,6.1,136675,130019,6656,4.9
East Feliciana,10/1/1997,7434,7038,396,5.3,136633,130179,6454,4.7
East Feliciana,11/1/1997,7376,7019,357,4.8,136961,130653,6308,4.6
East Feliciana,12/1/1997,7298,6950,348,4.8,137155,130679,6476,4.7
East Feliciana,1/1/1998,7403,6939,464,6.3,137095,130726,6368,4.6
East Feliciana,2/1/1998,7310,6915,395,5.4,137112,130807,6306,4.6
East Feliciana,3/1/1998,7394,6950,444,6,137236,130814,6422,4.7
East Feliciana,4/1/1998,7350,6935,415,5.6,137150,131209,5941,4.3
East Feliciana,5/1/1998,7371,6930,441,6,137372,131325,6047,4.4
East Feliciana,6/1/1998,7389,6890,499,6.8,137455,131244,6212,4.5
East Feliciana,7/1/1998,7556,7119,437,5.8,137588,131329,6259,4.5
East Feliciana,8/1/1998,7519,7070,449,6,137570,131390,6179,4.5
East Feliciana,9/1/1998,7365,6941,424,5.8,138286,131986,6300,4.6
East Feliciana,10/1/1998,7510,7134,376,5,138279,131999,6280,4.5
East Feliciana,11/1/1998,7448,7127,321,4.3,138381,132280,6100,4.4
East Feliciana,12/1/1998,7534,7170,364,4.8,138634,132602,6032,4.4
East Feliciana,1/1/1999,7481,7088,393,5.3,139003,133027,5976,4.3
East Feliciana,2/1/1999,7476,7122,354,4.7,138967,132856,6111,4.4
East Feliciana,3/1/1999,7453,7143,310,4.2,138730,132947,5783,4.2
East Feliciana,4/1/1999,7363,7073,290,3.9,138959,132955,6004,4.3
East Feliciana,5/1/1999,7424,7108,316,4.3,139107,133311,5796,4.2
East Feliciana,6/1/1999,7470,7065,405,5.4,139329,133378,5951,4.3
East Feliciana,7/1/1999,7574,7187,387,5.1,139439,133414,6025,4.3
East Feliciana,8/1/1999,7547,7140,407,5.4,139430,133591,5838,4.2
East Feliciana,9/1/1999,7374,7005,369,5,139622,133707,5915,4.2
East Feliciana,10/1/1999,7319,6969,350,4.8,139771,133993,5778,4.1
East Feliciana,11/1/1999,7307,7004,303,4.1,140025,134309,5716,4.1
East Feliciana,12/1/1999,7270,6963,307,4.2,140177,134523,5653,4
East Feliciana,1/1/2000,8250,7757,493,6,142267,136559,5708,4
East Feliciana,2/1/2000,8252,7843,409,5,142456,136598,5858,4.1
East Feliciana,3/1/2000,8290,7874,416,5,142434,136701,5733,4
East Feliciana,4/1/2000,8346,7958,388,4.6,142751,137270,5481,3.8
East Feliciana,5/1/2000,8257,7809,448,5.4,142388,136630,5758,4
East Feliciana,6/1/2000,8391,7868,523,6.2,142591,136940,5651,4
East Feliciana,7/1/2000,8177,7699,478,5.8,142278,136531,5747,4
East Feliciana,8/1/2000,8180,7691,489,6,142514,136662,5853,4.1
East Feliciana,9/1/2000,8162,7691,471,5.8,142518,136893,5625,3.9
East Feliciana,10/1/2000,8170,7715,455,5.6,142622,137088,5534,3.9
East Feliciana,11/1/2000,8205,7733,472,5.8,142962,137322,5639,3.9
East Feliciana,12/1/2000,8184,7726,458,5.6,143248,137614,5634,3.9
East Feliciana,1/1/2001,8135,7589,546,6.7,143800,137778,6023,4.2
East Feliciana,2/1/2001,8064,7596,468,5.8,143701,137612,6089,4.2
East Feliciana,3/1/2001,8040,7591,449,5.6,143924,137783,6141,4.3
East Feliciana,4/1/2001,8095,7639,456,5.6,143569,137299,6271,4.4
East Feliciana,5/1/2001,8056,7608,448,5.6,143318,137092,6226,4.3
East Feliciana,6/1/2001,8214,7633,581,7.1,143357,136873,6484,4.5
East Feliciana,7/1/2001,8090,7566,524,6.5,143654,137071,6583,4.6
East Feliciana,8/1/2001,8027,7504,523,6.5,143284,136241,7042,4.9
East Feliciana,9/1/2001,8075,7537,538,6.7,143989,136846,7142,5
East Feliciana,10/1/2001,8176,7652,524,6.4,144086,136392,7694,5.3
East Feliciana,11/1/2001,8162,7641,521,6.4,144240,136238,8003,5.5
East Feliciana,12/1/2001,8128,7610,518,6.4,144305,136047,8258,5.7
East Feliciana,1/1/2002,7883,7332,551,7,143883,135701,8182,5.7
East Feliciana,2/1/2002,7894,7425,469,5.9,144653,136438,8215,5.7
East Feliciana,3/1/2002,7892,7411,481,6.1,144481,136177,8304,5.7
East Feliciana,4/1/2002,7966,7485,481,6,144725,136126,8599,5.9
East Feliciana,5/1/2002,7922,7416,506,6.4,144938,136539,8399,5.8
East Feliciana,6/1/2002,8076,7471,605,7.5,144808,136415,8393,5.8
East Feliciana,7/1/2002,8007,7440,567,7.1,144803,136413,8390,5.8
East Feliciana,8/1/2002,7972,7428,544,6.8,145009,136705,8304,5.7
East Feliciana,9/1/2002,8034,7479,555,6.9,145552,137302,8251,5.7
East Feliciana,10/1/2002,8041,7542,499,6.2,145314,137008,8307,5.7
East Feliciana,11/1/2002,8027,7490,537,6.7,145041,136521,8520,5.9
East Feliciana,12/1/2002,7987,7433,554,6.9,145066,136426,8640,6
East Feliciana,1/1/2003,7866,7276,590,7.5,145937,137417,8520,5.8
East Feliciana,2/1/2003,7932,7406,526,6.6,146100,137482,8618,5.9
East Feliciana,3/1/2003,7941,7392,549,6.9,146022,137434,8588,5.9
East Feliciana,4/1/2003,8039,7491,548,6.8,146474,137633,8842,6
East Feliciana,5/1/2003,7993,7404,589,7.4,146500,137544,8957,6.1
East Feliciana,6/1/2003,8158,7393,765,9.4,147056,137790,9266,6.3
East Feliciana,7/1/2003,8127,7445,682,8.4,146485,137474,9011,6.2
East Feliciana,8/1/2003,7994,7393,601,7.5,146445,137549,8896,6.1
East Feliciana,9/1/2003,7982,7403,579,7.3,146530,137609,8921,6.1
East Feliciana,10/1/2003,8044,7516,528,6.6,146716,137984,8732,6
East Feliciana,11/1/2003,8022,7497,525,6.5,147000,138424,8576,5.8
East Feliciana,12/1/2003,7976,7445,531,6.7,146729,138411,8317,5.7
East Feliciana,1/1/2004,7881,7272,609,7.7,146842,138472,8370,5.7
East Feliciana,2/1/2004,7905,7387,518,6.6,146709,138542,8167,5.6
East Feliciana,3/1/2004,7966,7443,523,6.6,146944,138453,8491,5.8
East Feliciana,4/1/2004,7987,7460,527,6.6,146850,138680,8170,5.6
East Feliciana,5/1/2004,7876,7357,519,6.6,147065,138852,8212,5.6
East Feliciana,6/1/2004,8035,7434,601,7.5,147460,139174,8286,5.6
East Feliciana,7/1/2004,8049,7469,580,7.2,147692,139556,8136,5.5
East Feliciana,8/1/2004,7964,7444,520,6.5,147564,139573,7990,5.4
East Feliciana,9/1/2004,8001,7443,558,7,147415,139487,7927,5.4
East Feliciana,10/1/2004,8066,7513,553,6.9,147793,139732,8061,5.5
East Feliciana,11/1/2004,8096,7564,532,6.6,148162,140231,7932,5.4
East Feliciana,12/1/2004,8060,7516,544,6.7,148059,140125,7934,5.4
East Feliciana,1/1/2005,7864,7298,566,7.2,148029,140245,7784,5.3
East Feliciana,2/1/2005,7937,7399,538,6.8,148364,140385,7980,5.4
East Feliciana,3/1/2005,7928,7456,472,6,148391,140654,7737,5.2
East Feliciana,4/1/2005,7981,7573,408,5.1,148926,141254,7672,5.2
East Feliciana,5/1/2005,7919,7457,462,5.8,149261,141609,7651,5.1
East Feliciana,6/1/2005,8039,7483,556,6.9,149238,141714,7524,5
East Feliciana,7/1/2005,8028,7527,501,6.2,149432,142026,7406,5
East Feliciana,8/1/2005,8008,7529,479,6,149779,142434,7345,4.9
East Feliciana,9/1/2005,8948,8109,839,9.4,149954,142401,7553,5
East Feliciana,10/1/2005,8969,8255,714,8,150001,142548,7453,5
East Feliciana,11/1/2005,8967,8264,703,7.8,150065,142499,7566,5
East Feliciana,12/1/2005,8594,8167,427,5,150030,142752,7279,4.9
East Feliciana,1/1/2006,8051,7678,373,4.6,150214,143150,7064,4.7
East Feliciana,2/1/2006,8091,7773,318,3.9,150641,143457,7184,4.8
East Feliciana,3/1/2006,8122,7793,329,4.1,150813,143741,7072,4.7
East Feliciana,4/1/2006,8094,7761,333,4.1,150881,143761,7120,4.7
East Feliciana,5/1/2006,8060,7702,358,4.4,151069,144089,6980,4.6
East Feliciana,6/1/2006,8085,7654,431,5.3,151354,144353,7001,4.6
East Feliciana,7/1/2006,7938,7584,354,4.5,151377,144202,7175,4.7
East Feliciana,8/1/2006,8002,7607,395,4.9,151716,144625,7091,4.7
East Feliciana,9/1/2006,8004,7614,390,4.9,151662,144815,6847,4.5
East Feliciana,10/1/2006,8087,7712,375,4.6,152041,145314,6727,4.4
East Feliciana,11/1/2006,8086,7710,376,4.7,152406,145534,6872,4.5
East Feliciana,12/1/2006,8052,7719,333,4.1,152732,145970,6762,4.4
East Feliciana,1/1/2007,7894,7496,398,5,153144,146028,7116,4.6
East Feliciana,2/1/2007,7913,7580,333,4.2,152983,146057,6927,4.5
East Feliciana,3/1/2007,8006,7666,340,4.2,153051,146320,6731,4.4
East Feliciana,4/1/2007,8024,7685,339,4.2,152435,145586,6850,4.5
East Feliciana,5/1/2007,8060,7667,393,4.9,152670,145903,6766,4.4
East Feliciana,6/1/2007,8153,7720,433,5.3,153041,146063,6979,4.6
East Feliciana,7/1/2007,8158,7780,378,4.6,153054,145905,7149,4.7
East Feliciana,8/1/2007,8085,7698,387,4.8,152749,145682,7067,4.6
East Feliciana,9/1/2007,8151,7749,402,4.9,153414,146244,7170,4.7
East Feliciana,10/1/2007,8153,7814,339,4.2,153183,145946,7237,4.7
East Feliciana,11/1/2007,8202,7852,350,4.3,153835,146595,7240,4.7
East Feliciana,12/1/2007,8148,7807,341,4.2,153918,146273,7645,5
East Feliciana,1/1/2008,7964,7575,389,4.9,154063,146378,7685,5
East Feliciana,2/1/2008,7978,7640,338,4.2,153653,146156,7497,4.9
East Feliciana,3/1/2008,8056,7694,362,4.5,153908,146086,7822,5.1
East Feliciana,4/1/2008,8071,7767,304,3.8,153769,146132,7637,5
East Feliciana,5/1/2008,8091,7716,375,4.6,154303,145908,8395,5.4
East Feliciana,6/1/2008,8292,7798,494,6,154313,145737,8575,5.6
East Feliciana,7/1/2008,8265,7803,462,5.6,154469,145532,8937,5.8
East Feliciana,8/1/2008,8180,7722,458,5.6,154641,145203,9438,6.1
East Feliciana,9/1/2008,8197,7737,460,5.6,154570,145076,9494,6.1
East Feliciana,10/1/2008,8286,7832,454,5.5,154876,144802,10074,6.5
East Feliciana,11/1/2008,8288,7827,461,5.6,154639,144100,10538,6.8
East Feliciana,12/1/2008,8233,7788,445,5.4,154655,143369,11286,7.3
East Feliciana,1/1/2009,8013,7497,516,6.4,154210,142152,12058,7.8
East Feliciana,2/1/2009,8074,7559,515,6.4,154538,141640,12898,8.3
East Feliciana,3/1/2009,8131,7593,538,6.6,154133,140707,13426,8.7
East Feliciana,4/1/2009,8165,7637,528,6.5,154509,140656,13853,9
East Feliciana,5/1/2009,8155,7565,590,7.2,154747,140248,14499,9.4
East Feliciana,6/1/2009,8264,7581,683,8.3,154716,140009,14707,9.5
East Feliciana,7/1/2009,8304,7667,637,7.7,154502,139901,14601,9.5
East Feliciana,8/1/2009,8217,7603,614,7.5,154307,139492,14814,9.6
East Feliciana,9/1/2009,8233,7628,605,7.3,153827,138818,15009,9.8
East Feliciana,10/1/2009,8181,7605,576,7,153784,138432,15352,10
East Feliciana,11/1/2009,8184,7631,553,6.8,153878,138659,15219,9.9
East Feliciana,12/1/2009,8072,7508,564,7,153111,138013,15098,9.9
East Feliciana,1/1/2010,7961,7366,595,7.5,153484,138438,15046,9.8
East Feliciana,2/1/2010,7974,7442,532,6.7,153694,138581,15113,9.8
East Feliciana,3/1/2010,8066,7506,560,6.9,153954,138751,15202,9.9
East Feliciana,4/1/2010,8097,7543,554,6.8,154622,139297,15325,9.9
East Feliciana,5/1/2010,8086,7486,600,7.4,154091,139241,14849,9.6
East Feliciana,6/1/2010,8195,7506,689,8.4,153616,139141,14474,9.4
East Feliciana,7/1/2010,8188,7505,683,8.3,153691,139179,14512,9.4
East Feliciana,8/1/2010,8196,7503,693,8.5,154086,139438,14648,9.5
East Feliciana,9/1/2010,8175,7493,682,8.3,153975,139396,14579,9.5
East Feliciana,10/1/2010,8180,7512,668,8.2,153635,139119,14516,9.4
East Feliciana,11/1/2010,8177,7501,676,8.3,154125,139044,15081,9.8
East Feliciana,12/1/2010,8091,7439,652,8.1,153650,139301,14348,9.3
East Feliciana,1/1/2011,8026,7327,699,8.7,153263,139250,14013,9.1
East Feliciana,2/1/2011,8059,7419,640,7.9,153214,139394,13820,9
East Feliciana,3/1/2011,8103,7462,641,7.9,153376,139639,13737,9
East Feliciana,4/1/2011,8069,7483,586,7.3,153543,139586,13957,9.1
East Feliciana,5/1/2011,8047,7434,613,7.6,153479,139624,13855,9
East Feliciana,6/1/2011,8113,7404,709,8.7,153346,139384,13962,9.1
East Feliciana,7/1/2011,8127,7429,698,8.6,153288,139524,13763,9
East Feliciana,8/1/2011,8043,7375,668,8.3,153760,139942,13818,9
East Feliciana,9/1/2011,8115,7457,658,8.1,154131,140183,13948,9
East Feliciana,10/1/2011,8146,7525,621,7.6,153961,140368,13594,8.8
East Feliciana,11/1/2011,8133,7531,602,7.4,154128,140826,13302,8.6
East Feliciana,12/1/2011,8049,7461,588,7.3,153995,140902,13093,8.5
East Feliciana,1/1/2012,7904,7264,640,8.1,154381,141584,12797,8.3
East Feliciana,2/1/2012,7957,7367,590,7.4,154671,141858,12813,8.3
East Feliciana,3/1/2012,8016,7432,584,7.3,154749,142036,12713,8.2
East Feliciana,4/1/2012,7991,7448,543,6.8,154545,141899,12646,8.2
East Feliciana,5/1/2012,7988,7412,576,7.2,154866,142206,12660,8.2
East Feliciana,6/1/2012,8080,7424,656,8.1,155083,142391,12692,8.2
East Feliciana,7/1/2012,8032,7400,632,7.9,154948,142292,12656,8.2
East Feliciana,8/1/2012,7975,7404,571,7.2,154763,142291,12471,8.1
East Feliciana,9/1/2012,8027,7494,533,6.6,155160,143044,12115,7.8
East Feliciana,10/1/2012,8065,7545,520,6.4,155554,143431,12124,7.8
East Feliciana,11/1/2012,8022,7539,483,6,155338,143333,12005,7.7
East Feliciana,12/1/2012,7985,7466,519,6.5,155628,143330,12298,7.9
East Feliciana,1/1/2013,7816,7217,599,7.7,155763,143292,12471,8
East Feliciana,2/1/2013,7865,7324,541,6.9,155312,143362,11950,7.7
East Feliciana,3/1/2013,7893,7380,513,6.5,155005,143316,11689,7.5
East Feliciana,4/1/2013,7948,7451,497,6.3,155394,143635,11760,7.6
East Feliciana,5/1/2013,7972,7440,532,6.7,155536,143882,11654,7.5
East Feliciana,6/1/2013,8043,7451,592,7.4,155749,143999,11751,7.5
East Feliciana,7/1/2013,8043,7474,569,7.1,155599,144264,11335,7.3
East Feliciana,8/1/2013,7982,7444,538,6.7,155605,144326,11279,7.2
East Feliciana,9/1/2013,8046,7504,542,6.7,155687,144418,11270,7.2
East Feliciana,10/1/2013,7993,7498,495,6.2,154673,143537,11136,7.2
East Feliciana,11/1/2013,7978,7537,441,5.5,155265,144479,10787,6.9
East Feliciana,12/1/2013,7871,7468,403,5.1,155182,144778,10404,6.7
East Feliciana,1/1/2014,7843,7384,459,5.9,155352,145150,10202,6.6
East Feliciana,2/1/2014,7912,7485,427,5.4,155483,145134,10349,6.7
East Feliciana,3/1/2014,7999,7558,441,5.5,156028,145648,10380,6.7
East Feliciana,4/1/2014,8020,7599,421,5.2,155369,145667,9702,6.2
East Feliciana,5/1/2014,8078,7605,473,5.9,155684,145825,9859,6.3
East Feliciana,6/1/2014,8182,7616,566,6.9,155707,146247,9460,6.1
East Feliciana,7/1/2014,8254,7657,597,7.2,156007,146399,9608,6.2
East Feliciana,8/1/2014,8255,7657,598,7.2,156130,146530,9599,6.1
East Feliciana,9/1/2014,8306,7733,573,6.9,156040,146778,9262,5.9
East Feliciana,10/1/2014,8355,7819,536,6.4,156417,147427,8990,5.7
East Feliciana,11/1/2014,8299,7761,538,6.5,156494,147404,9090,5.8
East Feliciana,12/1/2014,8221,7698,523,6.4,156332,147615,8717,5.6
East Feliciana,1/1/2015,8118,7551,567,7,157030,148145,8885,5.7
East Feliciana,2/1/2015,8152,7620,532,6.5,156644,148045,8599,5.5
East Feliciana,3/1/2015,8167,7671,496,6.1,156643,148128,8515,5.4
East Feliciana,4/1/2015,8170,7705,465,5.7,157060,148511,8550,5.4
East Feliciana,5/1/2015,8213,7728,485,5.9,157651,148817,8834,5.6
East Feliciana,6/1/2015,8234,7716,518,6.3,157062,148816,8247,5.3
East Feliciana,7/1/2015,8247,7732,515,6.2,156997,148830,8167,5.2
East Feliciana,8/1/2015,8166,7694,472,5.8,157172,149181,7992,5.1
East Feliciana,9/1/2015,8149,7683,466,5.7,156733,148826,7907,5
East Feliciana,10/1/2015,8183,7739,444,5.4,157167,149246,7922,5
East Feliciana,11/1/2015,8161,7749,412,5,157463,149463,8000,5.1
East Feliciana,12/1/2015,8079,7685,394,4.9,158035,150128,7907,5
East Feliciana,1/1/2016,8001,7531,470,5.9,158280,150653,7627,4.8
East Feliciana,2/1/2016,8077,7630,447,5.5,158640,150939,7702,4.9
East Feliciana,3/1/2016,8157,7702,455,5.6,159179,151218,7961,5
East Feliciana,4/1/2016,8156,7710,446,5.5,159141,151074,8067,5.1
East Feliciana,5/1/2016,8149,7678,471,5.8,158784,151132,7652,4.8
East Feliciana,6/1/2016,8224,7687,537,6.5,158967,151223,7744,4.9
East Feliciana,7/1/2016,8225,7695,530,6.4,159194,151554,7641,4.8
East Feliciana,8/1/2016,8039,7547,492,6.1,159562,151779,7784,4.9
East Feliciana,9/1/2016,8093,7597,496,6.1,159714,151761,7953,5
East Feliciana,10/1/2016,8102,7665,437,5.4,159605,151793,7811,4.9
East Feliciana,11/1/2016,8051,7645,406,5,159506,151954,7553,4.7
East Feliciana,12/1/2016,7939,7545,394,5,159678,152157,7521,4.7
East Feliciana,1/1/2017,7854,7418,436,5.6,159620,152152,7468,4.7
East Feliciana,2/1/2017,7940,7552,388,4.9,159859,152480,7379,4.6
East Feliciana,3/1/2017,7972,7599,373,4.7,160137,153065,7073,4.4
East Feliciana,4/1/2017,8005,7619,386,4.8,160345,153255,7089,4.4
East Feliciana,5/1/2017,7924,7567,357,4.5,160068,153069,7000,4.4
East Feliciana,6/1/2017,8015,7579,436,5.4,160192,153318,6873,4.3
East Feliciana,7/1/2017,8026,7611,415,5.2,160462,153569,6892,4.3
East Feliciana,8/1/2017,7993,7580,413,5.2,160586,153503,7082,4.4
East Feliciana,9/1/2017,8018,7632,386,4.8,161140,154286,6854,4.3
East Feliciana,10/1/2017,7986,7657,329,4.1,160309,153609,6700,4.2
East Feliciana,11/1/2017,8001,7651,350,4.4,160579,153805,6774,4.2
East Feliciana,12/1/2017,7905,7589,316,4,160535,153904,6632,4.1
East Feliciana,1/1/2018,7813,7466,347,4.4,160914,154425,6489,4
East Feliciana,2/1/2018,7917,7584,333,4.2,161778,155197,6581,4.1
East Feliciana,3/1/2018,8022,7682,340,4.2,161686,155214,6472,4
East Feliciana,4/1/2018,8007,7679,328,4.1,161771,155312,6459,4
East Feliciana,5/1/2018,7976,7625,351,4.4,161848,155652,6196,3.8
East Feliciana,6/1/2018,8114,7649,465,5.7,162210,155762,6447,4
East Feliciana,7/1/2018,8108,7679,429,5.3,162341,156146,6195,3.8
East Feliciana,8/1/2018,7994,7585,409,5.1,161660,155504,6156,3.8
East Feliciana,9/1/2018,8014,7629,385,4.8,162087,156015,6073,3.7
East Feliciana,10/1/2018,8070,7696,374,4.6,162602,156391,6211,3.8
East Feliciana,11/1/2018,8053,7722,331,4.1,162836,156721,6115,3.8
East Feliciana,12/1/2018,7968,7648,320,4,163206,156817,6389,3.9
East Feliciana,1/1/2019,7860,7470,390,5,162963,156487,6475,4
East Feliciana,2/1/2019,7907,7581,326,4.1,162999,156863,6136,3.8
East Feliciana,3/1/2019,7938,7630,308,3.9,162904,156701,6202,3.8
East Feliciana,4/1/2019,7894,7600,294,3.7,162586,156625,5961,3.7
East Feliciana,5/1/2019,7858,7530,328,4.2,162751,156821,5930,3.6
East Feliciana,6/1/2019,7938,7529,409,5.2,163168,157232,5935,3.6
East Feliciana,7/1/2019,7922,7509,413,5.2,163590,157529,6061,3.7
East Feliciana,8/1/2019,7882,7494,388,4.9,163774,157829,5945,3.6
East Feliciana,9/1/2019,7906,7548,358,4.5,164092,158339,5753,3.5
East Feliciana,10/1/2019,7925,7568,357,4.5,164416,158545,5871,3.6
East Feliciana,11/1/2019,7923,7581,342,4.3,164496,158629,5868,3.6
East Feliciana,12/1/2019,7784,7469,315,4,164699,158845,5853,3.6
East Feliciana,1/1/2020,7580,7240,340,4.5,164377,158508,5869,3.6
East Feliciana,2/1/2020,7608,7336,272,3.6,164467,158714,5753,3.5
East Feliciana,3/1/2020,7738,7247,491,6.3,162559,155353,7206,4.4
East Feliciana,4/1/2020,7005,6302,703,10,156269,133185,23084,14.8
East Feliciana,5/1/2020,7190,6489,701,9.7,158101,137173,20929,13.2
East Feliciana,6/1/2020,7428,6716,712,9.6,159994,142342,17652,11
East Feliciana,7/1/2020,7511,6814,697,9.3,160132,143779,16352,10.2
East Feliciana,8/1/2020,7549,6987,562,7.4,160706,147245,13461,8.4
East Feliciana,9/1/2020,7644,7085,559,7.3,160174,147620,12554,7.8
East Feliciana,10/1/2020,7729,7238,491,6.4,161003,149931,11072,6.9
East Feliciana,11/1/2020,7642,7203,439,5.7,160629,149934,10694,6.7
East Feliciana,12/1/2020,7590,7151,439,5.8,160745,149975,10770,6.7
East Feliciana,1/1/2021,7515,7067,448,6,160088,149852,10236,6.4
East Feliciana,2/1/2021,7587,7165,422,5.6,160184,150189,9995,6.2
East Feliciana,3/1/2021,7646,7257,389,5.1,160400,150644,9756,6.1
East Feliciana,4/1/2021,7687,7297,390,5.1,160843,151081,9762,6.1
East Feliciana,5/1/2021,7651,7272,379,5,160800,151535,9266,5.8
East Feliciana,6/1/2021,7646,7197,449,5.9,161197,151734,9462,5.9
East Feliciana,7/1/2021,7646,7244,402,5.3,161504,152773,8731,5.4
East Feliciana,8/1/2021,7610,7262,348,4.6,161527,153250,8276,5.1
East Feliciana,9/1/2021,7787,7468,319,4.1,161495,153843,7652,4.7
East Feliciana,10/1/2021,7783,7499,284,3.6,161754,154475,7279,4.5
East Feliciana,11/1/2021,7778,7527,251,3.2,162281,155530,6751,4.2
East Feliciana,12/1/2021,7717,7492,225,2.9,162497,156099,6398,3.9
East Feliciana,1/1/2022,7744,7472,272,3.5,163627,157115,6512,4
East Feliciana,2/1/2022,7854,7597,257,3.3,163899,157598,6301,3.8
East Feliciana,3/1/2022,7917,7668,249,3.1,164220,158206,6014,3.7
East Feliciana,4/1/2022,7869,7648,221,2.8,163893,157891,6002,3.7
East Feliciana,5/1/2022,7862,7615,247,3.1,164362,158378,5983,3.6
East Feliciana,6/1/2022,7862,7550,312,4,164046,158094,5951,3.6
East Feliciana,7/1/2022,7857,7577,280,3.6,164026,158258,5768,3.5
East Feliciana,8/1/2022,7822,7558,264,3.4,164654,158735,5919,3.6
East Feliciana,9/1/2022,7818,7585,233,3,164602,158810,5792,3.5
East Feliciana,10/1/2022,7821,7609,212,2.7,164648,158684,5964,3.6
East Feliciana,11/1/2022,7810,7604,206,2.6,164450,158507,5943,3.6
East Feliciana,12/1/2022,7787,7557,230,3,165025,159259,5766,3.5
East Feliciana,1/1/2023,7764,7499,265,3.4,165964,160217,5747,3.5
East Feliciana,2/1/2023,7857,7598,259,3.3,166358,160395,5962,3.6
East Feliciana,3/1/2023,7919,7679,240,3,166651,160812,5839,3.5
East Feliciana,4/1/2023,7890,7667,223,2.8,166725,160974,5751,3.4
East Feliciana,5/1/2023,7874,7596,278,3.5,166886,160796,6089,3.6
East Feliciana,6/1/2023,7874,7549,325,4.1,166937,160979,5958,3.6
East Feliciana,7/1/2023,7885,7584,301,3.8,167103,161183,5920,3.5
East Feliciana,8/1/2023,7881,7584,297,3.8,167759,161475,6284,3.7
East Feliciana,9/1/2023,7950,7653,297,3.7,167767,161442,6326,3.8
East Feliciana,10/1/2023,7987,7682,305,3.8,167690,161211,6479,3.9
East Feliciana,11/1/2023,8018,7726,292,3.6,168140,161886,6254,3.7
East Feliciana,12/1/2023,7919,7633,286,3.6,167439,161124,6315,3.8
East Feliciana,1/1/2024,7912,7573,339,4.3,167339,161190,6149,3.7
East Feliciana,2/1/2024,7939,7628,311,3.9,167475,161013,6462,3.9
East Feliciana,3/1/2024,8045,7740,305,3.8,167922,161425,6497,3.9
East Feliciana,4/1/2024,8013,7737,276,3.4,167988,161495,6492,3.9
East Feliciana,5/1/2024,7965,7679,286,3.6,167799,161164,6635,4
East Feliciana,6/1/2024,7987,7622,365,4.6,168005,161155,6849,4.1
East Feliciana,7/1/2024,8028,7652,376,4.7,168315,161219,7097,4.2
East Feliciana,8/1/2024,7979,7628,351,4.4,168496,161425,7071,4.2
East Feliciana,9/1/2024,7948,7615,333,4.2,168703,161802,6901,4.1
East Feliciana,10/1/2024,7981,7650,331,4.1,168428,161456,6972,4.1
East Feliciana,11/1/2024,7966,7647,319,4,168304,161183,7121,4.2
East Feliciana,12/1/2024,7930,7618,312,3.9,168547,161661,6886,4.1
East Feliciana,1/1/2025,7198,6878,320,4.4,170744,163895,6849,4
East Feliciana,2/1/2025,7224,6919,305,4.2,170359,163307,7052,4.1
Evangeline,1/1/1990,10948,10112,836,7.6,125833,119081,6752,5.4
Evangeline,2/1/1990,10947,10135,812,7.4,125710,119059,6651,5.3
Evangeline,3/1/1990,11095,10340,755,6.8,125801,119203,6598,5.2
Evangeline,4/1/1990,11025,10294,731,6.6,125649,118852,6797,5.4
Evangeline,5/1/1990,11103,10369,734,6.6,125893,119151,6742,5.4
Evangeline,6/1/1990,11190,10262,928,8.3,125573,118983,6590,5.2
Evangeline,7/1/1990,11312,10500,812,7.2,125732,118810,6922,5.5
Evangeline,8/1/1990,11619,10739,880,7.6,125990,118802,7188,5.7
Evangeline,9/1/1990,11630,10717,913,7.9,125892,118524,7368,5.9
Evangeline,10/1/1990,11652,10790,862,7.4,125995,118536,7459,5.9
Evangeline,11/1/1990,11692,10806,886,7.6,126070,118306,7764,6.2
Evangeline,12/1/1990,11582,10648,934,8.1,126142,118241,7901,6.3
Evangeline,1/1/1991,11688,10467,1221,10.4,125955,117940,8015,6.4
Evangeline,2/1/1991,11718,10649,1069,9.1,126020,117755,8265,6.6
Evangeline,3/1/1991,11905,10860,1045,8.8,126238,117652,8586,6.8
Evangeline,4/1/1991,12184,11197,987,8.1,126548,118109,8439,6.7
Evangeline,5/1/1991,12213,11147,1066,8.7,126176,117440,8736,6.9
Evangeline,6/1/1991,12540,11294,1246,9.9,126331,117639,8692,6.9
Evangeline,7/1/1991,12722,11623,1099,8.6,126154,117568,8586,6.8
Evangeline,8/1/1991,12734,11687,1047,8.2,126150,117484,8666,6.9
Evangeline,9/1/1991,12562,11623,939,7.5,126650,117928,8722,6.9
Evangeline,10/1/1991,12856,11850,1006,7.8,126642,117800,8842,7
Evangeline,11/1/1991,12669,11692,977,7.7,126701,117770,8931,7
Evangeline,12/1/1991,12552,11551,1001,8,126664,117466,9198,7.3
Evangeline,1/1/1992,12035,10750,1285,10.7,127261,117978,9283,7.3
Evangeline,2/1/1992,12114,10818,1296,10.7,127207,117753,9454,7.4
Evangeline,3/1/1992,12224,10913,1311,10.7,127604,118144,9460,7.4
Evangeline,4/1/1992,12293,11177,1116,9.1,127841,118426,9415,7.4
Evangeline,5/1/1992,12237,11086,1151,9.4,128119,118375,9744,7.6
Evangeline,6/1/1992,12554,11160,1394,11.1,128459,118419,10040,7.8
Evangeline,7/1/1992,12939,11684,1255,9.7,128563,118713,9850,7.7
Evangeline,8/1/1992,13018,11800,1218,9.4,128613,118826,9787,7.6
Evangeline,9/1/1992,12810,11726,1084,8.5,128501,118720,9781,7.6
Evangeline,10/1/1992,12603,11610,993,7.9,128026,118628,9398,7.3
Evangeline,11/1/1992,12227,11295,932,7.6,128441,118876,9565,7.4
Evangeline,12/1/1992,11924,11029,895,7.5,128554,118997,9557,7.4
Evangeline,1/1/1993,11938,10852,1086,9.1,128400,119075,9325,7.3
Evangeline,2/1/1993,11963,10972,991,8.3,128458,119275,9183,7.1
Evangeline,3/1/1993,12032,11082,950,7.9,128598,119542,9056,7
Evangeline,4/1/1993,11983,11071,912,7.6,128584,119474,9110,7.1
Evangeline,5/1/1993,12075,11186,889,7.4,129264,120115,9149,7.1
Evangeline,6/1/1993,12254,11225,1029,8.4,129411,120290,9121,7
Evangeline,7/1/1993,12178,11305,873,7.2,129397,120467,8930,6.9
Evangeline,8/1/1993,12059,11229,830,6.9,129619,120856,8763,6.8
Evangeline,9/1/1993,11999,11253,746,6.2,129268,120554,8714,6.7
Evangeline,10/1/1993,12181,11405,776,6.4,129573,120823,8750,6.8
Evangeline,11/1/1993,12032,11236,796,6.6,129711,121169,8542,6.6
Evangeline,12/1/1993,12042,11208,834,6.9,129941,121464,8477,6.5
Evangeline,1/1/1994,12111,11070,1041,8.6,130596,121966,8630,6.6
Evangeline,2/1/1994,12172,11181,991,8.1,130669,122086,8583,6.6
Evangeline,3/1/1994,12358,11341,1017,8.2,130400,121930,8470,6.5
Evangeline,4/1/1994,12171,11361,810,6.7,130621,122290,8331,6.4
Evangeline,5/1/1994,12140,11379,761,6.3,130779,122864,7915,6.1
Evangeline,6/1/1994,12161,11229,932,7.7,130561,122634,7927,6.1
Evangeline,7/1/1994,12079,11208,871,7.2,130652,122706,7946,6.1
Evangeline,8/1/1994,12109,11193,916,7.6,131275,123342,7933,6
Evangeline,9/1/1994,12093,11202,891,7.4,131421,123687,7734,5.9
Evangeline,10/1/1994,12004,11113,891,7.4,131744,124112,7632,5.8
Evangeline,11/1/1994,11932,11113,819,6.9,131891,124516,7375,5.6
Evangeline,12/1/1994,11785,10985,800,6.8,131951,124721,7230,5.5
Evangeline,1/1/1995,11907,10855,1052,8.8,132038,124663,7375,5.6
Evangeline,2/1/1995,11684,10767,917,7.8,132115,124928,7187,5.4
Evangeline,3/1/1995,11824,10897,927,7.8,132108,124955,7153,5.4
Evangeline,4/1/1995,11773,10962,811,6.9,132590,124945,7645,5.8
Evangeline,5/1/1995,11757,10943,814,6.9,131851,124421,7430,5.6
Evangeline,6/1/1995,12082,11116,966,8,131949,124522,7427,5.6
Evangeline,7/1/1995,11935,11038,897,7.5,132343,124816,7527,5.7
Evangeline,8/1/1995,11863,10998,865,7.3,132336,124852,7484,5.7
Evangeline,9/1/1995,11775,11010,765,6.5,132611,125133,7478,5.6
Evangeline,10/1/1995,11692,10924,768,6.6,132716,125388,7328,5.5
Evangeline,11/1/1995,11481,10761,720,6.3,132614,125188,7426,5.6
Evangeline,12/1/1995,11353,10661,692,6.1,132511,125088,7423,5.6
Evangeline,1/1/1996,11490,10609,881,7.7,132616,125125,7491,5.6
Evangeline,2/1/1996,11538,10816,722,6.3,132952,125639,7313,5.5
Evangeline,3/1/1996,11605,10915,690,5.9,133180,125862,7318,5.5
Evangeline,4/1/1996,11758,11059,699,5.9,133409,125994,7415,5.6
Evangeline,5/1/1996,11718,11013,705,6,133667,126244,7423,5.6
Evangeline,6/1/1996,11965,11090,875,7.3,133697,126602,7095,5.3
Evangeline,7/1/1996,12262,11439,823,6.7,134284,126947,7337,5.5
Evangeline,8/1/1996,11926,11140,786,6.6,134054,127172,6882,5.1
Evangeline,9/1/1996,11904,11248,656,5.5,134515,127536,6979,5.2
Evangeline,10/1/1996,12026,11365,661,5.5,134921,127890,7031,5.2
Evangeline,11/1/1996,11785,11136,649,5.5,135007,127771,7236,5.4
Evangeline,12/1/1996,11457,10877,580,5.1,135113,127860,7253,5.4
Evangeline,1/1/1997,11681,10924,757,6.5,135456,128298,7158,5.3
Evangeline,2/1/1997,11586,10935,651,5.6,135400,128298,7102,5.2
Evangeline,3/1/1997,11735,11073,662,5.6,135891,128891,7000,5.2
Evangeline,4/1/1997,11862,11264,598,5,136016,129143,6873,5.1
Evangeline,5/1/1997,11884,11284,600,5,136119,129464,6655,4.9
Evangeline,6/1/1997,12227,11375,852,7,136211,129412,6799,5
Evangeline,7/1/1997,12414,11699,715,5.8,136477,129822,6655,4.9
Evangeline,8/1/1997,12303,11620,683,5.6,136618,130010,6608,4.8
Evangeline,9/1/1997,12074,11442,632,5.2,136675,130019,6656,4.9
Evangeline,10/1/1997,11970,11335,635,5.3,136633,130179,6454,4.7
Evangeline,11/1/1997,11788,11208,580,4.9,136961,130653,6308,4.6
Evangeline,12/1/1997,11708,11118,590,5,137155,130679,6476,4.7
Evangeline,1/1/1998,11745,11078,667,5.7,137095,130726,6368,4.6
Evangeline,2/1/1998,11706,11173,533,4.6,137112,130807,6306,4.6
Evangeline,3/1/1998,11867,11245,622,5.2,137236,130814,6422,4.7
Evangeline,4/1/1998,11870,11318,552,4.7,137150,131209,5941,4.3
Evangeline,5/1/1998,11891,11340,551,4.6,137372,131325,6047,4.4
Evangeline,6/1/1998,12278,11600,678,5.5,137455,131244,6212,4.5
Evangeline,7/1/1998,12263,11639,624,5.1,137588,131329,6259,4.5
Evangeline,8/1/1998,12329,11590,739,6,137570,131390,6179,4.5
Evangeline,9/1/1998,12020,11348,672,5.6,138286,131986,6300,4.6
Evangeline,10/1/1998,11863,11253,610,5.1,138279,131999,6280,4.5
Evangeline,11/1/1998,11684,11112,572,4.9,138381,132280,6100,4.4
Evangeline,12/1/1998,11609,11049,560,4.8,138634,132602,6032,4.4
Evangeline,1/1/1999,11710,11032,678,5.8,139003,133027,5976,4.3
Evangeline,2/1/1999,11637,11017,620,5.3,138967,132856,6111,4.4
Evangeline,3/1/1999,11686,11039,647,5.5,138730,132947,5783,4.2
Evangeline,4/1/1999,12085,11459,626,5.2,138959,132955,6004,4.3
Evangeline,5/1/1999,12100,11492,608,5,139107,133311,5796,4.2
Evangeline,6/1/1999,12364,11538,826,6.7,139329,133378,5951,4.3
Evangeline,7/1/1999,12238,11522,716,5.9,139439,133414,6025,4.3
Evangeline,8/1/1999,12171,11463,708,5.8,139430,133591,5838,4.2
Evangeline,9/1/1999,11909,11249,660,5.5,139622,133707,5915,4.2
Evangeline,10/1/1999,12006,11386,620,5.2,139771,133993,5778,4.1
Evangeline,11/1/1999,11728,11178,550,4.7,140025,134309,5716,4.1
Evangeline,12/1/1999,11611,11122,489,4.2,140177,134523,5653,4
Evangeline,1/1/2000,12071,11405,666,5.5,142267,136559,5708,4
Evangeline,2/1/2000,12019,11438,581,4.8,142456,136598,5858,4.1
Evangeline,3/1/2000,12224,11600,624,5.1,142434,136701,5733,4
Evangeline,4/1/2000,12150,11580,570,4.7,142751,137270,5481,3.8
Evangeline,5/1/2000,12060,11413,647,5.4,142388,136630,5758,4
Evangeline,6/1/2000,12344,11500,844,6.8,142591,136940,5651,4
Evangeline,7/1/2000,12482,11685,797,6.4,142278,136531,5747,4
Evangeline,8/1/2000,12308,11493,815,6.6,142514,136662,5853,4.1
Evangeline,9/1/2000,12052,11300,752,6.2,142518,136893,5625,3.9
Evangeline,10/1/2000,11827,11109,718,6.1,142622,137088,5534,3.9
Evangeline,11/1/2000,11731,11034,697,5.9,142962,137322,5639,3.9
Evangeline,12/1/2000,11740,11084,656,5.6,143248,137614,5634,3.9
Evangeline,1/1/2001,11650,10814,836,7.2,143800,137778,6023,4.2
Evangeline,2/1/2001,11598,10850,748,6.4,143701,137612,6089,4.2
Evangeline,3/1/2001,11817,11045,772,6.5,143924,137783,6141,4.3
Evangeline,4/1/2001,11888,11152,736,6.2,143569,137299,6271,4.4
Evangeline,5/1/2001,11714,10997,717,6.1,143318,137092,6226,4.3
Evangeline,6/1/2001,12140,11213,927,7.6,143357,136873,6484,4.5
Evangeline,7/1/2001,12228,11402,826,6.8,143654,137071,6583,4.6
Evangeline,8/1/2001,12082,11276,806,6.7,143284,136241,7042,4.9
Evangeline,9/1/2001,12141,11352,789,6.5,143989,136846,7142,5
Evangeline,10/1/2001,12131,11357,774,6.4,144086,136392,7694,5.3
Evangeline,11/1/2001,12038,11273,765,6.4,144240,136238,8003,5.5
Evangeline,12/1/2001,12048,11283,765,6.3,144305,136047,8258,5.7
Evangeline,1/1/2002,11868,10997,871,7.3,143883,135701,8182,5.7
Evangeline,2/1/2002,11820,11056,764,6.5,144653,136438,8215,5.7
Evangeline,3/1/2002,12031,11267,764,6.4,144481,136177,8304,5.7
Evangeline,4/1/2002,12022,11259,763,6.3,144725,136126,8599,5.9
Evangeline,5/1/2002,12019,11244,775,6.4,144938,136539,8399,5.8
Evangeline,6/1/2002,12306,11355,951,7.7,144808,136415,8393,5.8
Evangeline,7/1/2002,12262,11313,949,7.7,144803,136413,8390,5.8
Evangeline,8/1/2002,12146,11207,939,7.7,145009,136705,8304,5.7
Evangeline,9/1/2002,12067,11155,912,7.6,145552,137302,8251,5.7
Evangeline,10/1/2002,12075,11201,874,7.2,145314,137008,8307,5.7
Evangeline,11/1/2002,11972,11120,852,7.1,145041,136521,8520,5.9
Evangeline,12/1/2002,11969,11119,850,7.1,145066,136426,8640,6
Evangeline,1/1/2003,12001,11032,969,8.1,145937,137417,8520,5.8
Evangeline,2/1/2003,11839,10959,880,7.4,146100,137482,8618,5.9
Evangeline,3/1/2003,12020,11085,935,7.8,146022,137434,8588,5.9
Evangeline,4/1/2003,11933,11026,907,7.6,146474,137633,8842,6
Evangeline,5/1/2003,11889,10945,944,7.9,146500,137544,8957,6.1
Evangeline,6/1/2003,12195,10985,1210,9.9,147056,137790,9266,6.3
Evangeline,7/1/2003,12008,10885,1123,9.4,146485,137474,9011,6.2
Evangeline,8/1/2003,11972,10960,1012,8.5,146445,137549,8896,6.1
Evangeline,9/1/2003,11814,10924,890,7.5,146530,137609,8921,6.1
Evangeline,10/1/2003,11817,11003,814,6.9,146716,137984,8732,6
Evangeline,11/1/2003,11667,10877,790,6.8,147000,138424,8576,5.8
Evangeline,12/1/2003,11501,10733,768,6.7,146729,138411,8317,5.7
Evangeline,1/1/2004,11596,10705,891,7.7,146842,138472,8370,5.7
Evangeline,2/1/2004,11524,10770,754,6.5,146709,138542,8167,5.6
Evangeline,3/1/2004,11632,10844,788,6.8,146944,138453,8491,5.8
Evangeline,4/1/2004,11587,10874,713,6.2,146850,138680,8170,5.6
Evangeline,5/1/2004,11601,10840,761,6.6,147065,138852,8212,5.6
Evangeline,6/1/2004,11797,10870,927,7.9,147460,139174,8286,5.6
Evangeline,7/1/2004,11910,11056,854,7.2,147692,139556,8136,5.5
Evangeline,8/1/2004,11973,11234,739,6.2,147564,139573,7990,5.4
Evangeline,9/1/2004,11836,11110,726,6.1,147415,139487,7927,5.4
Evangeline,10/1/2004,11935,11227,708,5.9,147793,139732,8061,5.5
Evangeline,11/1/2004,11840,11136,704,5.9,148162,140231,7932,5.4
Evangeline,12/1/2004,11702,11002,700,6,148059,140125,7934,5.4
Evangeline,1/1/2005,11701,10895,806,6.9,148029,140245,7784,5.3
Evangeline,2/1/2005,11536,10807,729,6.3,148364,140385,7980,5.4
Evangeline,3/1/2005,11634,10957,677,5.8,148391,140654,7737,5.2
Evangeline,4/1/2005,11807,11152,655,5.5,148926,141254,7672,5.2
Evangeline,5/1/2005,11785,11076,709,6,149261,141609,7651,5.1
Evangeline,6/1/2005,12179,11304,875,7.2,149238,141714,7524,5
Evangeline,7/1/2005,12080,11295,785,6.5,149432,142026,7406,5
Evangeline,8/1/2005,11903,11204,699,5.9,149779,142434,7345,4.9
Evangeline,9/1/2005,13104,11964,1140,8.7,149954,142401,7553,5
Evangeline,10/1/2005,13560,12153,1407,10.4,150001,142548,7453,5
Evangeline,11/1/2005,13260,11847,1413,10.7,150065,142499,7566,5
Evangeline,12/1/2005,12360,11722,638,5.2,150030,142752,7279,4.9
Evangeline,1/1/2006,12166,11601,565,4.6,150214,143150,7064,4.7
Evangeline,2/1/2006,12086,11633,453,3.7,150641,143457,7184,4.8
Evangeline,3/1/2006,12276,11795,481,3.9,150813,143741,7072,4.7
Evangeline,4/1/2006,12299,11844,455,3.7,150881,143761,7120,4.7
Evangeline,5/1/2006,12143,11632,511,4.2,151069,144089,6980,4.6
Evangeline,6/1/2006,12420,11759,661,5.3,151354,144353,7001,4.6
Evangeline,7/1/2006,12390,11812,578,4.7,151377,144202,7175,4.7
Evangeline,8/1/2006,12334,11761,573,4.6,151716,144625,7091,4.7
Evangeline,9/1/2006,12368,11839,529,4.3,151662,144815,6847,4.5
Evangeline,10/1/2006,12352,11831,521,4.2,152041,145314,6727,4.4
Evangeline,11/1/2006,12286,11741,545,4.4,152406,145534,6872,4.5
Evangeline,12/1/2006,12116,11619,497,4.1,152732,145970,6762,4.4
Evangeline,1/1/2007,12292,11659,633,5.1,153144,146028,7116,4.6
Evangeline,2/1/2007,12294,11767,527,4.3,152983,146057,6927,4.5
Evangeline,3/1/2007,12396,11851,545,4.4,153051,146320,6731,4.4
Evangeline,4/1/2007,12321,11781,540,4.4,152435,145586,6850,4.5
Evangeline,5/1/2007,12279,11659,620,5,152670,145903,6766,4.4
Evangeline,6/1/2007,12477,11712,765,6.1,153041,146063,6979,4.6
Evangeline,7/1/2007,12439,11733,706,5.7,153054,145905,7149,4.7
Evangeline,8/1/2007,12506,11861,645,5.2,152749,145682,7067,4.6
Evangeline,9/1/2007,12477,11873,604,4.8,153414,146244,7170,4.7
Evangeline,10/1/2007,12416,11892,524,4.2,153183,145946,7237,4.7
Evangeline,11/1/2007,12359,11813,546,4.4,153835,146595,7240,4.7
Evangeline,12/1/2007,12213,11630,583,4.8,153918,146273,7645,5
Evangeline,1/1/2008,12224,11568,656,5.4,154063,146378,7685,5
Evangeline,2/1/2008,12176,11663,513,4.2,153653,146156,7497,4.9
Evangeline,3/1/2008,12411,11834,577,4.6,153908,146086,7822,5.1
Evangeline,4/1/2008,12487,11999,488,3.9,153769,146132,7637,5
Evangeline,5/1/2008,12470,11891,579,4.6,154303,145908,8395,5.4
Evangeline,6/1/2008,12676,11933,743,5.9,154313,145737,8575,5.6
Evangeline,7/1/2008,12874,12213,661,5.1,154469,145532,8937,5.8
Evangeline,8/1/2008,12753,12052,701,5.5,154641,145203,9438,6.1
Evangeline,9/1/2008,12720,12085,635,5,154570,145076,9494,6.1
Evangeline,10/1/2008,12719,12016,703,5.5,154876,144802,10074,6.5
Evangeline,11/1/2008,12610,11910,700,5.6,154639,144100,10538,6.8
Evangeline,12/1/2008,12362,11641,721,5.8,154655,143369,11286,7.3
Evangeline,1/1/2009,12394,11560,834,6.7,154210,142152,12058,7.8
Evangeline,2/1/2009,12409,11568,841,6.8,154538,141640,12898,8.3
Evangeline,3/1/2009,12584,11679,905,7.2,154133,140707,13426,8.7
Evangeline,4/1/2009,12840,11911,929,7.2,154509,140656,13853,9
Evangeline,5/1/2009,12877,11911,966,7.5,154747,140248,14499,9.4
Evangeline,6/1/2009,13175,11968,1207,9.2,154716,140009,14707,9.5
Evangeline,7/1/2009,13302,12123,1179,8.9,154502,139901,14601,9.5
Evangeline,8/1/2009,13022,11952,1070,8.2,154307,139492,14814,9.6
Evangeline,9/1/2009,12812,11815,997,7.8,153827,138818,15009,9.8
Evangeline,10/1/2009,12807,11822,985,7.7,153784,138432,15352,10
Evangeline,11/1/2009,12787,11832,955,7.5,153878,138659,15219,9.9
Evangeline,12/1/2009,12698,11672,1026,8.1,153111,138013,15098,9.9
Evangeline,1/1/2010,12844,11716,1128,8.8,153484,138438,15046,9.8
Evangeline,2/1/2010,12890,11904,986,7.6,153694,138581,15113,9.8
Evangeline,3/1/2010,12977,12007,970,7.5,153954,138751,15202,9.9
Evangeline,4/1/2010,13114,12171,943,7.2,154622,139297,15325,9.9
Evangeline,5/1/2010,13104,12092,1012,7.7,154091,139241,14849,9.6
Evangeline,6/1/2010,13389,12211,1178,8.8,153616,139141,14474,9.4
Evangeline,7/1/2010,13582,12428,1154,8.5,153691,139179,14512,9.4
Evangeline,8/1/2010,13356,12227,1129,8.5,154086,139438,14648,9.5
Evangeline,9/1/2010,13124,12107,1017,7.7,153975,139396,14579,9.5
Evangeline,10/1/2010,13303,12267,1036,7.8,153635,139119,14516,9.4
Evangeline,11/1/2010,13186,12124,1062,8.1,154125,139044,15081,9.8
Evangeline,12/1/2010,13045,12017,1028,7.9,153650,139301,14348,9.3
Evangeline,1/1/2011,13035,11843,1192,9.1,153263,139250,14013,9.1
Evangeline,2/1/2011,12948,11885,1063,8.2,153214,139394,13820,9
Evangeline,3/1/2011,13030,12004,1026,7.9,153376,139639,13737,9
Evangeline,4/1/2011,13103,12141,962,7.3,153543,139586,13957,9.1
Evangeline,5/1/2011,13117,12107,1010,7.7,153479,139624,13855,9
Evangeline,6/1/2011,13296,12113,1183,8.9,153346,139384,13962,9.1
Evangeline,7/1/2011,13267,12138,1129,8.5,153288,139524,13763,9
Evangeline,8/1/2011,13074,12013,1061,8.1,153760,139942,13818,9
Evangeline,9/1/2011,13072,12077,995,7.6,154131,140183,13948,9
Evangeline,10/1/2011,13143,12169,974,7.4,153961,140368,13594,8.8
Evangeline,11/1/2011,13048,12117,931,7.1,154128,140826,13302,8.6
Evangeline,12/1/2011,12954,12042,912,7,153995,140902,13093,8.5
Evangeline,1/1/2012,12657,11643,1014,8,154381,141584,12797,8.3
Evangeline,2/1/2012,12661,11729,932,7.4,154671,141858,12813,8.3
Evangeline,3/1/2012,12702,11757,945,7.4,154749,142036,12713,8.2
Evangeline,4/1/2012,12960,12093,867,6.7,154545,141899,12646,8.2
Evangeline,5/1/2012,13067,12146,921,7,154866,142206,12660,8.2
Evangeline,6/1/2012,13346,12260,1086,8.1,155083,142391,12692,8.2
Evangeline,7/1/2012,13111,12089,1022,7.8,154948,142292,12656,8.2
Evangeline,8/1/2012,12887,11973,914,7.1,154763,142291,12471,8.1
Evangeline,9/1/2012,12874,12057,817,6.3,155160,143044,12115,7.8
Evangeline,10/1/2012,12924,12111,813,6.3,155554,143431,12124,7.8
Evangeline,11/1/2012,12842,12102,740,5.8,155338,143333,12005,7.7
Evangeline,12/1/2012,12815,12006,809,6.3,155628,143330,12298,7.9
Evangeline,1/1/2013,12828,11856,972,7.6,155763,143292,12471,8
Evangeline,2/1/2013,12627,11795,832,6.6,155312,143362,11950,7.7
Evangeline,3/1/2013,12685,11870,815,6.4,155005,143316,11689,7.5
Evangeline,4/1/2013,12837,12044,793,6.2,155394,143635,11760,7.6
Evangeline,5/1/2013,13017,12139,878,6.7,155536,143882,11654,7.5
Evangeline,6/1/2013,13276,12242,1034,7.8,155749,143999,11751,7.5
Evangeline,7/1/2013,13186,12252,934,7.1,155599,144264,11335,7.3
Evangeline,8/1/2013,13031,12179,852,6.5,155605,144326,11279,7.2
Evangeline,9/1/2013,12875,12116,759,5.9,155687,144418,11270,7.2
Evangeline,10/1/2013,12725,11956,769,6,154673,143537,11136,7.2
Evangeline,11/1/2013,12703,11975,728,5.7,155265,144479,10787,6.9
Evangeline,12/1/2013,12608,11968,640,5.1,155182,144778,10404,6.7
Evangeline,1/1/2014,13028,12289,739,5.7,155352,145150,10202,6.6
Evangeline,2/1/2014,13001,12302,699,5.4,155483,145134,10349,6.7
Evangeline,3/1/2014,13179,12426,753,5.7,156028,145648,10380,6.7
Evangeline,4/1/2014,12987,12293,694,5.3,155369,145667,9702,6.2
Evangeline,5/1/2014,13087,12250,837,6.4,155684,145825,9859,6.3
Evangeline,6/1/2014,13285,12299,986,7.4,155707,146247,9460,6.1
Evangeline,7/1/2014,12771,11743,1028,8,156007,146399,9608,6.2
Evangeline,8/1/2014,12797,11809,988,7.7,156130,146530,9599,6.1
Evangeline,9/1/2014,13220,12291,929,7,156040,146778,9262,5.9
Evangeline,10/1/2014,13197,12290,907,6.9,156417,147427,8990,5.7
Evangeline,11/1/2014,13124,12192,932,7.1,156494,147404,9090,5.8
Evangeline,12/1/2014,13083,12206,877,6.7,156332,147615,8717,5.6
Evangeline,1/1/2015,13091,12075,1016,7.8,157030,148145,8885,5.7
Evangeline,2/1/2015,12953,12004,949,7.3,156644,148045,8599,5.5
Evangeline,3/1/2015,13055,12076,979,7.5,156643,148128,8515,5.4
Evangeline,4/1/2015,12958,12005,953,7.4,157060,148511,8550,5.4
Evangeline,5/1/2015,12963,11983,980,7.6,157651,148817,8834,5.6
Evangeline,6/1/2015,13159,12075,1084,8.2,157062,148816,8247,5.3
Evangeline,7/1/2015,12975,11934,1041,8,156997,148830,8167,5.2
Evangeline,8/1/2015,12814,11841,973,7.6,157172,149181,7992,5.1
Evangeline,9/1/2015,12780,11830,950,7.4,156733,148826,7907,5
Evangeline,10/1/2015,12813,11892,921,7.2,157167,149246,7922,5
Evangeline,11/1/2015,12770,11899,871,6.8,157463,149463,8000,5.1
Evangeline,12/1/2015,12723,11882,841,6.6,158035,150128,7907,5
Evangeline,1/1/2016,12658,11725,933,7.4,158280,150653,7627,4.8
Evangeline,2/1/2016,12651,11742,909,7.2,158640,150939,7702,4.9
Evangeline,3/1/2016,12777,11843,934,7.3,159179,151218,7961,5
Evangeline,4/1/2016,12778,11893,885,6.9,159141,151074,8067,5.1
Evangeline,5/1/2016,12776,11893,883,6.9,158784,151132,7652,4.8
Evangeline,6/1/2016,13030,11911,1119,8.6,158967,151223,7744,4.9
Evangeline,7/1/2016,12802,11736,1066,8.3,159194,151554,7641,4.8
Evangeline,8/1/2016,12585,11567,1018,8.1,159562,151779,7784,4.9
Evangeline,9/1/2016,12711,11729,982,7.7,159714,151761,7953,5
Evangeline,10/1/2016,12464,11586,878,7,159605,151793,7811,4.9
Evangeline,11/1/2016,12406,11597,809,6.5,159506,151954,7553,4.7
Evangeline,12/1/2016,12358,11564,794,6.4,159678,152157,7521,4.7
Evangeline,1/1/2017,12516,11637,879,7,159620,152152,7468,4.7
Evangeline,2/1/2017,12506,11726,780,6.2,159859,152480,7379,4.6
Evangeline,3/1/2017,12660,11927,733,5.8,160137,153065,7073,4.4
Evangeline,4/1/2017,12585,11853,732,5.8,160345,153255,7089,4.4
Evangeline,5/1/2017,12588,11863,725,5.8,160068,153069,7000,4.4
Evangeline,6/1/2017,12816,11969,847,6.6,160192,153318,6873,4.3
Evangeline,7/1/2017,12605,11783,822,6.5,160462,153569,6892,4.3
Evangeline,8/1/2017,12451,11683,768,6.2,160586,153503,7082,4.4
Evangeline,9/1/2017,12621,11900,721,5.7,161140,154286,6854,4.3
Evangeline,10/1/2017,12307,11674,633,5.1,160309,153609,6700,4.2
Evangeline,11/1/2017,12383,11750,633,5.1,160579,153805,6774,4.2
Evangeline,12/1/2017,12275,11673,602,4.9,160535,153904,6632,4.1
Evangeline,1/1/2018,11844,11156,688,5.8,160914,154425,6489,4
Evangeline,2/1/2018,11965,11318,647,5.4,161778,155197,6581,4.1
Evangeline,3/1/2018,12170,11509,661,5.4,161686,155214,6472,4
Evangeline,4/1/2018,12085,11434,651,5.4,161771,155312,6459,4
Evangeline,5/1/2018,12213,11552,661,5.4,161848,155652,6196,3.8
Evangeline,6/1/2018,12397,11509,888,7.2,162210,155762,6447,4
Evangeline,7/1/2018,12139,11305,834,6.9,162341,156146,6195,3.8
Evangeline,8/1/2018,11933,11225,708,5.9,161660,155504,6156,3.8
Evangeline,9/1/2018,12085,11425,660,5.5,162087,156015,6073,3.7
Evangeline,10/1/2018,12083,11457,626,5.2,162602,156391,6211,3.8
Evangeline,11/1/2018,12060,11461,599,5,162836,156721,6115,3.8
Evangeline,12/1/2018,12042,11454,588,4.9,163206,156817,6389,3.9
Evangeline,1/1/2019,11809,11105,704,6,162963,156487,6475,4
Evangeline,2/1/2019,11823,11206,617,5.2,162999,156863,6136,3.8
Evangeline,3/1/2019,11953,11366,587,4.9,162904,156701,6202,3.8
Evangeline,4/1/2019,11911,11364,547,4.6,162586,156625,5961,3.7
Evangeline,5/1/2019,11955,11330,625,5.2,162751,156821,5930,3.6
Evangeline,6/1/2019,12201,11393,808,6.6,163168,157232,5935,3.6
Evangeline,7/1/2019,11874,11053,821,6.9,163590,157529,6061,3.7
Evangeline,8/1/2019,11784,11039,745,6.3,163774,157829,5945,3.6
Evangeline,9/1/2019,11973,11297,676,5.6,164092,158339,5753,3.5
Evangeline,10/1/2019,11903,11229,674,5.7,164416,158545,5871,3.6
Evangeline,11/1/2019,11787,11123,664,5.6,164496,158629,5868,3.6
Evangeline,12/1/2019,11701,11077,624,5.3,164699,158845,5853,3.6
Evangeline,1/1/2020,11733,11049,684,5.8,164377,158508,5869,3.6
Evangeline,2/1/2020,11769,11228,541,4.6,164467,158714,5753,3.5
Evangeline,3/1/2020,12230,11300,930,7.6,162559,155353,7206,4.4
Evangeline,4/1/2020,11571,10484,1087,9.4,156269,133185,23084,14.8
Evangeline,5/1/2020,11843,10609,1234,10.4,158101,137173,20929,13.2
Evangeline,6/1/2020,11961,10695,1266,10.6,159994,142342,17652,11
Evangeline,7/1/2020,11730,10469,1261,10.8,160132,143779,16352,10.2
Evangeline,8/1/2020,11712,10667,1045,8.9,160706,147245,13461,8.4
Evangeline,9/1/2020,11985,10940,1045,8.7,160174,147620,12554,7.8
Evangeline,10/1/2020,12026,11113,913,7.6,161003,149931,11072,6.9
Evangeline,11/1/2020,11884,11068,816,6.9,160629,149934,10694,6.7
Evangeline,12/1/2020,11894,11075,819,6.9,160745,149975,10770,6.7
Evangeline,1/1/2021,11797,10939,858,7.3,160088,149852,10236,6.4
Evangeline,2/1/2021,11860,11054,806,6.8,160184,150189,9995,6.2
Evangeline,3/1/2021,12147,11402,745,6.1,160400,150644,9756,6.1
Evangeline,4/1/2021,12190,11491,699,5.7,160843,151081,9762,6.1
Evangeline,5/1/2021,12115,11407,708,5.8,160800,151535,9266,5.8
Evangeline,6/1/2021,12269,11434,835,6.8,161197,151734,9462,5.9
Evangeline,7/1/2021,11919,11168,751,6.3,161504,152773,8731,5.4
Evangeline,8/1/2021,11649,10984,665,5.7,161527,153250,8276,5.1
Evangeline,9/1/2021,11925,11353,572,4.8,161495,153843,7652,4.7
Evangeline,10/1/2021,11660,11149,511,4.4,161754,154475,7279,4.5
Evangeline,11/1/2021,11650,11187,463,4,162281,155530,6751,4.2
Evangeline,12/1/2021,11647,11231,416,3.6,162497,156099,6398,3.9
Evangeline,1/1/2022,11780,11241,539,4.6,163627,157115,6512,4
Evangeline,2/1/2022,11867,11379,488,4.1,163899,157598,6301,3.8
Evangeline,3/1/2022,12204,11737,467,3.8,164220,158206,6014,3.7
Evangeline,4/1/2022,12257,11819,438,3.6,163893,157891,6002,3.7
Evangeline,5/1/2022,12174,11708,466,3.8,164362,158378,5983,3.6
Evangeline,6/1/2022,12318,11683,635,5.2,164046,158094,5951,3.6
Evangeline,7/1/2022,11942,11363,579,4.8,164026,158258,5768,3.5
Evangeline,8/1/2022,11762,11233,529,4.5,164654,158735,5919,3.6
Evangeline,9/1/2022,11847,11376,471,4,164602,158810,5792,3.5
Evangeline,10/1/2022,11750,11313,437,3.7,164648,158684,5964,3.6
Evangeline,11/1/2022,11695,11286,409,3.5,164450,158507,5943,3.6
Evangeline,12/1/2022,11730,11320,410,3.5,165025,159259,5766,3.5
Evangeline,1/1/2023,11940,11447,493,4.1,165964,160217,5747,3.5
Evangeline,2/1/2023,11959,11493,466,3.9,166358,160395,5962,3.6
Evangeline,3/1/2023,12129,11685,444,3.7,166651,160812,5839,3.5
Evangeline,4/1/2023,12307,11923,384,3.1,166725,160974,5751,3.4
Evangeline,5/1/2023,12301,11840,461,3.7,166886,160796,6089,3.6
Evangeline,6/1/2023,12335,11753,582,4.7,166937,160979,5958,3.6
Evangeline,7/1/2023,12278,11793,485,4,167103,161183,5920,3.5
Evangeline,8/1/2023,12134,11634,500,4.1,167759,161475,6284,3.7
Evangeline,9/1/2023,12195,11677,518,4.2,167767,161442,6326,3.8
Evangeline,10/1/2023,12166,11664,502,4.1,167690,161211,6479,3.9
Evangeline,11/1/2023,12202,11721,481,3.9,168140,161886,6254,3.7
Evangeline,12/1/2023,12139,11662,477,3.9,167439,161124,6315,3.8
Evangeline,1/1/2024,12296,11747,549,4.5,167339,161190,6149,3.7
Evangeline,2/1/2024,12278,11744,534,4.3,167475,161013,6462,3.9
Evangeline,3/1/2024,12453,11939,514,4.1,167922,161425,6497,3.9
Evangeline,4/1/2024,12558,12076,482,3.8,167988,161495,6492,3.9
Evangeline,5/1/2024,12492,11954,538,4.3,167799,161164,6635,4
Evangeline,6/1/2024,12342,11655,687,5.6,168005,161155,6849,4.1
Evangeline,7/1/2024,12215,11531,684,5.6,168315,161219,7097,4.2
Evangeline,8/1/2024,12057,11405,652,5.4,168496,161425,7071,4.2
Evangeline,9/1/2024,12183,11554,629,5.2,168703,161802,6901,4.1
Evangeline,10/1/2024,12106,11490,616,5.1,168428,161456,6972,4.1
Evangeline,11/1/2024,12006,11406,600,5,168304,161183,7121,4.2
Evangeline,12/1/2024,11964,11406,558,4.7,168547,161661,6886,4.1
Evangeline,1/1/2025,11587,11027,560,4.8,170744,163895,6849,4
Evangeline,2/1/2025,11681,11147,534,4.6,170359,163307,7052,4.1
Franklin,1/1/1990,8614,7631,983,11.4,125833,119081,6752,5.4
Franklin,2/1/1990,8357,7541,816,9.8,125710,119059,6651,5.3
Franklin,3/1/1990,8482,7716,766,9,125801,119203,6598,5.2
Franklin,4/1/1990,8522,7860,662,7.8,125649,118852,6797,5.4
Franklin,5/1/1990,8832,8140,692,7.8,125893,119151,6742,5.4
Franklin,6/1/1990,9082,8297,785,8.6,125573,118983,6590,5.2
Franklin,7/1/1990,9027,8380,647,7.2,125732,118810,6922,5.5
Franklin,8/1/1990,9037,8413,624,6.9,125990,118802,7188,5.7
Franklin,9/1/1990,9077,8456,621,6.8,125892,118524,7368,5.9
Franklin,10/1/1990,8756,8216,540,6.2,125995,118536,7459,5.9
Franklin,11/1/1990,8758,8108,650,7.4,126070,118306,7764,6.2
Franklin,12/1/1990,8667,7819,848,9.8,126142,118241,7901,6.3
Franklin,1/1/1991,9262,8011,1251,13.5,125955,117940,8015,6.4
Franklin,2/1/1991,9300,8151,1149,12.4,126020,117755,8265,6.6
Franklin,3/1/1991,9353,8269,1084,11.6,126238,117652,8586,6.8
Franklin,4/1/1991,9453,8432,1021,10.8,126548,118109,8439,6.7
Franklin,5/1/1991,9755,8543,1212,12.4,126176,117440,8736,6.9
Franklin,6/1/1991,10041,8745,1296,12.9,126331,117639,8692,6.9
Franklin,7/1/1991,9963,8925,1038,10.4,126154,117568,8586,6.8
Franklin,8/1/1991,9691,8745,946,9.8,126150,117484,8666,6.9
Franklin,9/1/1991,9464,8572,892,9.4,126650,117928,8722,6.9
Franklin,10/1/1991,9496,8713,783,8.2,126642,117800,8842,7
Franklin,11/1/1991,9570,8765,805,8.4,126701,117770,8931,7
Franklin,12/1/1991,9627,8491,1136,11.8,126664,117466,9198,7.3
Franklin,1/1/1992,10070,8587,1483,14.7,127261,117978,9283,7.3
Franklin,2/1/1992,10273,9000,1273,12.4,127207,117753,9454,7.4
Franklin,3/1/1992,10492,9155,1337,12.7,127604,118144,9460,7.4
Franklin,4/1/1992,10507,9332,1175,11.2,127841,118426,9415,7.4
Franklin,5/1/1992,10630,9426,1204,11.3,128119,118375,9744,7.6
Franklin,6/1/1992,10949,9480,1469,13.4,128459,118419,10040,7.8
Franklin,7/1/1992,10937,9768,1169,10.7,128563,118713,9850,7.7
Franklin,8/1/1992,10671,9630,1041,9.8,128613,118826,9787,7.6
Franklin,9/1/1992,10648,9742,906,8.5,128501,118720,9781,7.6
Franklin,10/1/1992,10304,9526,778,7.6,128026,118628,9398,7.3
Franklin,11/1/1992,10290,9498,792,7.7,128441,118876,9565,7.4
Franklin,12/1/1992,10160,9273,887,8.7,128554,118997,9557,7.4
Franklin,1/1/1993,10173,9134,1039,10.2,128400,119075,9325,7.3
Franklin,2/1/1993,10090,9165,925,9.2,128458,119275,9183,7.1
Franklin,3/1/1993,10371,9385,986,9.5,128598,119542,9056,7
Franklin,4/1/1993,10296,9423,873,8.5,128584,119474,9110,7.1
Franklin,5/1/1993,10309,9444,865,8.4,129264,120115,9149,7.1
Franklin,6/1/1993,10496,9484,1012,9.6,129411,120290,9121,7
Franklin,7/1/1993,10492,9573,919,8.8,129397,120467,8930,6.9
Franklin,8/1/1993,10418,9549,869,8.3,129619,120856,8763,6.8
Franklin,9/1/1993,9890,9171,719,7.3,129268,120554,8714,6.7
Franklin,10/1/1993,9956,9193,763,7.7,129573,120823,8750,6.8
Franklin,11/1/1993,9825,8992,833,8.5,129711,121169,8542,6.6
Franklin,12/1/1993,9964,9017,947,9.5,129941,121464,8477,6.5
Franklin,1/1/1994,10472,9235,1237,11.8,130596,121966,8630,6.6
Franklin,2/1/1994,10451,9349,1102,10.5,130669,122086,8583,6.6
Franklin,3/1/1994,10766,9708,1058,9.8,130400,121930,8470,6.5
Franklin,4/1/1994,10803,9819,984,9.1,130621,122290,8331,6.4
Franklin,5/1/1994,10622,9726,896,8.4,130779,122864,7915,6.1
Franklin,6/1/1994,10453,9523,930,8.9,130561,122634,7927,6.1
Franklin,7/1/1994,10490,9438,1052,10,130652,122706,7946,6.1
Franklin,8/1/1994,10512,9435,1077,10.2,131275,123342,7933,6
Franklin,9/1/1994,10431,9518,913,8.8,131421,123687,7734,5.9
Franklin,10/1/1994,10638,9738,900,8.5,131744,124112,7632,5.8
Franklin,11/1/1994,10545,9726,819,7.8,131891,124516,7375,5.6
Franklin,12/1/1994,10477,9534,943,9,131951,124721,7230,5.5
Franklin,1/1/1995,10166,9017,1149,11.3,132038,124663,7375,5.6
Franklin,2/1/1995,10029,9061,968,9.7,132115,124928,7187,5.4
Franklin,3/1/1995,10089,9158,931,9.2,132108,124955,7153,5.4
Franklin,4/1/1995,9943,9079,864,8.7,132590,124945,7645,5.8
Franklin,5/1/1995,9817,9034,783,8,131851,124421,7430,5.6
Franklin,6/1/1995,10242,9234,1008,9.8,131949,124522,7427,5.6
Franklin,7/1/1995,12470,11494,976,7.8,132343,124816,7527,5.7
Franklin,8/1/1995,12615,11673,942,7.5,132336,124852,7484,5.7
Franklin,9/1/1995,12397,11620,777,6.3,132611,125133,7478,5.6
Franklin,10/1/1995,12221,11487,734,6,132716,125388,7328,5.5
Franklin,11/1/1995,11516,10749,767,6.7,132614,125188,7426,5.6
Franklin,12/1/1995,10229,9416,813,7.9,132511,125088,7423,5.6
Franklin,1/1/1996,9666,8589,1077,11.1,132616,125125,7491,5.6
Franklin,2/1/1996,9454,8580,874,9.2,132952,125639,7313,5.5
Franklin,3/1/1996,9581,8782,799,8.3,133180,125862,7318,5.5
Franklin,4/1/1996,10111,9209,902,8.9,133409,125994,7415,5.6
Franklin,5/1/1996,9819,8924,895,9.1,133667,126244,7423,5.6
Franklin,6/1/1996,10034,9060,974,9.7,133697,126602,7095,5.3
Franklin,7/1/1996,10175,9100,1075,10.6,134284,126947,7337,5.5
Franklin,8/1/1996,9985,8893,1092,10.9,134054,127172,6882,5.1
Franklin,9/1/1996,9951,9044,907,9.1,134515,127536,6979,5.2
Franklin,10/1/1996,9712,8912,800,8.2,134921,127890,7031,5.2
Franklin,11/1/1996,9491,8733,758,8,135007,127771,7236,5.4
Franklin,12/1/1996,9383,8470,913,9.7,135113,127860,7253,5.4
Franklin,1/1/1997,9531,8403,1128,11.8,135456,128298,7158,5.3
Franklin,2/1/1997,9498,8556,942,9.9,135400,128298,7102,5.2
Franklin,3/1/1997,9735,8677,1058,10.9,135891,128891,7000,5.2
Franklin,4/1/1997,9682,8814,868,9,136016,129143,6873,5.1
Franklin,5/1/1997,9652,8826,826,8.6,136119,129464,6655,4.9
Franklin,6/1/1997,10263,9188,1075,10.5,136211,129412,6799,5
Franklin,7/1/1997,10081,9011,1070,10.6,136477,129822,6655,4.9
Franklin,8/1/1997,9673,8714,959,9.9,136618,130010,6608,4.8
Franklin,9/1/1997,9490,8598,892,9.4,136675,130019,6656,4.9
Franklin,10/1/1997,9408,8670,738,7.8,136633,130179,6454,4.7
Franklin,11/1/1997,9386,8572,814,8.7,136961,130653,6308,4.6
Franklin,12/1/1997,9492,8472,1020,10.7,137155,130679,6476,4.7
Franklin,1/1/1998,9620,8424,1196,12.4,137095,130726,6368,4.6
Franklin,2/1/1998,9328,8397,931,10,137112,130807,6306,4.6
Franklin,3/1/1998,9531,8458,1073,11.3,137236,130814,6422,4.7
Franklin,4/1/1998,9438,8438,1000,10.6,137150,131209,5941,4.3
Franklin,5/1/1998,9537,8561,976,10.2,137372,131325,6047,4.4
Franklin,6/1/1998,9972,8943,1029,10.3,137455,131244,6212,4.5
Franklin,7/1/1998,9967,8955,1012,10.2,137588,131329,6259,4.5
Franklin,8/1/1998,9846,8752,1094,11.1,137570,131390,6179,4.5
Franklin,9/1/1998,9696,8686,1010,10.4,138286,131986,6300,4.6
Franklin,10/1/1998,9622,8753,869,9,138279,131999,6280,4.5
Franklin,11/1/1998,9599,8683,916,9.5,138381,132280,6100,4.4
Franklin,12/1/1998,9752,8853,899,9.2,138634,132602,6032,4.4
Franklin,1/1/1999,9702,8690,1012,10.4,139003,133027,5976,4.3
Franklin,2/1/1999,9371,8558,813,8.7,138967,132856,6111,4.4
Franklin,3/1/1999,9466,8709,757,8,138730,132947,5783,4.2
Franklin,4/1/1999,9419,8743,676,7.2,138959,132955,6004,4.3
Franklin,5/1/1999,9488,8865,623,6.6,139107,133311,5796,4.2
Franklin,6/1/1999,10033,9255,778,7.8,139329,133378,5951,4.3
Franklin,7/1/1999,10268,9429,839,8.2,139439,133414,6025,4.3
Franklin,8/1/1999,10067,9314,753,7.5,139430,133591,5838,4.2
Franklin,9/1/1999,9841,9121,720,7.3,139622,133707,5915,4.2
Franklin,10/1/1999,9907,9237,670,6.8,139771,133993,5778,4.1
Franklin,11/1/1999,9659,9075,584,6,140025,134309,5716,4.1
Franklin,12/1/1999,9644,8988,656,6.8,140177,134523,5653,4
Franklin,1/1/2000,7984,7346,638,8,142267,136559,5708,4
Franklin,2/1/2000,7819,7270,549,7,142456,136598,5858,4.1
Franklin,3/1/2000,7852,7307,545,6.9,142434,136701,5733,4
Franklin,4/1/2000,8225,7755,470,5.7,142751,137270,5481,3.8
Franklin,5/1/2000,8198,7656,542,6.6,142388,136630,5758,4
Franklin,6/1/2000,8347,7730,617,7.4,142591,136940,5651,4
Franklin,7/1/2000,8242,7667,575,7,142278,136531,5747,4
Franklin,8/1/2000,8165,7558,607,7.4,142514,136662,5853,4.1
Franklin,9/1/2000,8262,7711,551,6.7,142518,136893,5625,3.9
Franklin,10/1/2000,8278,7743,535,6.5,142622,137088,5534,3.9
Franklin,11/1/2000,8284,7645,639,7.7,142962,137322,5639,3.9
Franklin,12/1/2000,8354,7647,707,8.5,143248,137614,5634,3.9
Franklin,1/1/2001,8132,7249,883,10.9,143800,137778,6023,4.2
Franklin,2/1/2001,7986,7253,733,9.2,143701,137612,6089,4.2
Franklin,3/1/2001,8218,7451,767,9.3,143924,137783,6141,4.3
Franklin,4/1/2001,8193,7569,624,7.6,143569,137299,6271,4.4
Franklin,5/1/2001,8100,7535,565,7,143318,137092,6226,4.3
Franklin,6/1/2001,8368,7685,683,8.2,143357,136873,6484,4.5
Franklin,7/1/2001,8157,7538,619,7.6,143654,137071,6583,4.6
Franklin,8/1/2001,8066,7423,643,8,143284,136241,7042,4.9
Franklin,9/1/2001,8171,7498,673,8.2,143989,136846,7142,5
Franklin,10/1/2001,7991,7392,599,7.5,144086,136392,7694,5.3
Franklin,11/1/2001,7968,7304,664,8.3,144240,136238,8003,5.5
Franklin,12/1/2001,8038,7175,863,10.7,144305,136047,8258,5.7
Franklin,1/1/2002,8037,6968,1069,13.3,143883,135701,8182,5.7
Franklin,2/1/2002,7841,6983,858,10.9,144653,136438,8215,5.7
Franklin,3/1/2002,7958,7027,931,11.7,144481,136177,8304,5.7
Franklin,4/1/2002,7887,7104,783,9.9,144725,136126,8599,5.9
Franklin,5/1/2002,7902,7175,727,9.2,144938,136539,8399,5.8
Franklin,6/1/2002,7974,7152,822,10.3,144808,136415,8393,5.8
Franklin,7/1/2002,7997,7224,773,9.7,144803,136413,8390,5.8
Franklin,8/1/2002,8028,7276,752,9.4,145009,136705,8304,5.7
Franklin,9/1/2002,8056,7345,711,8.8,145552,137302,8251,5.7
Franklin,10/1/2002,8074,7421,653,8.1,145314,137008,8307,5.7
Franklin,11/1/2002,8049,7335,714,8.9,145041,136521,8520,5.9
Franklin,12/1/2002,8094,7279,815,10.1,145066,136426,8640,6
Franklin,1/1/2003,8214,7232,982,12,145937,137417,8520,5.8
Franklin,2/1/2003,7908,7035,873,11,146100,137482,8618,5.9
Franklin,3/1/2003,8045,7148,897,11.1,146022,137434,8588,5.9
Franklin,4/1/2003,7974,7191,783,9.8,146474,137633,8842,6
Franklin,5/1/2003,7872,7117,755,9.6,146500,137544,8957,6.1
Franklin,6/1/2003,8172,7316,856,10.5,147056,137790,9266,6.3
Franklin,7/1/2003,8022,7218,804,10,146485,137474,9011,6.2
Franklin,8/1/2003,8147,7396,751,9.2,146445,137549,8896,6.1
Franklin,9/1/2003,8119,7456,663,8.2,146530,137609,8921,6.1
Franklin,10/1/2003,8204,7591,613,7.5,146716,137984,8732,6
Franklin,11/1/2003,8063,7412,651,8.1,147000,138424,8576,5.8
Franklin,12/1/2003,7848,7144,704,9,146729,138411,8317,5.7
Franklin,1/1/2004,7807,6872,935,12,146842,138472,8370,5.7
Franklin,2/1/2004,7637,6862,775,10.1,146709,138542,8167,5.6
Franklin,3/1/2004,7616,6831,785,10.3,146944,138453,8491,5.8
Franklin,4/1/2004,7701,7024,677,8.8,146850,138680,8170,5.6
Franklin,5/1/2004,7656,7026,630,8.2,147065,138852,8212,5.6
Franklin,6/1/2004,7836,7115,721,9.2,147460,139174,8286,5.6
Franklin,7/1/2004,7912,7241,671,8.5,147692,139556,8136,5.5
Franklin,8/1/2004,7835,7221,614,7.8,147564,139573,7990,5.4
Franklin,9/1/2004,7835,7227,608,7.8,147415,139487,7927,5.4
Franklin,10/1/2004,7898,7307,591,7.5,147793,139732,8061,5.5
Franklin,11/1/2004,7695,7126,569,7.4,148162,140231,7932,5.4
Franklin,12/1/2004,7529,6908,621,8.2,148059,140125,7934,5.4
Franklin,1/1/2005,7654,6859,795,10.4,148029,140245,7784,5.3
Franklin,2/1/2005,7435,6756,679,9.1,148364,140385,7980,5.4
Franklin,3/1/2005,7447,6790,657,8.8,148391,140654,7737,5.2
Franklin,4/1/2005,7727,7118,609,7.9,148926,141254,7672,5.2
Franklin,5/1/2005,7638,7061,577,7.6,149261,141609,7651,5.1
Franklin,6/1/2005,7894,7214,680,8.6,149238,141714,7524,5
Franklin,7/1/2005,7847,7212,635,8.1,149432,142026,7406,5
Franklin,8/1/2005,7639,7048,591,7.7,149779,142434,7345,4.9
Franklin,9/1/2005,8460,7528,932,11,149954,142401,7553,5
Franklin,10/1/2005,8487,7667,820,9.7,150001,142548,7453,5
Franklin,11/1/2005,8241,7380,861,10.4,150065,142499,7566,5
Franklin,12/1/2005,7952,7322,630,7.9,150030,142752,7279,4.9
Franklin,1/1/2006,7750,7180,570,7.4,150214,143150,7064,4.7
Franklin,2/1/2006,7688,7203,485,6.3,150641,143457,7184,4.8
Franklin,3/1/2006,7850,7408,442,5.6,150813,143741,7072,4.7
Franklin,4/1/2006,7910,7477,433,5.5,150881,143761,7120,4.7
Franklin,5/1/2006,7858,7402,456,5.8,151069,144089,6980,4.6
Franklin,6/1/2006,7998,7462,536,6.7,151354,144353,7001,4.6
Franklin,7/1/2006,7906,7413,493,6.2,151377,144202,7175,4.7
Franklin,8/1/2006,7852,7359,493,6.3,151716,144625,7091,4.7
Franklin,9/1/2006,8017,7564,453,5.7,151662,144815,6847,4.5
Franklin,10/1/2006,8022,7601,421,5.2,152041,145314,6727,4.4
Franklin,11/1/2006,7923,7503,420,5.3,152406,145534,6872,4.5
Franklin,12/1/2006,7752,7293,459,5.9,152732,145970,6762,4.4
Franklin,1/1/2007,7911,7312,599,7.6,153144,146028,7116,4.6
Franklin,2/1/2007,7954,7413,541,6.8,152983,146057,6927,4.5
Franklin,3/1/2007,7892,7404,488,6.2,153051,146320,6731,4.4
Franklin,4/1/2007,7821,7345,476,6.1,152435,145586,6850,4.5
Franklin,5/1/2007,7675,7198,477,6.2,152670,145903,6766,4.4
Franklin,6/1/2007,7749,7192,557,7.2,153041,146063,6979,4.6
Franklin,7/1/2007,7656,7107,549,7.2,153054,145905,7149,4.7
Franklin,8/1/2007,7726,7227,499,6.5,152749,145682,7067,4.6
Franklin,9/1/2007,7940,7474,466,5.9,153414,146244,7170,4.7
Franklin,10/1/2007,7771,7372,399,5.1,153183,145946,7237,4.7
Franklin,11/1/2007,7841,7419,422,5.4,153835,146595,7240,4.7
Franklin,12/1/2007,7760,7212,548,7.1,153918,146273,7645,5
Franklin,1/1/2008,7825,7217,608,7.8,154063,146378,7685,5
Franklin,2/1/2008,7740,7226,514,6.6,153653,146156,7497,4.9
Franklin,3/1/2008,7964,7452,512,6.4,153908,146086,7822,5.1
Franklin,4/1/2008,7909,7455,454,5.7,153769,146132,7637,5
Franklin,5/1/2008,7793,7323,470,6,154303,145908,8395,5.4
Franklin,6/1/2008,7866,7291,575,7.3,154313,145737,8575,5.6
Franklin,7/1/2008,7893,7255,638,8.1,154469,145532,8937,5.8
Franklin,8/1/2008,7741,7135,606,7.8,154641,145203,9438,6.1
Franklin,9/1/2008,7649,7099,550,7.2,154570,145076,9494,6.1
Franklin,10/1/2008,7857,7312,545,6.9,154876,144802,10074,6.5
Franklin,11/1/2008,7990,7377,613,7.7,154639,144100,10538,6.8
Franklin,12/1/2008,7646,6959,687,9,154655,143369,11286,7.3
Franklin,1/1/2009,7757,6885,872,11.2,154210,142152,12058,7.8
Franklin,2/1/2009,7796,6976,820,10.5,154538,141640,12898,8.3
Franklin,3/1/2009,7788,6959,829,10.6,154133,140707,13426,8.7
Franklin,4/1/2009,8061,7251,810,10,154509,140656,13853,9
Franklin,5/1/2009,8037,7223,814,10.1,154747,140248,14499,9.4
Franklin,6/1/2009,8126,7198,928,11.4,154716,140009,14707,9.5
Franklin,7/1/2009,8036,7113,923,11.5,154502,139901,14601,9.5
Franklin,8/1/2009,7805,6963,842,10.8,154307,139492,14814,9.6
Franklin,9/1/2009,7672,6868,804,10.5,153827,138818,15009,9.8
Franklin,10/1/2009,7657,6895,762,10,153784,138432,15352,10
Franklin,11/1/2009,7700,6967,733,9.5,153878,138659,15219,9.9
Franklin,12/1/2009,7698,6893,805,10.5,153111,138013,15098,9.9
Franklin,1/1/2010,7979,7093,886,11.1,153484,138438,15046,9.8
Franklin,2/1/2010,8174,7345,829,10.1,153694,138581,15113,9.8
Franklin,3/1/2010,8258,7447,811,9.8,153954,138751,15202,9.9
Franklin,4/1/2010,8386,7605,781,9.3,154622,139297,15325,9.9
Franklin,5/1/2010,8465,7621,844,10,154091,139241,14849,9.6
Franklin,6/1/2010,8609,7681,928,10.8,153616,139141,14474,9.4
Franklin,7/1/2010,8585,7654,931,10.8,153691,139179,14512,9.4
Franklin,8/1/2010,8517,7607,910,10.7,154086,139438,14648,9.5
Franklin,9/1/2010,8404,7546,858,10.2,153975,139396,14579,9.5
Franklin,10/1/2010,8234,7417,817,9.9,153635,139119,14516,9.4
Franklin,11/1/2010,8205,7353,852,10.4,154125,139044,15081,9.8
Franklin,12/1/2010,8126,7210,916,11.3,153650,139301,14348,9.3
Franklin,1/1/2011,8039,7019,1020,12.7,153263,139250,14013,9.1
Franklin,2/1/2011,7949,6984,965,12.1,153214,139394,13820,9
Franklin,3/1/2011,7951,7033,918,11.5,153376,139639,13737,9
Franklin,4/1/2011,7999,7164,835,10.4,153543,139586,13957,9.1
Franklin,5/1/2011,8049,7206,843,10.5,153479,139624,13855,9
Franklin,6/1/2011,8225,7259,966,11.7,153346,139384,13962,9.1
Franklin,7/1/2011,8147,7228,919,11.3,153288,139524,13763,9
Franklin,8/1/2011,7950,7080,870,10.9,153760,139942,13818,9
Franklin,9/1/2011,7882,7059,823,10.4,154131,140183,13948,9
Franklin,10/1/2011,7880,7097,783,9.9,153961,140368,13594,8.8
Franklin,11/1/2011,7886,7123,763,9.7,154128,140826,13302,8.6
Franklin,12/1/2011,7828,7011,817,10.4,153995,140902,13093,8.5
Franklin,1/1/2012,7588,6711,877,11.6,154381,141584,12797,8.3
Franklin,2/1/2012,7626,6796,830,10.9,154671,141858,12813,8.3
Franklin,3/1/2012,7638,6867,771,10.1,154749,142036,12713,8.2
Franklin,4/1/2012,7610,6899,711,9.3,154545,141899,12646,8.2
Franklin,5/1/2012,7807,7044,763,9.8,154866,142206,12660,8.2
Franklin,6/1/2012,7982,7140,842,10.5,155083,142391,12692,8.2
Franklin,7/1/2012,8081,7205,876,10.8,154948,142292,12656,8.2
Franklin,8/1/2012,7719,6924,795,10.3,154763,142291,12471,8.1
Franklin,9/1/2012,7722,7020,702,9.1,155160,143044,12115,7.8
Franklin,10/1/2012,7621,6985,636,8.3,155554,143431,12124,7.8
Franklin,11/1/2012,7635,6997,638,8.4,155338,143333,12005,7.7
Franklin,12/1/2012,7696,6972,724,9.4,155628,143330,12298,7.9
Franklin,1/1/2013,7681,6831,850,11.1,155763,143292,12471,8
Franklin,2/1/2013,7670,6886,784,10.2,155312,143362,11950,7.7
Franklin,3/1/2013,7624,6857,767,10.1,155005,143316,11689,7.5
Franklin,4/1/2013,7561,6823,738,9.8,155394,143635,11760,7.6
Franklin,5/1/2013,7723,6975,748,9.7,155536,143882,11654,7.5
Franklin,6/1/2013,7841,6994,847,10.8,155749,143999,11751,7.5
Franklin,7/1/2013,7915,7110,805,10.2,155599,144264,11335,7.3
Franklin,8/1/2013,7789,7043,746,9.6,155605,144326,11279,7.2
Franklin,9/1/2013,7784,7075,709,9.1,155687,144418,11270,7.2
Franklin,10/1/2013,7599,6957,642,8.4,154673,143537,11136,7.2
Franklin,11/1/2013,7562,6931,631,8.3,155265,144479,10787,6.9
Franklin,12/1/2013,7569,6930,639,8.4,155182,144778,10404,6.7
Franklin,1/1/2014,7519,6854,665,8.8,155352,145150,10202,6.6
Franklin,2/1/2014,7517,6898,619,8.2,155483,145134,10349,6.7
Franklin,3/1/2014,7439,6806,633,8.5,156028,145648,10380,6.7
Franklin,4/1/2014,7407,6823,584,7.9,155369,145667,9702,6.2
Franklin,5/1/2014,7452,6801,651,8.7,155684,145825,9859,6.3
Franklin,6/1/2014,7605,6875,730,9.6,155707,146247,9460,6.1
Franklin,7/1/2014,7670,6878,792,10.3,156007,146399,9608,6.2
Franklin,8/1/2014,7587,6806,781,10.3,156130,146530,9599,6.1
Franklin,9/1/2014,7667,6918,749,9.8,156040,146778,9262,5.9
Franklin,10/1/2014,7583,6887,696,9.2,156417,147427,8990,5.7
Franklin,11/1/2014,7582,6854,728,9.6,156494,147404,9090,5.8
Franklin,12/1/2014,7606,6851,755,9.9,156332,147615,8717,5.6
Franklin,1/1/2015,7604,6792,812,10.7,157030,148145,8885,5.7
Franklin,2/1/2015,7510,6773,737,9.8,156644,148045,8599,5.5
Franklin,3/1/2015,7528,6753,775,10.3,156643,148128,8515,5.4
Franklin,4/1/2015,7448,6710,738,9.9,157060,148511,8550,5.4
Franklin,5/1/2015,7566,6800,766,10.1,157651,148817,8834,5.6
Franklin,6/1/2015,7792,6978,814,10.4,157062,148816,8247,5.3
Franklin,7/1/2015,7661,6917,744,9.7,156997,148830,8167,5.2
Franklin,8/1/2015,7451,6773,678,9.1,157172,149181,7992,5.1
Franklin,9/1/2015,7346,6708,638,8.7,156733,148826,7907,5
Franklin,10/1/2015,7288,6663,625,8.6,157167,149246,7922,5
Franklin,11/1/2015,7238,6607,631,8.7,157463,149463,8000,5.1
Franklin,12/1/2015,7334,6677,657,9,158035,150128,7907,5
Franklin,1/1/2016,7287,6578,709,9.7,158280,150653,7627,4.8
Franklin,2/1/2016,7303,6610,693,9.5,158640,150939,7702,4.9
Franklin,3/1/2016,7334,6646,688,9.4,159179,151218,7961,5
Franklin,4/1/2016,7337,6677,660,9,159141,151074,8067,5.1
Franklin,5/1/2016,7432,6745,687,9.2,158784,151132,7652,4.8
Franklin,6/1/2016,7600,6860,740,9.7,158967,151223,7744,4.9
Franklin,7/1/2016,7371,6689,682,9.3,159194,151554,7641,4.8
Franklin,8/1/2016,7213,6561,652,9,159562,151779,7784,4.9
Franklin,9/1/2016,7183,6546,637,8.9,159714,151761,7953,5
Franklin,10/1/2016,7002,6435,567,8.1,159605,151793,7811,4.9
Franklin,11/1/2016,7117,6566,551,7.7,159506,151954,7553,4.7
Franklin,12/1/2016,7130,6519,611,8.6,159678,152157,7521,4.7
Franklin,1/1/2017,7209,6522,687,9.5,159620,152152,7468,4.7
Franklin,2/1/2017,7153,6572,581,8.1,159859,152480,7379,4.6
Franklin,3/1/2017,7258,6695,563,7.8,160137,153065,7073,4.4
Franklin,4/1/2017,7344,6794,550,7.5,160345,153255,7089,4.4
Franklin,5/1/2017,7455,6926,529,7.1,160068,153069,7000,4.4
Franklin,6/1/2017,7650,7039,611,8,160192,153318,6873,4.3
Franklin,7/1/2017,7457,6878,579,7.8,160462,153569,6892,4.3
Franklin,8/1/2017,7317,6760,557,7.6,160586,153503,7082,4.4
Franklin,9/1/2017,7271,6767,504,6.9,161140,154286,6854,4.3
Franklin,10/1/2017,7147,6717,430,6,160309,153609,6700,4.2
Franklin,11/1/2017,7136,6678,458,6.4,160579,153805,6774,4.2
Franklin,12/1/2017,7177,6697,480,6.7,160535,153904,6632,4.1
Franklin,1/1/2018,7206,6667,539,7.5,160914,154425,6489,4
Franklin,2/1/2018,7213,6689,524,7.3,161778,155197,6581,4.1
Franklin,3/1/2018,7298,6785,513,7,161686,155214,6472,4
Franklin,4/1/2018,7236,6744,492,6.8,161771,155312,6459,4
Franklin,5/1/2018,7374,6871,503,6.8,161848,155652,6196,3.8
Franklin,6/1/2018,7521,6911,610,8.1,162210,155762,6447,4
Franklin,7/1/2018,7466,6897,569,7.6,162341,156146,6195,3.8
Franklin,8/1/2018,7285,6740,545,7.5,161660,155504,6156,3.8
Franklin,9/1/2018,7215,6735,480,6.7,162087,156015,6073,3.7
Franklin,10/1/2018,7151,6704,447,6.3,162602,156391,6211,3.8
Franklin,11/1/2018,7085,6631,454,6.4,162836,156721,6115,3.8
Franklin,12/1/2018,7134,6630,504,7.1,163206,156817,6389,3.9
Franklin,1/1/2019,7172,6587,585,8.2,162963,156487,6475,4
Franklin,2/1/2019,7192,6701,491,6.8,162999,156863,6136,3.8
Franklin,3/1/2019,7248,6788,460,6.3,162904,156701,6202,3.8
Franklin,4/1/2019,7252,6842,410,5.7,162586,156625,5961,3.7
Franklin,5/1/2019,7300,6848,452,6.2,162751,156821,5930,3.6
Franklin,6/1/2019,7563,6994,569,7.5,163168,157232,5935,3.6
Franklin,7/1/2019,7564,6984,580,7.7,163590,157529,6061,3.7
Franklin,8/1/2019,7536,6942,594,7.9,163774,157829,5945,3.6
Franklin,9/1/2019,7519,7000,519,6.9,164092,158339,5753,3.5
Franklin,10/1/2019,7413,6912,501,6.8,164416,158545,5871,3.6
Franklin,11/1/2019,7273,6791,482,6.6,164496,158629,5868,3.6
Franklin,12/1/2019,7276,6788,488,6.7,164699,158845,5853,3.6
Franklin,1/1/2020,7175,6636,539,7.5,164377,158508,5869,3.6
Franklin,2/1/2020,7200,6748,452,6.3,164467,158714,5753,3.5
Franklin,3/1/2020,7513,6750,763,10.2,162559,155353,7206,4.4
Franklin,4/1/2020,6891,6264,627,9.1,156269,133185,23084,14.8
Franklin,5/1/2020,7046,6341,705,10,158101,137173,20929,13.2
Franklin,6/1/2020,7287,6513,774,10.6,159994,142342,17652,11
Franklin,7/1/2020,7277,6504,773,10.6,160132,143779,16352,10.2
Franklin,8/1/2020,7376,6736,640,8.7,160706,147245,13461,8.4
Franklin,9/1/2020,7477,6822,655,8.8,160174,147620,12554,7.8
Franklin,10/1/2020,7379,6814,565,7.7,161003,149931,11072,6.9
Franklin,11/1/2020,7290,6781,509,7,160629,149934,10694,6.7
Franklin,12/1/2020,7293,6771,522,7.2,160745,149975,10770,6.7
Franklin,1/1/2021,7268,6719,549,7.6,160088,149852,10236,6.4
Franklin,2/1/2021,7308,6770,538,7.4,160184,150189,9995,6.2
Franklin,3/1/2021,7407,6890,517,7,160400,150644,9756,6.1
Franklin,4/1/2021,7356,6900,456,6.2,160843,151081,9762,6.1
Franklin,5/1/2021,7372,6912,460,6.2,160800,151535,9266,5.8
Franklin,6/1/2021,7499,6956,543,7.2,161197,151734,9462,5.9
Franklin,7/1/2021,7352,6860,492,6.7,161504,152773,8731,5.4
Franklin,8/1/2021,7353,6904,449,6.1,161527,153250,8276,5.1
Franklin,9/1/2021,7546,7178,368,4.9,161495,153843,7652,4.7
Franklin,10/1/2021,7387,7058,329,4.5,161754,154475,7279,4.5
Franklin,11/1/2021,7250,6933,317,4.4,162281,155530,6751,4.2
Franklin,12/1/2021,7262,6968,294,4,162497,156099,6398,3.9
Franklin,1/1/2022,7259,6891,368,5.1,163627,157115,6512,4
Franklin,2/1/2022,7308,6967,341,4.7,163899,157598,6301,3.8
Franklin,3/1/2022,7400,7072,328,4.4,164220,158206,6014,3.7
Franklin,4/1/2022,7401,7093,308,4.2,163893,157891,6002,3.7
Franklin,5/1/2022,7422,7080,342,4.6,164362,158378,5983,3.6
Franklin,6/1/2022,7520,7099,421,5.6,164046,158094,5951,3.6
Franklin,7/1/2022,7399,7002,397,5.4,164026,158258,5768,3.5
Franklin,8/1/2022,7304,6937,367,5,164654,158735,5919,3.6
Franklin,9/1/2022,7402,7038,364,4.9,164602,158810,5792,3.5
Franklin,10/1/2022,7316,6985,331,4.5,164648,158684,5964,3.6
Franklin,11/1/2022,7232,6902,330,4.6,164450,158507,5943,3.6
Franklin,12/1/2022,7298,6960,338,4.6,165025,159259,5766,3.5
Franklin,1/1/2023,7209,6821,388,5.4,165964,160217,5747,3.5
Franklin,2/1/2023,7250,6869,381,5.3,166358,160395,5962,3.6
Franklin,3/1/2023,7296,6928,368,5,166651,160812,5839,3.5
Franklin,4/1/2023,7354,7002,352,4.8,166725,160974,5751,3.4
Franklin,5/1/2023,7332,6946,386,5.3,166886,160796,6089,3.6
Franklin,6/1/2023,7462,7023,439,5.9,166937,160979,5958,3.6
Franklin,7/1/2023,7269,6879,390,5.4,167103,161183,5920,3.5
Franklin,8/1/2023,7242,6834,408,5.6,167759,161475,6284,3.7
Franklin,9/1/2023,7264,6902,362,5,167767,161442,6326,3.8
Franklin,10/1/2023,7220,6852,368,5.1,167690,161211,6479,3.9
Franklin,11/1/2023,7230,6867,363,5,168140,161886,6254,3.7
Franklin,12/1/2023,7237,6867,370,5.1,167439,161124,6315,3.8
Franklin,1/1/2024,7200,6769,431,6,167339,161190,6149,3.7
Franklin,2/1/2024,7121,6709,412,5.8,167475,161013,6462,3.9
Franklin,3/1/2024,7189,6801,388,5.4,167922,161425,6497,3.9
Franklin,4/1/2024,7198,6838,360,5,167988,161495,6492,3.9
Franklin,5/1/2024,7192,6809,383,5.3,167799,161164,6635,4
Franklin,6/1/2024,7381,6911,470,6.4,168005,161155,6849,4.1
Franklin,7/1/2024,7350,6871,479,6.5,168315,161219,7097,4.2
Franklin,8/1/2024,7282,6833,449,6.2,168496,161425,7071,4.2
Franklin,9/1/2024,7291,6870,421,5.8,168703,161802,6901,4.1
Franklin,10/1/2024,7203,6789,414,5.7,168428,161456,6972,4.1
Franklin,11/1/2024,7142,6699,443,6.2,168304,161183,7121,4.2
Franklin,12/1/2024,7165,6743,422,5.9,168547,161661,6886,4.1
Franklin,1/1/2025,7226,6785,441,6.1,170744,163895,6849,4
Franklin,2/1/2025,7074,6656,418,5.9,170359,163307,7052,4.1
Grant,1/1/1990,7015,6522,493,7,125833,119081,6752,5.4
Grant,2/1/1990,6934,6456,478,6.9,125710,119059,6651,5.3
Grant,3/1/1990,6866,6455,411,6,125801,119203,6598,5.2
Grant,4/1/1990,6967,6566,401,5.8,125649,118852,6797,5.4
Grant,5/1/1990,6949,6546,403,5.8,125893,119151,6742,5.4
Grant,6/1/1990,7126,6624,502,7,125573,118983,6590,5.2
Grant,7/1/1990,6989,6514,475,6.8,125732,118810,6922,5.5
Grant,8/1/1990,7025,6515,510,7.3,125990,118802,7188,5.7
Grant,9/1/1990,7383,6902,481,6.5,125892,118524,7368,5.9
Grant,10/1/1990,6847,6429,418,6.1,125995,118536,7459,5.9
Grant,11/1/1990,7022,6555,467,6.7,126070,118306,7764,6.2
Grant,12/1/1990,7052,6528,524,7.4,126142,118241,7901,6.3
Grant,1/1/1991,6820,6067,753,11,125955,117940,8015,6.4
Grant,2/1/1991,6799,6163,636,9.4,126020,117755,8265,6.6
Grant,3/1/1991,6765,6207,558,8.2,126238,117652,8586,6.8
Grant,4/1/1991,6741,6163,578,8.6,126548,118109,8439,6.7
Grant,5/1/1991,6743,6119,624,9.3,126176,117440,8736,6.9
Grant,6/1/1991,6824,6163,661,9.7,126331,117639,8692,6.9
Grant,7/1/1991,7033,6459,574,8.2,126154,117568,8586,6.8
Grant,8/1/1991,7037,6476,561,8,126150,117484,8666,6.9
Grant,9/1/1991,6900,6338,562,8.1,126650,117928,8722,6.9
Grant,10/1/1991,6880,6321,559,8.1,126642,117800,8842,7
Grant,11/1/1991,6733,6198,535,7.9,126701,117770,8931,7
Grant,12/1/1991,6658,6052,606,9.1,126664,117466,9198,7.3
Grant,1/1/1992,6928,6128,800,11.5,127261,117978,9283,7.3
Grant,2/1/1992,6837,6095,742,10.9,127207,117753,9454,7.4
Grant,3/1/1992,6973,6239,734,10.5,127604,118144,9460,7.4
Grant,4/1/1992,6771,6158,613,9.1,127841,118426,9415,7.4
Grant,5/1/1992,6796,6164,632,9.3,128119,118375,9744,7.6
Grant,6/1/1992,7052,6288,764,10.8,128459,118419,10040,7.8
Grant,7/1/1992,7276,6597,679,9.3,128563,118713,9850,7.7
Grant,8/1/1992,7132,6513,619,8.7,128613,118826,9787,7.6
Grant,9/1/1992,7111,6478,633,8.9,128501,118720,9781,7.6
Grant,10/1/1992,7075,6487,588,8.3,128026,118628,9398,7.3
Grant,11/1/1992,6927,6405,522,7.5,128441,118876,9565,7.4
Grant,12/1/1992,6863,6308,555,8.1,128554,118997,9557,7.4
Grant,1/1/1993,7014,6358,656,9.4,128400,119075,9325,7.3
Grant,2/1/1993,6912,6344,568,8.2,128458,119275,9183,7.1
Grant,3/1/1993,6897,6364,533,7.7,128598,119542,9056,7
Grant,4/1/1993,6840,6365,475,6.9,128584,119474,9110,7.1
Grant,5/1/1993,6982,6518,464,6.6,129264,120115,9149,7.1
Grant,6/1/1993,7060,6553,507,7.2,129411,120290,9121,7
Grant,7/1/1993,6782,6311,471,6.9,129397,120467,8930,6.9
Grant,8/1/1993,6838,6375,463,6.8,129619,120856,8763,6.8
Grant,9/1/1993,6737,6303,434,6.4,129268,120554,8714,6.7
Grant,10/1/1993,6986,6535,451,6.5,129573,120823,8750,6.8
Grant,11/1/1993,6947,6493,454,6.5,129711,121169,8542,6.6
Grant,12/1/1993,6888,6374,514,7.5,129941,121464,8477,6.5
Grant,1/1/1994,6550,5681,869,13.3,130596,121966,8630,6.6
Grant,2/1/1994,6461,5603,858,13.3,130669,122086,8583,6.6
Grant,3/1/1994,6536,5716,820,12.5,130400,121930,8470,6.5
Grant,4/1/1994,6472,5709,763,11.8,130621,122290,8331,6.4
Grant,5/1/1994,6406,5650,756,11.8,130779,122864,7915,6.1
Grant,6/1/1994,6574,5745,829,12.6,130561,122634,7927,6.1
Grant,7/1/1994,6608,5816,792,12,130652,122706,7946,6.1
Grant,8/1/1994,6628,5850,778,11.7,131275,123342,7933,6
Grant,9/1/1994,6509,5780,729,11.2,131421,123687,7734,5.9
Grant,10/1/1994,6755,6064,691,10.2,131744,124112,7632,5.8
Grant,11/1/1994,6772,6123,649,9.6,131891,124516,7375,5.6
Grant,12/1/1994,6642,6030,612,9.2,131951,124721,7230,5.5
Grant,1/1/1995,6667,5901,766,11.5,132038,124663,7375,5.6
Grant,2/1/1995,6528,5904,624,9.6,132115,124928,7187,5.4
Grant,3/1/1995,6654,6001,653,9.8,132108,124955,7153,5.4
Grant,4/1/1995,6856,6229,627,9.1,132590,124945,7645,5.8
Grant,5/1/1995,6749,6197,552,8.2,131851,124421,7430,5.6
Grant,6/1/1995,6920,6181,739,10.7,131949,124522,7427,5.6
Grant,7/1/1995,7053,6416,637,9,132343,124816,7527,5.7
Grant,8/1/1995,6842,6251,591,8.6,132336,124852,7484,5.7
Grant,9/1/1995,6731,6206,525,7.8,132611,125133,7478,5.6
Grant,10/1/1995,6678,6205,473,7.1,132716,125388,7328,5.5
Grant,11/1/1995,6658,6161,497,7.5,132614,125188,7426,5.6
Grant,12/1/1995,6371,5814,557,8.7,132511,125088,7423,5.6
Grant,1/1/1996,6537,5864,673,10.3,132616,125125,7491,5.6
Grant,2/1/1996,6440,5881,559,8.7,132952,125639,7313,5.5
Grant,3/1/1996,6416,5823,593,9.2,133180,125862,7318,5.5
Grant,4/1/1996,6388,5737,651,10.2,133409,125994,7415,5.6
Grant,5/1/1996,6331,5739,592,9.4,133667,126244,7423,5.6
Grant,6/1/1996,6511,5763,748,11.5,133697,126602,7095,5.3
Grant,7/1/1996,6464,5796,668,10.3,134284,126947,7337,5.5
Grant,8/1/1996,6390,5763,627,9.8,134054,127172,6882,5.1
Grant,9/1/1996,6310,5677,633,10,134515,127536,6979,5.2
Grant,10/1/1996,6223,5642,581,9.3,134921,127890,7031,5.2
Grant,11/1/1996,6196,5664,532,8.6,135007,127771,7236,5.4
Grant,12/1/1996,6148,5602,546,8.9,135113,127860,7253,5.4
Grant,1/1/1997,6371,5691,680,10.7,135456,128298,7158,5.3
Grant,2/1/1997,6184,5632,552,8.9,135400,128298,7102,5.2
Grant,3/1/1997,6293,5702,591,9.4,135891,128891,7000,5.2
Grant,4/1/1997,6219,5719,500,8,136016,129143,6873,5.1
Grant,5/1/1997,6222,5716,506,8.1,136119,129464,6655,4.9
Grant,6/1/1997,6485,5776,709,10.9,136211,129412,6799,5
Grant,7/1/1997,6432,5805,627,9.7,136477,129822,6655,4.9
Grant,8/1/1997,6322,5765,557,8.8,136618,130010,6608,4.8
Grant,9/1/1997,6262,5737,525,8.4,136675,130019,6656,4.9
Grant,10/1/1997,6164,5715,449,7.3,136633,130179,6454,4.7
Grant,11/1/1997,6129,5722,407,6.6,136961,130653,6308,4.6
Grant,12/1/1997,6103,5656,447,7.3,137155,130679,6476,4.7
Grant,1/1/1998,6320,5745,575,9.1,137095,130726,6368,4.6
Grant,2/1/1998,6096,5691,405,6.6,137112,130807,6306,4.6
Grant,3/1/1998,6255,5776,479,7.7,137236,130814,6422,4.7
Grant,4/1/1998,6211,5747,464,7.5,137150,131209,5941,4.3
Grant,5/1/1998,6349,5846,503,7.9,137372,131325,6047,4.4
Grant,6/1/1998,6610,5989,621,9.4,137455,131244,6212,4.5
Grant,7/1/1998,6727,6190,537,8,137588,131329,6259,4.5
Grant,8/1/1998,6771,6265,506,7.5,137570,131390,6179,4.5
Grant,9/1/1998,6770,6256,514,7.6,138286,131986,6300,4.6
Grant,10/1/1998,6597,6143,454,6.9,138279,131999,6280,4.5
Grant,11/1/1998,6465,6043,422,6.5,138381,132280,6100,4.4
Grant,12/1/1998,6641,6205,436,6.6,138634,132602,6032,4.4
Grant,1/1/1999,6747,6187,560,8.3,139003,133027,5976,4.3
Grant,2/1/1999,6661,6234,427,6.4,138967,132856,6111,4.4
Grant,3/1/1999,6717,6290,427,6.4,138730,132947,5783,4.2
Grant,4/1/1999,6739,6313,426,6.3,138959,132955,6004,4.3
Grant,5/1/1999,6876,6455,421,6.1,139107,133311,5796,4.2
Grant,6/1/1999,7094,6561,533,7.5,139329,133378,5951,4.3
Grant,7/1/1999,7154,6648,506,7.1,139439,133414,6025,4.3
Grant,8/1/1999,7139,6648,491,6.9,139430,133591,5838,4.2
Grant,9/1/1999,6977,6518,459,6.6,139622,133707,5915,4.2
Grant,10/1/1999,6910,6492,418,6,139771,133993,5778,4.1
Grant,11/1/1999,6902,6520,382,5.5,140025,134309,5716,4.1
Grant,12/1/1999,6771,6416,355,5.2,140177,134523,5653,4
Grant,1/1/2000,7752,7328,424,5.5,142267,136559,5708,4
Grant,2/1/2000,7731,7316,415,5.4,142456,136598,5858,4.1
Grant,3/1/2000,7771,7335,436,5.6,142434,136701,5733,4
Grant,4/1/2000,7851,7472,379,4.8,142751,137270,5481,3.8
Grant,5/1/2000,7827,7368,459,5.9,142388,136630,5758,4
Grant,6/1/2000,7955,7386,569,7.2,142591,136940,5651,4
Grant,7/1/2000,7981,7452,529,6.6,142278,136531,5747,4
Grant,8/1/2000,7953,7412,541,6.8,142514,136662,5853,4.1
Grant,9/1/2000,7837,7358,479,6.1,142518,136893,5625,3.9
Grant,10/1/2000,7903,7429,474,6,142622,137088,5534,3.9
Grant,11/1/2000,7934,7402,532,6.7,142962,137322,5639,3.9
Grant,12/1/2000,7947,7422,525,6.6,143248,137614,5634,3.9
Grant,1/1/2001,7799,7220,579,7.4,143800,137778,6023,4.2
Grant,2/1/2001,7768,7248,520,6.7,143701,137612,6089,4.2
Grant,3/1/2001,7842,7284,558,7.1,143924,137783,6141,4.3
Grant,4/1/2001,7920,7368,552,7,143569,137299,6271,4.4
Grant,5/1/2001,7843,7342,501,6.4,143318,137092,6226,4.3
Grant,6/1/2001,7990,7411,579,7.2,143357,136873,6484,4.5
Grant,7/1/2001,8046,7537,509,6.3,143654,137071,6583,4.6
Grant,8/1/2001,8019,7476,543,6.8,143284,136241,7042,4.9
Grant,9/1/2001,7904,7423,481,6.1,143989,136846,7142,5
Grant,10/1/2001,7885,7412,473,6,144086,136392,7694,5.3
Grant,11/1/2001,7904,7421,483,6.1,144240,136238,8003,5.5
Grant,12/1/2001,7921,7412,509,6.4,144305,136047,8258,5.7
Grant,1/1/2002,7767,7206,561,7.2,143883,135701,8182,5.7
Grant,2/1/2002,7773,7287,486,6.3,144653,136438,8215,5.7
Grant,3/1/2002,7842,7342,500,6.4,144481,136177,8304,5.7
Grant,4/1/2002,7956,7418,538,6.8,144725,136126,8599,5.9
Grant,5/1/2002,7923,7390,533,6.7,144938,136539,8399,5.8
Grant,6/1/2002,8089,7468,621,7.7,144808,136415,8393,5.8
Grant,7/1/2002,8137,7544,593,7.3,144803,136413,8390,5.8
Grant,8/1/2002,8147,7563,584,7.2,145009,136705,8304,5.7
Grant,9/1/2002,7968,7452,516,6.5,145552,137302,8251,5.7
Grant,10/1/2002,7974,7517,457,5.7,145314,137008,8307,5.7
Grant,11/1/2002,7967,7479,488,6.1,145041,136521,8520,5.9
Grant,12/1/2002,8009,7467,542,6.8,145066,136426,8640,6
Grant,1/1/2003,7906,7321,585,7.4,145937,137417,8520,5.8
Grant,2/1/2003,7864,7322,542,6.9,146100,137482,8618,5.9
Grant,3/1/2003,7971,7339,632,7.9,146022,137434,8588,5.9
Grant,4/1/2003,8111,7499,612,7.5,146474,137633,8842,6
Grant,5/1/2003,8102,7457,645,8,146500,137544,8957,6.1
Grant,6/1/2003,8335,7517,818,9.8,147056,137790,9266,6.3
Grant,7/1/2003,8144,7433,711,8.7,146485,137474,9011,6.2
Grant,8/1/2003,8137,7423,714,8.8,146445,137549,8896,6.1
Grant,9/1/2003,7975,7381,594,7.4,146530,137609,8921,6.1
Grant,10/1/2003,7998,7472,526,6.6,146716,137984,8732,6
Grant,11/1/2003,8023,7497,526,6.6,147000,138424,8576,5.8
Grant,12/1/2003,7927,7432,495,6.2,146729,138411,8317,5.7
Grant,1/1/2004,7812,7259,553,7.1,146842,138472,8370,5.7
Grant,2/1/2004,7795,7268,527,6.8,146709,138542,8167,5.6
Grant,3/1/2004,7820,7284,536,6.9,146944,138453,8491,5.8
Grant,4/1/2004,8057,7544,513,6.4,146850,138680,8170,5.6
Grant,5/1/2004,8055,7536,519,6.4,147065,138852,8212,5.6
Grant,6/1/2004,8300,7645,655,7.9,147460,139174,8286,5.6
Grant,7/1/2004,8293,7706,587,7.1,147692,139556,8136,5.5
Grant,8/1/2004,8300,7764,536,6.5,147564,139573,7990,5.4
Grant,9/1/2004,8202,7725,477,5.8,147415,139487,7927,5.4
Grant,10/1/2004,8262,7792,470,5.7,147793,139732,8061,5.5
Grant,11/1/2004,8325,7837,488,5.9,148162,140231,7932,5.4
Grant,12/1/2004,8332,7822,510,6.1,148059,140125,7934,5.4
Grant,1/1/2005,8328,7793,535,6.4,148029,140245,7784,5.3
Grant,2/1/2005,8236,7738,498,6,148364,140385,7980,5.4
Grant,3/1/2005,8196,7736,460,5.6,148391,140654,7737,5.2
Grant,4/1/2005,8324,7866,458,5.5,148926,141254,7672,5.2
Grant,5/1/2005,8329,7849,480,5.8,149261,141609,7651,5.1
Grant,6/1/2005,8500,7879,621,7.3,149238,141714,7524,5
Grant,7/1/2005,8547,7976,571,6.7,149432,142026,7406,5
Grant,8/1/2005,8464,7939,525,6.2,149779,142434,7345,4.9
Grant,9/1/2005,9156,8500,656,7.2,149954,142401,7553,5
Grant,10/1/2005,9236,8649,587,6.4,150001,142548,7453,5
Grant,11/1/2005,9195,8580,615,6.7,150065,142499,7566,5
Grant,12/1/2005,8905,8503,402,4.5,150030,142752,7279,4.9
Grant,1/1/2006,8697,8366,331,3.8,150214,143150,7064,4.7
Grant,2/1/2006,8642,8362,280,3.2,150641,143457,7184,4.8
Grant,3/1/2006,8717,8418,299,3.4,150813,143741,7072,4.7
Grant,4/1/2006,8779,8478,301,3.4,150881,143761,7120,4.7
Grant,5/1/2006,8778,8435,343,3.9,151069,144089,6980,4.6
Grant,6/1/2006,8977,8525,452,5,151354,144353,7001,4.6
Grant,7/1/2006,8960,8575,385,4.3,151377,144202,7175,4.7
Grant,8/1/2006,8837,8430,407,4.6,151716,144625,7091,4.7
Grant,9/1/2006,8770,8425,345,3.9,151662,144815,6847,4.5
Grant,10/1/2006,8735,8429,306,3.5,152041,145314,6727,4.4
Grant,11/1/2006,8721,8375,346,4,152406,145534,6872,4.5
Grant,12/1/2006,8648,8313,335,3.9,152732,145970,6762,4.4
Grant,1/1/2007,8624,8241,383,4.4,153144,146028,7116,4.6
Grant,2/1/2007,8576,8220,356,4.2,152983,146057,6927,4.5
Grant,3/1/2007,8668,8315,353,4.1,153051,146320,6731,4.4
Grant,4/1/2007,8681,8297,384,4.4,152435,145586,6850,4.5
Grant,5/1/2007,8629,8259,370,4.3,152670,145903,6766,4.4
Grant,6/1/2007,8817,8310,507,5.8,153041,146063,6979,4.6
Grant,7/1/2007,8852,8356,496,5.6,153054,145905,7149,4.7
Grant,8/1/2007,8725,8302,423,4.8,152749,145682,7067,4.6
Grant,9/1/2007,8662,8300,362,4.2,153414,146244,7170,4.7
Grant,10/1/2007,8729,8403,326,3.7,153183,145946,7237,4.7
Grant,11/1/2007,8774,8449,325,3.7,153835,146595,7240,4.7
Grant,12/1/2007,8767,8381,386,4.4,153918,146273,7645,5
Grant,1/1/2008,8837,8389,448,5.1,154063,146378,7685,5
Grant,2/1/2008,8742,8392,350,4,153653,146156,7497,4.9
Grant,3/1/2008,8853,8480,373,4.2,153908,146086,7822,5.1
Grant,4/1/2008,8799,8493,306,3.5,153769,146132,7637,5
Grant,5/1/2008,8857,8480,377,4.3,154303,145908,8395,5.4
Grant,6/1/2008,9026,8528,498,5.5,154313,145737,8575,5.6
Grant,7/1/2008,9102,8582,520,5.7,154469,145532,8937,5.8
Grant,8/1/2008,8997,8472,525,5.8,154641,145203,9438,6.1
Grant,9/1/2008,8914,8457,457,5.1,154570,145076,9494,6.1
Grant,10/1/2008,8909,8439,470,5.3,154876,144802,10074,6.5
Grant,11/1/2008,8935,8446,489,5.5,154639,144100,10538,6.8
Grant,12/1/2008,8867,8319,548,6.2,154655,143369,11286,7.3
Grant,1/1/2009,8809,8164,645,7.3,154210,142152,12058,7.8
Grant,2/1/2009,8761,8141,620,7.1,154538,141640,12898,8.3
Grant,3/1/2009,8824,8150,674,7.6,154133,140707,13426,8.7
Grant,4/1/2009,8926,8260,666,7.5,154509,140656,13853,9
Grant,5/1/2009,8947,8266,681,7.6,154747,140248,14499,9.4
Grant,6/1/2009,9134,8326,808,8.8,154716,140009,14707,9.5
Grant,7/1/2009,9132,8366,766,8.4,154502,139901,14601,9.5
Grant,8/1/2009,8945,8230,715,8,154307,139492,14814,9.6
Grant,9/1/2009,8846,8176,670,7.6,153827,138818,15009,9.8
Grant,10/1/2009,8795,8169,626,7.1,153784,138432,15352,10
Grant,11/1/2009,8811,8178,633,7.2,153878,138659,15219,9.9
Grant,12/1/2009,8746,8077,669,7.6,153111,138013,15098,9.9
Grant,1/1/2010,8444,7750,694,8.2,153484,138438,15046,9.8
Grant,2/1/2010,8462,7833,629,7.4,153694,138581,15113,9.8
Grant,3/1/2010,8551,7899,652,7.6,153954,138751,15202,9.9
Grant,4/1/2010,8638,8018,620,7.2,154622,139297,15325,9.9
Grant,5/1/2010,8591,7917,674,7.8,154091,139241,14849,9.6
Grant,6/1/2010,8736,7948,788,9,153616,139141,14474,9.4
Grant,7/1/2010,8740,7983,757,8.7,153691,139179,14512,9.4
Grant,8/1/2010,8677,7953,724,8.3,154086,139438,14648,9.5
Grant,9/1/2010,8609,7944,665,7.7,153975,139396,14579,9.5
Grant,10/1/2010,8616,7975,641,7.4,153635,139119,14516,9.4
Grant,11/1/2010,8647,7971,676,7.8,154125,139044,15081,9.8
Grant,12/1/2010,8522,7898,624,7.3,153650,139301,14348,9.3
Grant,1/1/2011,8371,7633,738,8.8,153263,139250,14013,9.1
Grant,2/1/2011,8343,7681,662,7.9,153214,139394,13820,9
Grant,3/1/2011,8350,7687,663,7.9,153376,139639,13737,9
Grant,4/1/2011,8406,7791,615,7.3,153543,139586,13957,9.1
Grant,5/1/2011,8366,7737,629,7.5,153479,139624,13855,9
Grant,6/1/2011,8528,7766,762,8.9,153346,139384,13962,9.1
Grant,7/1/2011,8512,7768,744,8.7,153288,139524,13763,9
Grant,8/1/2011,8434,7738,696,8.3,153760,139942,13818,9
Grant,9/1/2011,8373,7736,637,7.6,154131,140183,13948,9
Grant,10/1/2011,8346,7744,602,7.2,153961,140368,13594,8.8
Grant,11/1/2011,8387,7781,606,7.2,154128,140826,13302,8.6
Grant,12/1/2011,8364,7753,611,7.3,153995,140902,13093,8.5
Grant,1/1/2012,8244,7568,676,8.2,154381,141584,12797,8.3
Grant,2/1/2012,8245,7611,634,7.7,154671,141858,12813,8.3
Grant,3/1/2012,8272,7675,597,7.2,154749,142036,12713,8.2
Grant,4/1/2012,8280,7706,574,6.9,154545,141899,12646,8.2
Grant,5/1/2012,8286,7663,623,7.5,154866,142206,12660,8.2
Grant,6/1/2012,8479,7717,762,9,155083,142391,12692,8.2
Grant,7/1/2012,8476,7725,751,8.9,154948,142292,12656,8.2
Grant,8/1/2012,8222,7604,618,7.5,154763,142291,12471,8.1
Grant,9/1/2012,8195,7624,571,7,155160,143044,12115,7.8
Grant,10/1/2012,8198,7662,536,6.5,155554,143431,12124,7.8
Grant,11/1/2012,8150,7636,514,6.3,155338,143333,12005,7.7
Grant,12/1/2012,8172,7587,585,7.2,155628,143330,12298,7.9
Grant,1/1/2013,8108,7438,670,8.3,155763,143292,12471,8
Grant,2/1/2013,8081,7512,569,7,155312,143362,11950,7.7
Grant,3/1/2013,8102,7545,557,6.9,155005,143316,11689,7.5
Grant,4/1/2013,8130,7586,544,6.7,155394,143635,11760,7.6
Grant,5/1/2013,8175,7576,599,7.3,155536,143882,11654,7.5
Grant,6/1/2013,8326,7613,713,8.6,155749,143999,11751,7.5
Grant,7/1/2013,8301,7660,641,7.7,155599,144264,11335,7.3
Grant,8/1/2013,8161,7588,573,7,155605,144326,11279,7.2
Grant,9/1/2013,8135,7608,527,6.5,155687,144418,11270,7.2
Grant,10/1/2013,8046,7552,494,6.1,154673,143537,11136,7.2
Grant,11/1/2013,8098,7603,495,6.1,155265,144479,10787,6.9
Grant,12/1/2013,8104,7639,465,5.7,155182,144778,10404,6.7
Grant,1/1/2014,8138,7672,466,5.7,155352,145150,10202,6.6
Grant,2/1/2014,8143,7710,433,5.3,155483,145134,10349,6.7
Grant,3/1/2014,8257,7763,494,6,156028,145648,10380,6.7
Grant,4/1/2014,8232,7798,434,5.3,155369,145667,9702,6.2
Grant,5/1/2014,8279,7772,507,6.1,155684,145825,9859,6.3
Grant,6/1/2014,8488,7826,662,7.8,155707,146247,9460,6.1
Grant,7/1/2014,8556,7823,733,8.6,156007,146399,9608,6.2
Grant,8/1/2014,8459,7768,691,8.2,156130,146530,9599,6.1
Grant,9/1/2014,8423,7786,637,7.6,156040,146778,9262,5.9
Grant,10/1/2014,8412,7802,610,7.3,156417,147427,8990,5.7
Grant,11/1/2014,8486,7831,655,7.7,156494,147404,9090,5.8
Grant,12/1/2014,8477,7824,653,7.7,156332,147615,8717,5.6
Grant,1/1/2015,8445,7775,670,7.9,157030,148145,8885,5.7
Grant,2/1/2015,8436,7829,607,7.2,156644,148045,8599,5.5
Grant,3/1/2015,8453,7851,602,7.1,156643,148128,8515,5.4
Grant,4/1/2015,8531,7885,646,7.6,157060,148511,8550,5.4
Grant,5/1/2015,8506,7869,637,7.5,157651,148817,8834,5.6
Grant,6/1/2015,8607,7909,698,8.1,157062,148816,8247,5.3
Grant,7/1/2015,8548,7872,676,7.9,156997,148830,8167,5.2
Grant,8/1/2015,8374,7783,591,7.1,157172,149181,7992,5.1
Grant,9/1/2015,8313,7732,581,7,156733,148826,7907,5
Grant,10/1/2015,8299,7757,542,6.5,157167,149246,7922,5
Grant,11/1/2015,8312,7768,544,6.5,157463,149463,8000,5.1
Grant,12/1/2015,8323,7793,530,6.4,158035,150128,7907,5
Grant,1/1/2016,8333,7747,586,7,158280,150653,7627,4.8
Grant,2/1/2016,8327,7783,544,6.5,158640,150939,7702,4.9
Grant,3/1/2016,8394,7824,570,6.8,159179,151218,7961,5
Grant,4/1/2016,8367,7855,512,6.1,159141,151074,8067,5.1
Grant,5/1/2016,8410,7825,585,7,158784,151132,7652,4.8
Grant,6/1/2016,8537,7855,682,8,158967,151223,7744,4.9
Grant,7/1/2016,8481,7845,636,7.5,159194,151554,7641,4.8
Grant,8/1/2016,8322,7704,618,7.4,159562,151779,7784,4.9
Grant,9/1/2016,8246,7655,591,7.2,159714,151761,7953,5
Grant,10/1/2016,8162,7637,525,6.4,159605,151793,7811,4.9
Grant,11/1/2016,8131,7624,507,6.2,159506,151954,7553,4.7
Grant,12/1/2016,8138,7563,575,7.1,159678,152157,7521,4.7
Grant,1/1/2017,8120,7509,611,7.5,159620,152152,7468,4.7
Grant,2/1/2017,8103,7547,556,6.9,159859,152480,7379,4.6
Grant,3/1/2017,8103,7605,498,6.1,160137,153065,7073,4.4
Grant,4/1/2017,8201,7711,490,6,160345,153255,7089,4.4
Grant,5/1/2017,8149,7651,498,6.1,160068,153069,7000,4.4
Grant,6/1/2017,8343,7731,612,7.3,160192,153318,6873,4.3
Grant,7/1/2017,8343,7756,587,7,160462,153569,6892,4.3
Grant,8/1/2017,8231,7664,567,6.9,160586,153503,7082,4.4
Grant,9/1/2017,8185,7710,475,5.8,161140,154286,6854,4.3
Grant,10/1/2017,8085,7693,392,4.8,160309,153609,6700,4.2
Grant,11/1/2017,8109,7686,423,5.2,160579,153805,6774,4.2
Grant,12/1/2017,8123,7665,458,5.6,160535,153904,6632,4.1
Grant,1/1/2018,8177,7671,506,6.2,160914,154425,6489,4
Grant,2/1/2018,8183,7733,450,5.5,161778,155197,6581,4.1
Grant,3/1/2018,8203,7748,455,5.5,161686,155214,6472,4
Grant,4/1/2018,8254,7824,430,5.2,161771,155312,6459,4
Grant,5/1/2018,8220,7772,448,5.5,161848,155652,6196,3.8
Grant,6/1/2018,8384,7795,589,7,162210,155762,6447,4
Grant,7/1/2018,8404,7856,548,6.5,162341,156146,6195,3.8
Grant,8/1/2018,8201,7691,510,6.2,161660,155504,6156,3.8
Grant,9/1/2018,8092,7662,430,5.3,162087,156015,6073,3.7
Grant,10/1/2018,8086,7681,405,5,162602,156391,6211,3.8
Grant,11/1/2018,8105,7697,408,5,162836,156721,6115,3.8
Grant,12/1/2018,8113,7642,471,5.8,163206,156817,6389,3.9
Grant,1/1/2019,8113,7597,516,6.4,162963,156487,6475,4
Grant,2/1/2019,8081,7674,407,5,162999,156863,6136,3.8
Grant,3/1/2019,8085,7714,371,4.6,162904,156701,6202,3.8
Grant,4/1/2019,8098,7763,335,4.1,162586,156625,5961,3.7
Grant,5/1/2019,8100,7703,397,4.9,162751,156821,5930,3.6
Grant,6/1/2019,8304,7771,533,6.4,163168,157232,5935,3.6
Grant,7/1/2019,8365,7803,562,6.7,163590,157529,6061,3.7
Grant,8/1/2019,8236,7742,494,6,163774,157829,5945,3.6
Grant,9/1/2019,8212,7767,445,5.4,164092,158339,5753,3.5
Grant,10/1/2019,8157,7729,428,5.2,164416,158545,5871,3.6
Grant,11/1/2019,8190,7716,474,5.8,164496,158629,5868,3.6
Grant,12/1/2019,8201,7682,519,6.3,164699,158845,5853,3.6
Grant,1/1/2020,8100,7611,489,6,164377,158508,5869,3.6
Grant,2/1/2020,8045,7639,406,5,164467,158714,5753,3.5
Grant,3/1/2020,8224,7549,675,8.2,162559,155353,7206,4.4
Grant,4/1/2020,7595,6936,659,8.7,156269,133185,23084,14.8
Grant,5/1/2020,7760,7090,670,8.6,158101,137173,20929,13.2
Grant,6/1/2020,8075,7387,688,8.5,159994,142342,17652,11
Grant,7/1/2020,8168,7521,647,7.9,160132,143779,16352,10.2
Grant,8/1/2020,8092,7553,539,6.7,160706,147245,13461,8.4
Grant,9/1/2020,8154,7586,568,7,160174,147620,12554,7.8
Grant,10/1/2020,8233,7757,476,5.8,161003,149931,11072,6.9
Grant,11/1/2020,8177,7728,449,5.5,160629,149934,10694,6.7
Grant,12/1/2020,8154,7698,456,5.6,160745,149975,10770,6.7
Grant,1/1/2021,8083,7626,457,5.7,160088,149852,10236,6.4
Grant,2/1/2021,8088,7681,407,5,160184,150189,9995,6.2
Grant,3/1/2021,8133,7751,382,4.7,160400,150644,9756,6.1
Grant,4/1/2021,8119,7784,335,4.1,160843,151081,9762,6.1
Grant,5/1/2021,8099,7754,345,4.3,160800,151535,9266,5.8
Grant,6/1/2021,8223,7808,415,5,161197,151734,9462,5.9
Grant,7/1/2021,8275,7892,383,4.6,161504,152773,8731,5.4
Grant,8/1/2021,8095,7762,333,4.1,161527,153250,8276,5.1
Grant,9/1/2021,8264,7969,295,3.6,161495,153843,7652,4.7
Grant,10/1/2021,8101,7830,271,3.3,161754,154475,7279,4.5
Grant,11/1/2021,8102,7848,254,3.1,162281,155530,6751,4.2
Grant,12/1/2021,8104,7859,245,3,162497,156099,6398,3.9
Grant,1/1/2022,8065,7757,308,3.8,163627,157115,6512,4
Grant,2/1/2022,8087,7824,263,3.3,163899,157598,6301,3.8
Grant,3/1/2022,8187,7931,256,3.1,164220,158206,6014,3.7
Grant,4/1/2022,8176,7942,234,2.9,163893,157891,6002,3.7
Grant,5/1/2022,8152,7896,256,3.1,164362,158378,5983,3.6
Grant,6/1/2022,8322,7957,365,4.4,164046,158094,5951,3.6
Grant,7/1/2022,8473,8123,350,4.1,164026,158258,5768,3.5
Grant,8/1/2022,8195,7880,315,3.8,164654,158735,5919,3.6
Grant,9/1/2022,8163,7878,285,3.5,164602,158810,5792,3.5
Grant,10/1/2022,8103,7844,259,3.2,164648,158684,5964,3.6
Grant,11/1/2022,8095,7826,269,3.3,164450,158507,5943,3.6
Grant,12/1/2022,8098,7827,271,3.3,165025,159259,5766,3.5
Grant,1/1/2023,7991,7679,312,3.9,165964,160217,5747,3.5
Grant,2/1/2023,7995,7722,273,3.4,166358,160395,5962,3.6
Grant,3/1/2023,8069,7808,261,3.2,166651,160812,5839,3.5
Grant,4/1/2023,8054,7820,234,2.9,166725,160974,5751,3.4
Grant,5/1/2023,8040,7771,269,3.3,166886,160796,6089,3.6
Grant,6/1/2023,8177,7815,362,4.4,166937,160979,5958,3.6
Grant,7/1/2023,8227,7911,316,3.8,167103,161183,5920,3.5
Grant,8/1/2023,8103,7786,317,3.9,167759,161475,6284,3.7
Grant,9/1/2023,8118,7800,318,3.9,167767,161442,6326,3.8
Grant,10/1/2023,8128,7807,321,3.9,167690,161211,6479,3.9
Grant,11/1/2023,8131,7816,315,3.9,168140,161886,6254,3.7
Grant,12/1/2023,8119,7772,347,4.3,167439,161124,6315,3.8
Grant,1/1/2024,8104,7732,372,4.6,167339,161190,6149,3.7
Grant,2/1/2024,8095,7746,349,4.3,167475,161013,6462,3.9
Grant,3/1/2024,8161,7822,339,4.2,167922,161425,6497,3.9
Grant,4/1/2024,8151,7853,298,3.7,167988,161495,6492,3.9
Grant,5/1/2024,8093,7783,310,3.8,167799,161164,6635,4
Grant,6/1/2024,8280,7842,438,5.3,168005,161155,6849,4.1
Grant,7/1/2024,8344,7925,419,5,168315,161219,7097,4.2
Grant,8/1/2024,8208,7808,400,4.9,168496,161425,7071,4.2
Grant,9/1/2024,8176,7814,362,4.4,168703,161802,6901,4.1
Grant,10/1/2024,8138,7798,340,4.2,168428,161456,6972,4.1
Grant,11/1/2024,8148,7794,354,4.3,168304,161183,7121,4.2
Grant,12/1/2024,8151,7800,351,4.3,168547,161661,6886,4.1
Grant,1/1/2025,7979,7645,334,4.2,170744,163895,6849,4
Grant,2/1/2025,7897,7586,311,3.9,170359,163307,7052,4.1
Iberia,1/1/1990,27519,26047,1472,5.3,125833,119081,6752,5.4
Iberia,2/1/1990,27542,26180,1362,4.9,125710,119059,6651,5.3
Iberia,3/1/1990,27768,26419,1349,4.9,125801,119203,6598,5.2
Iberia,4/1/1990,28519,27300,1219,4.3,125649,118852,6797,5.4
Iberia,5/1/1990,28760,27458,1302,4.5,125893,119151,6742,5.4
Iberia,6/1/1990,29374,27830,1544,5.3,125573,118983,6590,5.2
Iberia,7/1/1990,29109,27752,1357,4.7,125732,118810,6922,5.5
Iberia,8/1/1990,29256,27808,1448,4.9,125990,118802,7188,5.7
Iberia,9/1/1990,29395,27895,1500,5.1,125892,118524,7368,5.9
Iberia,10/1/1990,29257,27924,1333,4.6,125995,118536,7459,5.9
Iberia,11/1/1990,29017,27845,1172,4,126070,118306,7764,6.2
Iberia,12/1/1990,28730,27495,1235,4.3,126142,118241,7901,6.3
Iberia,1/1/1991,28962,26963,1999,6.9,125955,117940,8015,6.4
Iberia,2/1/1991,28532,26876,1656,5.8,126020,117755,8265,6.6
Iberia,3/1/1991,28983,27402,1581,5.5,126238,117652,8586,6.8
Iberia,4/1/1991,29379,27919,1460,5,126548,118109,8439,6.7
Iberia,5/1/1991,29403,27768,1635,5.6,126176,117440,8736,6.9
Iberia,6/1/1991,30631,28680,1951,6.4,126331,117639,8692,6.9
Iberia,7/1/1991,30768,28965,1803,5.9,126154,117568,8586,6.8
Iberia,8/1/1991,30763,28897,1866,6.1,126150,117484,8666,6.9
Iberia,9/1/1991,30475,28670,1805,5.9,126650,117928,8722,6.9
Iberia,10/1/1991,30339,28596,1743,5.7,126642,117800,8842,7
Iberia,11/1/1991,30084,28340,1744,5.8,126701,117770,8931,7
Iberia,12/1/1991,29726,27950,1776,6,126664,117466,9198,7.3
Iberia,1/1/1992,29111,26522,2589,8.9,127261,117978,9283,7.3
Iberia,2/1/1992,28997,26476,2521,8.7,127207,117753,9454,7.4
Iberia,3/1/1992,29203,26496,2707,9.3,127604,118144,9460,7.4
Iberia,4/1/1992,29845,27228,2617,8.8,127841,118426,9415,7.4
Iberia,5/1/1992,29724,26866,2858,9.6,128119,118375,9744,7.6
Iberia,6/1/1992,31064,27375,3689,11.9,128459,118419,10040,7.8
Iberia,7/1/1992,31066,27986,3080,9.9,128563,118713,9850,7.7
Iberia,8/1/1992,30950,27652,3298,10.7,128613,118826,9787,7.6
Iberia,9/1/1992,30712,27527,3185,10.4,128501,118720,9781,7.6
Iberia,10/1/1992,30623,28054,2569,8.4,128026,118628,9398,7.3
Iberia,11/1/1992,30498,28237,2261,7.4,128441,118876,9565,7.4
Iberia,12/1/1992,30012,27925,2087,7,128554,118997,9557,7.4
Iberia,1/1/1993,29065,26495,2570,8.8,128400,119075,9325,7.3
Iberia,2/1/1993,28650,26329,2321,8.1,128458,119275,9183,7.1
Iberia,3/1/1993,28883,26642,2241,7.8,128598,119542,9056,7
Iberia,4/1/1993,28918,26803,2115,7.3,128584,119474,9110,7.1
Iberia,5/1/1993,29155,27029,2126,7.3,129264,120115,9149,7.1
Iberia,6/1/1993,29945,27362,2583,8.6,129411,120290,9121,7
Iberia,7/1/1993,29508,27313,2195,7.4,129397,120467,8930,6.9
Iberia,8/1/1993,29230,27278,1952,6.7,129619,120856,8763,6.8
Iberia,9/1/1993,29307,27345,1962,6.7,129268,120554,8714,6.7
Iberia,10/1/1993,29892,28038,1854,6.2,129573,120823,8750,6.8
Iberia,11/1/1993,29695,27984,1711,5.8,129711,121169,8542,6.6
Iberia,12/1/1993,29556,27858,1698,5.7,129941,121464,8477,6.5
Iberia,1/1/1994,29453,26576,2877,9.8,130596,121966,8630,6.6
Iberia,2/1/1994,28797,26671,2126,7.4,130669,122086,8583,6.6
Iberia,3/1/1994,28931,26830,2101,7.3,130400,121930,8470,6.5
Iberia,4/1/1994,29142,27103,2039,7,130621,122290,8331,6.4
Iberia,5/1/1994,29336,27362,1974,6.7,130779,122864,7915,6.1
Iberia,6/1/1994,30263,27551,2712,9,130561,122634,7927,6.1
Iberia,7/1/1994,30095,27631,2464,8.2,130652,122706,7946,6.1
Iberia,8/1/1994,30346,27928,2418,8,131275,123342,7933,6
Iberia,9/1/1994,30397,28052,2345,7.7,131421,123687,7734,5.9
Iberia,10/1/1994,30481,28324,2157,7.1,131744,124112,7632,5.8
Iberia,11/1/1994,30701,28759,1942,6.3,131891,124516,7375,5.6
Iberia,12/1/1994,30266,28392,1874,6.2,131951,124721,7230,5.5
Iberia,1/1/1995,30178,27691,2487,8.2,132038,124663,7375,5.6
Iberia,2/1/1995,30028,27707,2321,7.7,132115,124928,7187,5.4
Iberia,3/1/1995,30064,27832,2232,7.4,132108,124955,7153,5.4
Iberia,4/1/1995,29309,27378,1931,6.6,132590,124945,7645,5.8
Iberia,5/1/1995,29195,27349,1846,6.3,131851,124421,7430,5.6
Iberia,6/1/1995,30100,27905,2195,7.3,131949,124522,7427,5.6
Iberia,7/1/1995,30513,28226,2287,7.5,132343,124816,7527,5.7
Iberia,8/1/1995,30054,28250,1804,6,132336,124852,7484,5.7
Iberia,9/1/1995,30246,28408,1838,6.1,132611,125133,7478,5.6
Iberia,10/1/1995,30223,28475,1748,5.8,132716,125388,7328,5.5
Iberia,11/1/1995,30004,28375,1629,5.4,132614,125188,7426,5.6
Iberia,12/1/1995,29732,28259,1473,5,132511,125088,7423,5.6
Iberia,1/1/1996,29980,27988,1992,6.6,132616,125125,7491,5.6
Iberia,2/1/1996,29730,27951,1779,6,132952,125639,7313,5.5
Iberia,3/1/1996,30071,28492,1579,5.3,133180,125862,7318,5.5
Iberia,4/1/1996,29863,28279,1584,5.3,133409,125994,7415,5.6
Iberia,5/1/1996,30251,28440,1811,6,133667,126244,7423,5.6
Iberia,6/1/1996,31452,29370,2082,6.6,133697,126602,7095,5.3
Iberia,7/1/1996,31709,29807,1902,6,134284,126947,7337,5.5
Iberia,8/1/1996,31243,29490,1753,5.6,134054,127172,6882,5.1
Iberia,9/1/1996,31252,29442,1810,5.8,134515,127536,6979,5.2
Iberia,10/1/1996,31428,29785,1643,5.2,134921,127890,7031,5.2
Iberia,11/1/1996,31377,29899,1478,4.7,135007,127771,7236,5.4
Iberia,12/1/1996,31025,29730,1295,4.2,135113,127860,7253,5.4
Iberia,1/1/1997,30447,28796,1651,5.4,135456,128298,7158,5.3
Iberia,2/1/1997,30406,29037,1369,4.5,135400,128298,7102,5.2
Iberia,3/1/1997,30764,29341,1423,4.6,135891,128891,7000,5.2
Iberia,4/1/1997,30942,29615,1327,4.3,136016,129143,6873,5.1
Iberia,5/1/1997,31063,29775,1288,4.1,136119,129464,6655,4.9
Iberia,6/1/1997,32235,30418,1817,5.6,136211,129412,6799,5
Iberia,7/1/1997,32592,30926,1666,5.1,136477,129822,6655,4.9
Iberia,8/1/1997,32304,30854,1450,4.5,136618,130010,6608,4.8
Iberia,9/1/1997,31790,30354,1436,4.5,136675,130019,6656,4.9
Iberia,10/1/1997,32724,30867,1857,5.7,136633,130179,6454,4.7
Iberia,11/1/1997,32491,30771,1720,5.3,136961,130653,6308,4.6
Iberia,12/1/1997,32322,30706,1616,5,137155,130679,6476,4.7
Iberia,1/1/1998,32410,30394,2016,6.2,137095,130726,6368,4.6
Iberia,2/1/1998,32150,30384,1766,5.5,137112,130807,6306,4.6
Iberia,3/1/1998,32816,30721,2095,6.4,137236,130814,6422,4.7
Iberia,4/1/1998,33291,31121,2170,6.5,137150,131209,5941,4.3
Iberia,5/1/1998,33046,30871,2175,6.6,137372,131325,6047,4.4
Iberia,6/1/1998,33941,31462,2479,7.3,137455,131244,6212,4.5
Iberia,7/1/1998,34895,31743,3152,9,137588,131329,6259,4.5
Iberia,8/1/1998,34655,31412,3243,9.4,137570,131390,6179,4.5
Iberia,9/1/1998,34100,30726,3374,9.9,138286,131986,6300,4.6
Iberia,10/1/1998,33941,31041,2900,8.5,138279,131999,6280,4.5
Iberia,11/1/1998,33287,30749,2538,7.6,138381,132280,6100,4.4
Iberia,12/1/1998,32916,30520,2396,7.3,138634,132602,6032,4.4
Iberia,1/1/1999,33080,30254,2826,8.5,139003,133027,5976,4.3
Iberia,2/1/1999,32376,29747,2629,8.1,138967,132856,6111,4.4
Iberia,3/1/1999,32210,29589,2621,8.1,138730,132947,5783,4.2
Iberia,4/1/1999,31535,29063,2472,7.8,138959,132955,6004,4.3
Iberia,5/1/1999,31344,29082,2262,7.2,139107,133311,5796,4.2
Iberia,6/1/1999,32419,29669,2750,8.5,139329,133378,5951,4.3
Iberia,7/1/1999,32826,30302,2524,7.7,139439,133414,6025,4.3
Iberia,8/1/1999,32453,30159,2294,7.1,139430,133591,5838,4.2
Iberia,9/1/1999,32029,29633,2396,7.5,139622,133707,5915,4.2
Iberia,10/1/1999,32057,29793,2264,7.1,139771,133993,5778,4.1
Iberia,11/1/1999,31805,29810,1995,6.3,140025,134309,5716,4.1
Iberia,12/1/1999,31297,29470,1827,5.8,140177,134523,5653,4
Iberia,1/1/2000,30229,28330,1899,6.3,142267,136559,5708,4
Iberia,2/1/2000,30404,28599,1805,5.9,142456,136598,5858,4.1
Iberia,3/1/2000,30594,28772,1822,6,142434,136701,5733,4
Iberia,4/1/2000,30025,28449,1576,5.2,142751,137270,5481,3.8
Iberia,5/1/2000,29955,28246,1709,5.7,142388,136630,5758,4
Iberia,6/1/2000,30318,28362,1956,6.5,142591,136940,5651,4
Iberia,7/1/2000,30716,28945,1771,5.8,142278,136531,5747,4
Iberia,8/1/2000,30589,28840,1749,5.7,142514,136662,5853,4.1
Iberia,9/1/2000,30045,28346,1699,5.7,142518,136893,5625,3.9
Iberia,10/1/2000,30478,28896,1582,5.2,142622,137088,5534,3.9
Iberia,11/1/2000,30381,28859,1522,5,142962,137322,5639,3.9
Iberia,12/1/2000,30524,29120,1404,4.6,143248,137614,5634,3.9
Iberia,1/1/2001,30431,28737,1694,5.6,143800,137778,6023,4.2
Iberia,2/1/2001,30656,29146,1510,4.9,143701,137612,6089,4.2
Iberia,3/1/2001,30944,29352,1592,5.1,143924,137783,6141,4.3
Iberia,4/1/2001,30724,29104,1620,5.3,143569,137299,6271,4.4
Iberia,5/1/2001,30436,28929,1507,5,143318,137092,6226,4.3
Iberia,6/1/2001,31101,29244,1857,6,143357,136873,6484,4.5
Iberia,7/1/2001,31381,29631,1750,5.6,143654,137071,6583,4.6
Iberia,8/1/2001,30957,29268,1689,5.5,143284,136241,7042,4.9
Iberia,9/1/2001,31070,29303,1767,5.7,143989,136846,7142,5
Iberia,10/1/2001,31141,29321,1820,5.8,144086,136392,7694,5.3
Iberia,11/1/2001,30870,28981,1889,6.1,144240,136238,8003,5.5
Iberia,12/1/2001,30875,29004,1871,6.1,144305,136047,8258,5.7
Iberia,1/1/2002,30473,28351,2122,7,143883,135701,8182,5.7
Iberia,2/1/2002,30340,28307,2033,6.7,144653,136438,8215,5.7
Iberia,3/1/2002,30433,28304,2129,7,144481,136177,8304,5.7
Iberia,4/1/2002,30682,28639,2043,6.7,144725,136126,8599,5.9
Iberia,5/1/2002,30578,28534,2044,6.7,144938,136539,8399,5.8
Iberia,6/1/2002,31419,29095,2324,7.4,144808,136415,8393,5.8
Iberia,7/1/2002,31164,29074,2090,6.7,144803,136413,8390,5.8
Iberia,8/1/2002,30928,28937,1991,6.4,145009,136705,8304,5.7
Iberia,9/1/2002,30732,28785,1947,6.3,145552,137302,8251,5.7
Iberia,10/1/2002,30766,28876,1890,6.1,145314,137008,8307,5.7
Iberia,11/1/2002,30524,28720,1804,5.9,145041,136521,8520,5.9
Iberia,12/1/2002,30622,28862,1760,5.7,145066,136426,8640,6
Iberia,1/1/2003,30112,28094,2018,6.7,145937,137417,8520,5.8
Iberia,2/1/2003,29970,28092,1878,6.3,146100,137482,8618,5.9
Iberia,3/1/2003,29972,28004,1968,6.6,146022,137434,8588,5.9
Iberia,4/1/2003,30486,28565,1921,6.3,146474,137633,8842,6
Iberia,5/1/2003,30296,28328,1968,6.5,146500,137544,8957,6.1
Iberia,6/1/2003,31374,28930,2444,7.8,147056,137790,9266,6.3
Iberia,7/1/2003,31479,29246,2233,7.1,146485,137474,9011,6.2
Iberia,8/1/2003,31364,29367,1997,6.4,146445,137549,8896,6.1
Iberia,9/1/2003,31387,29497,1890,6,146530,137609,8921,6.1
Iberia,10/1/2003,31599,29878,1721,5.4,146716,137984,8732,6
Iberia,11/1/2003,31464,29823,1641,5.2,147000,138424,8576,5.8
Iberia,12/1/2003,31422,29819,1603,5.1,146729,138411,8317,5.7
Iberia,1/1/2004,30872,28844,2028,6.6,146842,138472,8370,5.7
Iberia,2/1/2004,30588,28892,1696,5.5,146709,138542,8167,5.6
Iberia,3/1/2004,30892,29058,1834,5.9,146944,138453,8491,5.8
Iberia,4/1/2004,30753,29085,1668,5.4,146850,138680,8170,5.6
Iberia,5/1/2004,30866,29095,1771,5.7,147065,138852,8212,5.6
Iberia,6/1/2004,31672,29521,2151,6.8,147460,139174,8286,5.6
Iberia,7/1/2004,31533,29531,2002,6.3,147692,139556,8136,5.5
Iberia,8/1/2004,31527,29712,1815,5.8,147564,139573,7990,5.4
Iberia,9/1/2004,31174,29231,1943,6.2,147415,139487,7927,5.4
Iberia,10/1/2004,31801,29885,1916,6,147793,139732,8061,5.5
Iberia,11/1/2004,31549,29771,1778,5.6,148162,140231,7932,5.4
Iberia,12/1/2004,31308,29596,1712,5.5,148059,140125,7934,5.4
Iberia,1/1/2005,31110,29074,2036,6.5,148029,140245,7784,5.3
Iberia,2/1/2005,30843,29008,1835,5.9,148364,140385,7980,5.4
Iberia,3/1/2005,31133,29392,1741,5.6,148391,140654,7737,5.2
Iberia,4/1/2005,31534,29849,1685,5.3,148926,141254,7672,5.2
Iberia,5/1/2005,31383,29644,1739,5.5,149261,141609,7651,5.1
Iberia,6/1/2005,32063,30002,2061,6.4,149238,141714,7524,5
Iberia,7/1/2005,32071,30241,1830,5.7,149432,142026,7406,5
Iberia,8/1/2005,32047,30393,1654,5.2,149779,142434,7345,4.9
Iberia,9/1/2005,35471,32320,3151,8.9,149954,142401,7553,5
Iberia,10/1/2005,36776,33344,3432,9.3,150001,142548,7453,5
Iberia,11/1/2005,36373,32953,3420,9.4,150065,142499,7566,5
Iberia,12/1/2005,34397,32729,1668,4.8,150030,142752,7279,4.9
Iberia,1/1/2006,34070,32666,1404,4.1,150214,143150,7064,4.7
Iberia,2/1/2006,33932,32802,1130,3.3,150641,143457,7184,4.8
Iberia,3/1/2006,34156,32989,1167,3.4,150813,143741,7072,4.7
Iberia,4/1/2006,34294,33196,1098,3.2,150881,143761,7120,4.7
Iberia,5/1/2006,34317,33118,1199,3.5,151069,144089,6980,4.6
Iberia,6/1/2006,35106,33585,1521,4.3,151354,144353,7001,4.6
Iberia,7/1/2006,35216,33933,1283,3.6,151377,144202,7175,4.7
Iberia,8/1/2006,35055,33807,1248,3.6,151716,144625,7091,4.7
Iberia,9/1/2006,34797,33583,1214,3.5,151662,144815,6847,4.5
Iberia,10/1/2006,35204,34045,1159,3.3,152041,145314,6727,4.4
Iberia,11/1/2006,35133,33951,1182,3.4,152406,145534,6872,4.5
Iberia,12/1/2006,34848,33758,1090,3.1,152732,145970,6762,4.4
Iberia,1/1/2007,34013,32714,1299,3.8,153144,146028,7116,4.6
Iberia,2/1/2007,33917,32787,1130,3.3,152983,146057,6927,4.5
Iberia,3/1/2007,34287,33108,1179,3.4,153051,146320,6731,4.4
Iberia,4/1/2007,34547,33416,1131,3.3,152435,145586,6850,4.5
Iberia,5/1/2007,34429,33152,1277,3.7,152670,145903,6766,4.4
Iberia,6/1/2007,35255,33680,1575,4.5,153041,146063,6979,4.6
Iberia,7/1/2007,35180,33797,1383,3.9,153054,145905,7149,4.7
Iberia,8/1/2007,34691,33461,1230,3.5,152749,145682,7067,4.6
Iberia,9/1/2007,34685,33442,1243,3.6,153414,146244,7170,4.7
Iberia,10/1/2007,34596,33515,1081,3.1,153183,145946,7237,4.7
Iberia,11/1/2007,34698,33598,1100,3.2,153835,146595,7240,4.7
Iberia,12/1/2007,34381,33272,1109,3.2,153918,146273,7645,5
Iberia,1/1/2008,33991,32681,1310,3.9,154063,146378,7685,5
Iberia,2/1/2008,33836,32749,1087,3.2,153653,146156,7497,4.9
Iberia,3/1/2008,34311,33050,1261,3.7,153908,146086,7822,5.1
Iberia,4/1/2008,34456,33345,1111,3.2,153769,146132,7637,5
Iberia,5/1/2008,34729,33436,1293,3.7,154303,145908,8395,5.4
Iberia,6/1/2008,35591,33964,1627,4.6,154313,145737,8575,5.6
Iberia,7/1/2008,35751,34230,1521,4.3,154469,145532,8937,5.8
Iberia,8/1/2008,35509,33954,1555,4.4,154641,145203,9438,6.1
Iberia,9/1/2008,35749,33989,1760,4.9,154570,145076,9494,6.1
Iberia,10/1/2008,36146,34571,1575,4.4,154876,144802,10074,6.5
Iberia,11/1/2008,35921,34421,1500,4.2,154639,144100,10538,6.8
Iberia,12/1/2008,35528,34032,1496,4.2,154655,143369,11286,7.3
Iberia,1/1/2009,34699,32988,1711,4.9,154210,142152,12058,7.8
Iberia,2/1/2009,34958,33174,1784,5.1,154538,141640,12898,8.3
Iberia,3/1/2009,34918,32977,1941,5.6,154133,140707,13426,8.7
Iberia,4/1/2009,34859,32784,2075,6,154509,140656,13853,9
Iberia,5/1/2009,34790,32503,2287,6.6,154747,140248,14499,9.4
Iberia,6/1/2009,35456,32687,2769,7.8,154716,140009,14707,9.5
Iberia,7/1/2009,34805,32108,2697,7.7,154502,139901,14601,9.5
Iberia,8/1/2009,34335,31765,2570,7.5,154307,139492,14814,9.6
Iberia,9/1/2009,33631,31135,2496,7.4,153827,138818,15009,9.8
Iberia,10/1/2009,34007,31486,2521,7.4,153784,138432,15352,10
Iberia,11/1/2009,33876,31390,2486,7.3,153878,138659,15219,9.9
Iberia,12/1/2009,33696,31152,2544,7.5,153111,138013,15098,9.9
Iberia,1/1/2010,31615,28780,2835,9,153484,138438,15046,9.8
Iberia,2/1/2010,31832,29274,2558,8,153694,138581,15113,9.8
Iberia,3/1/2010,32099,29496,2603,8.1,153954,138751,15202,9.9
Iberia,4/1/2010,32413,29935,2478,7.6,154622,139297,15325,9.9
Iberia,5/1/2010,32441,29880,2561,7.9,154091,139241,14849,9.6
Iberia,6/1/2010,32810,29980,2830,8.6,153616,139141,14474,9.4
Iberia,7/1/2010,32944,30220,2724,8.3,153691,139179,14512,9.4
Iberia,8/1/2010,32600,29950,2650,8.1,154086,139438,14648,9.5
Iberia,9/1/2010,32395,29819,2576,8,153975,139396,14579,9.5
Iberia,10/1/2010,32359,29834,2525,7.8,153635,139119,14516,9.4
Iberia,11/1/2010,32221,29717,2504,7.8,154125,139044,15081,9.8
Iberia,12/1/2010,31790,29370,2420,7.6,153650,139301,14348,9.3
Iberia,1/1/2011,31424,28747,2677,8.5,153263,139250,14013,9.1
Iberia,2/1/2011,31554,29115,2439,7.7,153214,139394,13820,9
Iberia,3/1/2011,31676,29294,2382,7.5,153376,139639,13737,9
Iberia,4/1/2011,31844,29568,2276,7.1,153543,139586,13957,9.1
Iberia,5/1/2011,31893,29547,2346,7.4,153479,139624,13855,9
Iberia,6/1/2011,32279,29658,2621,8.1,153346,139384,13962,9.1
Iberia,7/1/2011,32570,30068,2502,7.7,153288,139524,13763,9
Iberia,8/1/2011,32315,29936,2379,7.4,153760,139942,13818,9
Iberia,9/1/2011,32247,29900,2347,7.3,154131,140183,13948,9
Iberia,10/1/2011,32353,30042,2311,7.1,153961,140368,13594,8.8
Iberia,11/1/2011,32342,30170,2172,6.7,154128,140826,13302,8.6
Iberia,12/1/2011,32045,29905,2140,6.7,153995,140902,13093,8.5
Iberia,1/1/2012,31741,29386,2355,7.4,154381,141584,12797,8.3
Iberia,2/1/2012,32045,29887,2158,6.7,154671,141858,12813,8.3
Iberia,3/1/2012,32246,30123,2123,6.6,154749,142036,12713,8.2
Iberia,4/1/2012,32493,30500,1993,6.1,154545,141899,12646,8.2
Iberia,5/1/2012,32734,30595,2139,6.5,154866,142206,12660,8.2
Iberia,6/1/2012,33238,30794,2444,7.4,155083,142391,12692,8.2
Iberia,7/1/2012,33030,30701,2329,7.1,154948,142292,12656,8.2
Iberia,8/1/2012,32392,30309,2083,6.4,154763,142291,12471,8.1
Iberia,9/1/2012,32238,30341,1897,5.9,155160,143044,12115,7.8
Iberia,10/1/2012,32430,30578,1852,5.7,155554,143431,12124,7.8
Iberia,11/1/2012,32303,30584,1719,5.3,155338,143333,12005,7.7
Iberia,12/1/2012,32249,30388,1861,5.8,155628,143330,12298,7.9
Iberia,1/1/2013,31799,29555,2244,7.1,155763,143292,12471,8
Iberia,2/1/2013,31846,29904,1942,6.1,155312,143362,11950,7.7
Iberia,3/1/2013,31928,29975,1953,6.1,155005,143316,11689,7.5
Iberia,4/1/2013,32222,30267,1955,6.1,155394,143635,11760,7.6
Iberia,5/1/2013,32435,30332,2103,6.5,155536,143882,11654,7.5
Iberia,6/1/2013,33022,30605,2417,7.3,155749,143999,11751,7.5
Iberia,7/1/2013,33053,30838,2215,6.7,155599,144264,11335,7.3
Iberia,8/1/2013,32583,30518,2065,6.3,155605,144326,11279,7.2
Iberia,9/1/2013,32426,30495,1931,6,155687,144418,11270,7.2
Iberia,10/1/2013,32138,30291,1847,5.7,154673,143537,11136,7.2
Iberia,11/1/2013,32129,30438,1691,5.3,155265,144479,10787,6.9
Iberia,12/1/2013,31984,30437,1547,4.8,155182,144778,10404,6.7
Iberia,1/1/2014,31587,29813,1774,5.6,155352,145150,10202,6.6
Iberia,2/1/2014,31750,30052,1698,5.3,155483,145134,10349,6.7
Iberia,3/1/2014,31996,30175,1821,5.7,156028,145648,10380,6.7
Iberia,4/1/2014,32117,30430,1687,5.3,155369,145667,9702,6.2
Iberia,5/1/2014,32237,30304,1933,6,155684,145825,9859,6.3
Iberia,6/1/2014,32636,30442,2194,6.7,155707,146247,9460,6.1
Iberia,7/1/2014,33044,30753,2291,6.9,156007,146399,9608,6.2
Iberia,8/1/2014,32785,30549,2236,6.8,156130,146530,9599,6.1
Iberia,9/1/2014,32713,30543,2170,6.6,156040,146778,9262,5.9
Iberia,10/1/2014,32764,30646,2118,6.5,156417,147427,8990,5.7
Iberia,11/1/2014,32639,30498,2141,6.6,156494,147404,9090,5.8
Iberia,12/1/2014,32488,30495,1993,6.1,156332,147615,8717,5.6
Iberia,1/1/2015,32065,29724,2341,7.3,157030,148145,8885,5.7
Iberia,2/1/2015,31938,29564,2374,7.4,156644,148045,8599,5.5
Iberia,3/1/2015,32065,29618,2447,7.6,156643,148128,8515,5.4
Iberia,4/1/2015,31904,29424,2480,7.8,157060,148511,8550,5.4
Iberia,5/1/2015,32136,29415,2721,8.5,157651,148817,8834,5.6
Iberia,6/1/2015,32229,29389,2840,8.8,157062,148816,8247,5.3
Iberia,7/1/2015,31960,29245,2715,8.5,156997,148830,8167,5.2
Iberia,8/1/2015,31462,28957,2505,8,157172,149181,7992,5.1
Iberia,9/1/2015,31136,28560,2576,8.3,156733,148826,7907,5
Iberia,10/1/2015,31193,28572,2621,8.4,157167,149246,7922,5
Iberia,11/1/2015,30964,28491,2473,8,157463,149463,8000,5.1
Iberia,12/1/2015,30880,28438,2442,7.9,158035,150128,7907,5
Iberia,1/1/2016,30336,27539,2797,9.2,158280,150653,7627,4.8
Iberia,2/1/2016,30413,27575,2838,9.3,158640,150939,7702,4.9
Iberia,3/1/2016,30560,27684,2876,9.4,159179,151218,7961,5
Iberia,4/1/2016,30387,27540,2847,9.4,159141,151074,8067,5.1
Iberia,5/1/2016,30427,27567,2860,9.4,158784,151132,7652,4.8
Iberia,6/1/2016,30746,27518,3228,10.5,158967,151223,7744,4.9
Iberia,7/1/2016,30529,27513,3016,9.9,159194,151554,7641,4.8
Iberia,8/1/2016,29915,27040,2875,9.6,159562,151779,7784,4.9
Iberia,9/1/2016,29735,26829,2906,9.8,159714,151761,7953,5
Iberia,10/1/2016,29459,26819,2640,9,159605,151793,7811,4.9
Iberia,11/1/2016,29392,26945,2447,8.3,159506,151954,7553,4.7
Iberia,12/1/2016,29286,26841,2445,8.3,159678,152157,7521,4.7
Iberia,1/1/2017,28813,26151,2662,9.2,159620,152152,7468,4.7
Iberia,2/1/2017,29002,26458,2544,8.8,159859,152480,7379,4.6
Iberia,3/1/2017,29187,26776,2411,8.3,160137,153065,7073,4.4
Iberia,4/1/2017,29196,26939,2257,7.7,160345,153255,7089,4.4
Iberia,5/1/2017,29173,26980,2193,7.5,160068,153069,7000,4.4
Iberia,6/1/2017,29536,27209,2327,7.9,160192,153318,6873,4.3
Iberia,7/1/2017,29504,27315,2189,7.4,160462,153569,6892,4.3
Iberia,8/1/2017,28957,26880,2077,7.2,160586,153503,7082,4.4
Iberia,9/1/2017,28677,26829,1848,6.4,161140,154286,6854,4.3
Iberia,10/1/2017,28386,26724,1662,5.9,160309,153609,6700,4.2
Iberia,11/1/2017,28318,26712,1606,5.7,160579,153805,6774,4.2
Iberia,12/1/2017,28154,26606,1548,5.5,160535,153904,6632,4.1
Iberia,1/1/2018,27796,26100,1696,6.1,160914,154425,6489,4
Iberia,2/1/2018,28024,26384,1640,5.9,161778,155197,6581,4.1
Iberia,3/1/2018,28307,26646,1661,5.9,161686,155214,6472,4
Iberia,4/1/2018,28375,26790,1585,5.6,161771,155312,6459,4
Iberia,5/1/2018,28441,26808,1633,5.7,161848,155652,6196,3.8
Iberia,6/1/2018,28809,26803,2006,7,162210,155762,6447,4
Iberia,7/1/2018,28943,27076,1867,6.5,162341,156146,6195,3.8
Iberia,8/1/2018,28193,26536,1657,5.9,161660,155504,6156,3.8
Iberia,9/1/2018,28036,26452,1584,5.6,162087,156015,6073,3.7
Iberia,10/1/2018,28238,26709,1529,5.4,162602,156391,6211,3.8
Iberia,11/1/2018,28066,26636,1430,5.1,162836,156721,6115,3.8
Iberia,12/1/2018,27899,26498,1401,5,163206,156817,6389,3.9
Iberia,1/1/2019,27247,25675,1572,5.8,162963,156487,6475,4
Iberia,2/1/2019,27376,26014,1362,5,162999,156863,6136,3.8
Iberia,3/1/2019,27502,26245,1257,4.6,162904,156701,6202,3.8
Iberia,4/1/2019,27513,26328,1185,4.3,162586,156625,5961,3.7
Iberia,5/1/2019,27701,26302,1399,5.1,162751,156821,5930,3.6
Iberia,6/1/2019,28142,26457,1685,6,163168,157232,5935,3.6
Iberia,7/1/2019,28192,26561,1631,5.8,163590,157529,6061,3.7
Iberia,8/1/2019,27946,26424,1522,5.4,163774,157829,5945,3.6
Iberia,9/1/2019,27957,26493,1464,5.2,164092,158339,5753,3.5
Iberia,10/1/2019,27963,26486,1477,5.3,164416,158545,5871,3.6
Iberia,11/1/2019,27771,26320,1451,5.2,164496,158629,5868,3.6
Iberia,12/1/2019,27528,26094,1434,5.2,164699,158845,5853,3.6
Iberia,1/1/2020,26964,25470,1494,5.5,164377,158508,5869,3.6
Iberia,2/1/2020,26975,25661,1314,4.9,164467,158714,5753,3.5
Iberia,3/1/2020,27640,25405,2235,8.1,162559,155353,7206,4.4
Iberia,4/1/2020,25998,22678,3320,12.8,156269,133185,23084,14.8
Iberia,5/1/2020,26804,23287,3517,13.1,158101,137173,20929,13.2
Iberia,6/1/2020,27500,24030,3470,12.6,159994,142342,17652,11
Iberia,7/1/2020,27866,24299,3567,12.8,160132,143779,16352,10.2
Iberia,8/1/2020,27588,24564,3024,11,160706,147245,13461,8.4
Iberia,9/1/2020,27730,24617,3113,11.2,160174,147620,12554,7.8
Iberia,10/1/2020,27750,25025,2725,9.8,161003,149931,11072,6.9
Iberia,11/1/2020,27462,25004,2458,9,160629,149934,10694,6.7
Iberia,12/1/2020,27480,24974,2506,9.1,160745,149975,10770,6.7
Iberia,1/1/2021,27167,24652,2515,9.3,160088,149852,10236,6.4
Iberia,2/1/2021,27264,24914,2350,8.6,160184,150189,9995,6.2
Iberia,3/1/2021,27523,25263,2260,8.2,160400,150644,9756,6.1
Iberia,4/1/2021,27605,25454,2151,7.8,160843,151081,9762,6.1
Iberia,5/1/2021,27557,25426,2131,7.7,160800,151535,9266,5.8
Iberia,6/1/2021,28065,25634,2431,8.7,161197,151734,9462,5.9
Iberia,7/1/2021,27991,25868,2123,7.6,161504,152773,8731,5.4
Iberia,8/1/2021,27431,25603,1828,6.7,161527,153250,8276,5.1
Iberia,9/1/2021,27557,25998,1559,5.7,161495,153843,7652,4.7
Iberia,10/1/2021,27257,25896,1361,5,161754,154475,7279,4.5
Iberia,11/1/2021,27176,25939,1237,4.6,162281,155530,6751,4.2
Iberia,12/1/2021,27050,25955,1095,4,162497,156099,6398,3.9
Iberia,1/1/2022,27029,25709,1320,4.9,163627,157115,6512,4
Iberia,2/1/2022,27093,25898,1195,4.4,163899,157598,6301,3.8
Iberia,3/1/2022,27414,26280,1134,4.1,164220,158206,6014,3.7
Iberia,4/1/2022,27405,26364,1041,3.8,163893,157891,6002,3.7
Iberia,5/1/2022,27437,26326,1111,4,164362,158378,5983,3.6
Iberia,6/1/2022,27726,26321,1405,5.1,164046,158094,5951,3.6
Iberia,7/1/2022,27787,26504,1283,4.6,164026,158258,5768,3.5
Iberia,8/1/2022,27326,26129,1197,4.4,164654,158735,5919,3.6
Iberia,9/1/2022,27301,26186,1115,4.1,164602,158810,5792,3.5
Iberia,10/1/2022,27367,26315,1052,3.8,164648,158684,5964,3.6
Iberia,11/1/2022,27285,26286,999,3.7,164450,158507,5943,3.6
Iberia,12/1/2022,27215,26232,983,3.6,165025,159259,5766,3.5
Iberia,1/1/2023,27153,25982,1171,4.3,165964,160217,5747,3.5
Iberia,2/1/2023,27220,26095,1125,4.1,166358,160395,5962,3.6
Iberia,3/1/2023,27421,26323,1098,4,166651,160812,5839,3.5
Iberia,4/1/2023,27470,26508,962,3.5,166725,160974,5751,3.4
Iberia,5/1/2023,27475,26335,1140,4.1,166886,160796,6089,3.6
Iberia,6/1/2023,27750,26467,1283,4.6,166937,160979,5958,3.6
Iberia,7/1/2023,27647,26600,1047,3.8,167103,161183,5920,3.5
Iberia,8/1/2023,27484,26304,1180,4.3,167759,161475,6284,3.7
Iberia,9/1/2023,27525,26330,1195,4.3,167767,161442,6326,3.8
Iberia,10/1/2023,27541,26328,1213,4.4,167690,161211,6479,3.9
Iberia,11/1/2023,27550,26412,1138,4.1,168140,161886,6254,3.7
Iberia,12/1/2023,27356,26203,1153,4.2,167439,161124,6315,3.8
Iberia,1/1/2024,27396,26104,1292,4.7,167339,161190,6149,3.7
Iberia,2/1/2024,27324,26050,1274,4.7,167475,161013,6462,3.9
Iberia,3/1/2024,27575,26320,1255,4.6,167922,161425,6497,3.9
Iberia,4/1/2024,27588,26515,1073,3.9,167988,161495,6492,3.9
Iberia,5/1/2024,27439,26307,1132,4.1,167799,161164,6635,4
Iberia,6/1/2024,27893,26475,1418,5.1,168005,161155,6849,4.1
Iberia,7/1/2024,28131,26705,1426,5.1,168315,161219,7097,4.2
Iberia,8/1/2024,27811,26355,1456,5.2,168496,161425,7071,4.2
Iberia,9/1/2024,27629,26247,1382,5,168703,161802,6901,4.1
Iberia,10/1/2024,27644,26259,1385,5,168428,161456,6972,4.1
Iberia,11/1/2024,27604,26232,1372,5,168304,161183,7121,4.2
Iberia,12/1/2024,27436,26192,1244,4.5,168547,161661,6886,4.1
Iberia,1/1/2025,27748,26446,1302,4.7,170744,163895,6849,4
Iberia,2/1/2025,27684,26429,1255,4.5,170359,163307,7052,4.1
Iberville,1/1/1990,12112,11135,977,8.1,125833,119081,6752,5.4
Iberville,2/1/1990,12068,11173,895,7.4,125710,119059,6651,5.3
Iberville,3/1/1990,12265,11364,901,7.3,125801,119203,6598,5.2
Iberville,4/1/1990,12540,11607,933,7.4,125649,118852,6797,5.4
Iberville,5/1/1990,12505,11525,980,7.8,125893,119151,6742,5.4
Iberville,6/1/1990,12752,11640,1112,8.7,125573,118983,6590,5.2
Iberville,7/1/1990,12947,11904,1043,8.1,125732,118810,6922,5.5
Iberville,8/1/1990,12898,11863,1035,8,125990,118802,7188,5.7
Iberville,9/1/1990,12930,11867,1063,8.2,125892,118524,7368,5.9
Iberville,10/1/1990,12780,11841,939,7.3,125995,118536,7459,5.9
Iberville,11/1/1990,12812,11750,1062,8.3,126070,118306,7764,6.2
Iberville,12/1/1990,12774,11661,1113,8.7,126142,118241,7901,6.3
Iberville,1/1/1991,12929,11594,1335,10.3,125955,117940,8015,6.4
Iberville,2/1/1991,12950,11689,1261,9.7,126020,117755,8265,6.6
Iberville,3/1/1991,12979,11752,1227,9.5,126238,117652,8586,6.8
Iberville,4/1/1991,13111,11802,1309,10,126548,118109,8439,6.7
Iberville,5/1/1991,12966,11613,1353,10.4,126176,117440,8736,6.9
Iberville,6/1/1991,13245,11717,1528,11.5,126331,117639,8692,6.9
Iberville,7/1/1991,13301,11921,1380,10.4,126154,117568,8586,6.8
Iberville,8/1/1991,13222,11903,1319,10,126150,117484,8666,6.9
Iberville,9/1/1991,13152,11910,1242,9.4,126650,117928,8722,6.9
Iberville,10/1/1991,13134,12034,1100,8.4,126642,117800,8842,7
Iberville,11/1/1991,13347,12299,1048,7.9,126701,117770,8931,7
Iberville,12/1/1991,13149,12173,976,7.4,126664,117466,9198,7.3
Iberville,1/1/1992,13386,11959,1427,10.7,127261,117978,9283,7.3
Iberville,2/1/1992,13330,12030,1300,9.8,127207,117753,9454,7.4
Iberville,3/1/1992,13305,12088,1217,9.1,127604,118144,9460,7.4
Iberville,4/1/1992,13303,12197,1106,8.3,127841,118426,9415,7.4
Iberville,5/1/1992,13182,11999,1183,9,128119,118375,9744,7.6
Iberville,6/1/1992,13510,12013,1497,11.1,128459,118419,10040,7.8
Iberville,7/1/1992,14034,12531,1503,10.7,128563,118713,9850,7.7
Iberville,8/1/1992,13935,12449,1486,10.7,128613,118826,9787,7.6
Iberville,9/1/1992,13737,12399,1338,9.7,128501,118720,9781,7.6
Iberville,10/1/1992,13630,12488,1142,8.4,128026,118628,9398,7.3
Iberville,11/1/1992,13673,12545,1128,8.2,128441,118876,9565,7.4
Iberville,12/1/1992,13365,12266,1099,8.2,128554,118997,9557,7.4
Iberville,1/1/1993,13254,11934,1320,10,128400,119075,9325,7.3
Iberville,2/1/1993,13035,11881,1154,8.9,128458,119275,9183,7.1
Iberville,3/1/1993,13176,11974,1202,9.1,128598,119542,9056,7
Iberville,4/1/1993,13047,11886,1161,8.9,128584,119474,9110,7.1
Iberville,5/1/1993,12947,11767,1180,9.1,129264,120115,9149,7.1
Iberville,6/1/1993,13255,11842,1413,10.7,129411,120290,9121,7
Iberville,7/1/1993,13237,11860,1377,10.4,129397,120467,8930,6.9
Iberville,8/1/1993,13335,11908,1427,10.7,129619,120856,8763,6.8
Iberville,9/1/1993,13127,11738,1389,10.6,129268,120554,8714,6.7
Iberville,10/1/1993,13066,11750,1316,10.1,129573,120823,8750,6.8
Iberville,11/1/1993,13056,11824,1232,9.4,129711,121169,8542,6.6
Iberville,12/1/1993,13029,11797,1232,9.5,129941,121464,8477,6.5
Iberville,1/1/1994,13380,11794,1586,11.9,130596,121966,8630,6.6
Iberville,2/1/1994,13187,11741,1446,11,130669,122086,8583,6.6
Iberville,3/1/1994,13189,11650,1539,11.7,130400,121930,8470,6.5
Iberville,4/1/1994,13279,11758,1521,11.5,130621,122290,8331,6.4
Iberville,5/1/1994,13115,11651,1464,11.2,130779,122864,7915,6.1
Iberville,6/1/1994,13592,11688,1904,14,130561,122634,7927,6.1
Iberville,7/1/1994,13516,11815,1701,12.6,130652,122706,7946,6.1
Iberville,8/1/1994,13405,11827,1578,11.8,131275,123342,7933,6
Iberville,9/1/1994,13127,11711,1416,10.8,131421,123687,7734,5.9
Iberville,10/1/1994,13240,11872,1368,10.3,131744,124112,7632,5.8
Iberville,11/1/1994,12959,11750,1209,9.3,131891,124516,7375,5.6
Iberville,12/1/1994,12777,11670,1107,8.7,131951,124721,7230,5.5
Iberville,1/1/1995,12500,11123,1377,11,132038,124663,7375,5.6
Iberville,2/1/1995,12376,11180,1196,9.7,132115,124928,7187,5.4
Iberville,3/1/1995,12467,11317,1150,9.2,132108,124955,7153,5.4
Iberville,4/1/1995,12451,11197,1254,10.1,132590,124945,7645,5.8
Iberville,5/1/1995,12443,11214,1229,9.9,131851,124421,7430,5.6
Iberville,6/1/1995,12626,11201,1425,11.3,131949,124522,7427,5.6
Iberville,7/1/1995,12672,11368,1304,10.3,132343,124816,7527,5.7
Iberville,8/1/1995,12465,11089,1376,11,132336,124852,7484,5.7
Iberville,9/1/1995,12254,11035,1219,9.9,132611,125133,7478,5.6
Iberville,10/1/1995,12192,11143,1049,8.6,132716,125388,7328,5.5
Iberville,11/1/1995,12050,11069,981,8.1,132614,125188,7426,5.6
Iberville,12/1/1995,11950,10941,1009,8.4,132511,125088,7423,5.6
Iberville,1/1/1996,12178,10914,1264,10.4,132616,125125,7491,5.6
Iberville,2/1/1996,12034,11023,1011,8.4,132952,125639,7313,5.5
Iberville,3/1/1996,12151,11218,933,7.7,133180,125862,7318,5.5
Iberville,4/1/1996,12129,11118,1011,8.3,133409,125994,7415,5.6
Iberville,5/1/1996,11975,10976,999,8.3,133667,126244,7423,5.6
Iberville,6/1/1996,12168,11027,1141,9.4,133697,126602,7095,5.3
Iberville,7/1/1996,12456,11268,1188,9.5,134284,126947,7337,5.5
Iberville,8/1/1996,12252,11173,1079,8.8,134054,127172,6882,5.1
Iberville,9/1/1996,12152,11131,1021,8.4,134515,127536,6979,5.2
Iberville,10/1/1996,12111,11165,946,7.8,134921,127890,7031,5.2
Iberville,11/1/1996,11938,11051,887,7.4,135007,127771,7236,5.4
Iberville,12/1/1996,11762,10901,861,7.3,135113,127860,7253,5.4
Iberville,1/1/1997,12030,11059,971,8.1,135456,128298,7158,5.3
Iberville,2/1/1997,12075,11181,894,7.4,135400,128298,7102,5.2
Iberville,3/1/1997,12241,11290,951,7.8,135891,128891,7000,5.2
Iberville,4/1/1997,11913,11032,881,7.4,136016,129143,6873,5.1
Iberville,5/1/1997,12037,11045,992,8.2,136119,129464,6655,4.9
Iberville,6/1/1997,12312,11171,1141,9.3,136211,129412,6799,5
Iberville,7/1/1997,12336,11289,1047,8.5,136477,129822,6655,4.9
Iberville,8/1/1997,12157,11170,987,8.1,136618,130010,6608,4.8
Iberville,9/1/1997,11998,11070,928,7.7,136675,130019,6656,4.9
Iberville,10/1/1997,12016,11189,827,6.9,136633,130179,6454,4.7
Iberville,11/1/1997,11885,11176,709,6,136961,130653,6308,4.6
Iberville,12/1/1997,11698,11005,693,5.9,137155,130679,6476,4.7
Iberville,1/1/1998,12222,11330,892,7.3,137095,130726,6368,4.6
Iberville,2/1/1998,12010,11235,775,6.5,137112,130807,6306,4.6
Iberville,3/1/1998,12134,11261,873,7.2,137236,130814,6422,4.7
Iberville,4/1/1998,12215,11365,850,7,137150,131209,5941,4.3
Iberville,5/1/1998,12260,11388,872,7.1,137372,131325,6047,4.4
Iberville,6/1/1998,12616,11589,1027,8.1,137455,131244,6212,4.5
Iberville,7/1/1998,12338,11452,886,7.2,137588,131329,6259,4.5
Iberville,8/1/1998,12309,11345,964,7.8,137570,131390,6179,4.5
Iberville,9/1/1998,12054,11101,953,7.9,138286,131986,6300,4.6
Iberville,10/1/1998,12328,11486,842,6.8,138279,131999,6280,4.5
Iberville,11/1/1998,12378,11662,716,5.8,138381,132280,6100,4.4
Iberville,12/1/1998,12347,11622,725,5.9,138634,132602,6032,4.4
Iberville,1/1/1999,12683,11765,918,7.2,139003,133027,5976,4.3
Iberville,2/1/1999,12740,11985,755,5.9,138967,132856,6111,4.4
Iberville,3/1/1999,12855,12113,742,5.8,138730,132947,5783,4.2
Iberville,4/1/1999,12978,12198,780,6,138959,132955,6004,4.3
Iberville,5/1/1999,12876,12159,717,5.6,139107,133311,5796,4.2
Iberville,6/1/1999,13369,12482,887,6.6,139329,133378,5951,4.3
Iberville,7/1/1999,13453,12553,900,6.7,139439,133414,6025,4.3
Iberville,8/1/1999,12801,11911,890,7,139430,133591,5838,4.2
Iberville,9/1/1999,12320,11472,848,6.9,139622,133707,5915,4.2
Iberville,10/1/1999,12564,11823,741,5.9,139771,133993,5778,4.1
Iberville,11/1/1999,12416,11753,663,5.3,140025,134309,5716,4.1
Iberville,12/1/1999,12281,11642,639,5.2,140177,134523,5653,4
Iberville,1/1/2000,12529,11662,867,6.9,142267,136559,5708,4
Iberville,2/1/2000,12584,11791,793,6.3,142456,136598,5858,4.1
Iberville,3/1/2000,12673,11839,834,6.6,142434,136701,5733,4
Iberville,4/1/2000,12705,11967,738,5.8,142751,137270,5481,3.8
Iberville,5/1/2000,12552,11742,810,6.5,142388,136630,5758,4
Iberville,6/1/2000,12767,11832,935,7.3,142591,136940,5651,4
Iberville,7/1/2000,12474,11576,898,7.2,142278,136531,5747,4
Iberville,8/1/2000,12473,11565,908,7.3,142514,136662,5853,4.1
Iberville,9/1/2000,12467,11564,903,7.2,142518,136893,5625,3.9
Iberville,10/1/2000,12455,11600,855,6.9,142622,137088,5534,3.9
Iberville,11/1/2000,12525,11628,897,7.2,142962,137322,5639,3.9
Iberville,12/1/2000,12501,11615,886,7.1,143248,137614,5634,3.9
Iberville,1/1/2001,12476,11471,1005,8.1,143800,137778,6023,4.2
Iberville,2/1/2001,12325,11485,840,6.8,143701,137612,6089,4.2
Iberville,3/1/2001,12342,11476,866,7,143924,137783,6141,4.3
Iberville,4/1/2001,12423,11548,875,7,143569,137299,6271,4.4
Iberville,5/1/2001,12320,11501,819,6.6,143318,137092,6226,4.3
Iberville,6/1/2001,12509,11539,970,7.8,143357,136873,6484,4.5
Iberville,7/1/2001,12326,11439,887,7.2,143654,137071,6583,4.6
Iberville,8/1/2001,12248,11345,903,7.4,143284,136241,7042,4.9
Iberville,9/1/2001,12338,11394,944,7.7,143989,136846,7142,5
Iberville,10/1/2001,12473,11567,906,7.3,144086,136392,7694,5.3
Iberville,11/1/2001,12467,11550,917,7.4,144240,136238,8003,5.5
Iberville,12/1/2001,12431,11505,926,7.4,144305,136047,8258,5.7
Iberville,1/1/2002,12093,11083,1010,8.4,143883,135701,8182,5.7
Iberville,2/1/2002,12152,11225,927,7.6,144653,136438,8215,5.7
Iberville,3/1/2002,12179,11201,978,8,144481,136177,8304,5.7
Iberville,4/1/2002,12237,11314,923,7.5,144725,136126,8599,5.9
Iberville,5/1/2002,12175,11209,966,7.9,144938,136539,8399,5.8
Iberville,6/1/2002,12398,11293,1105,8.9,144808,136415,8393,5.8
Iberville,7/1/2002,12259,11247,1012,8.3,144803,136413,8390,5.8
Iberville,8/1/2002,12237,11229,1008,8.2,145009,136705,8304,5.7
Iberville,9/1/2002,12289,11305,984,8,145552,137302,8251,5.7
Iberville,10/1/2002,12339,11401,938,7.6,145314,137008,8307,5.7
Iberville,11/1/2002,12261,11323,938,7.7,145041,136521,8520,5.9
Iberville,12/1/2002,12185,11235,950,7.8,145066,136426,8640,6
Iberville,1/1/2003,12001,10951,1050,8.7,145937,137417,8520,5.8
Iberville,2/1/2003,12113,11149,964,8,146100,137482,8618,5.9
Iberville,3/1/2003,12178,11125,1053,8.6,146022,137434,8588,5.9
Iberville,4/1/2003,12352,11276,1076,8.7,146474,137633,8842,6
Iberville,5/1/2003,12214,11144,1070,8.8,146500,137544,8957,6.1
Iberville,6/1/2003,12458,11127,1331,10.7,147056,137790,9266,6.3
Iberville,7/1/2003,12454,11206,1248,10,146485,137474,9011,6.2
Iberville,8/1/2003,12350,11127,1223,9.9,146445,137549,8896,6.1
Iberville,9/1/2003,12286,11143,1143,9.3,146530,137609,8921,6.1
Iberville,10/1/2003,12349,11312,1037,8.4,146716,137984,8732,6
Iberville,11/1/2003,12306,11285,1021,8.3,147000,138424,8576,5.8
Iberville,12/1/2003,12230,11206,1024,8.4,146729,138411,8317,5.7
Iberville,1/1/2004,12148,10923,1225,10.1,146842,138472,8370,5.7
Iberville,2/1/2004,12073,11095,978,8.1,146709,138542,8167,5.6
Iberville,3/1/2004,12229,11179,1050,8.6,146944,138453,8491,5.8
Iberville,4/1/2004,12261,11207,1054,8.6,146850,138680,8170,5.6
Iberville,5/1/2004,12084,11053,1031,8.5,147065,138852,8212,5.6
Iberville,6/1/2004,12373,11166,1207,9.8,147460,139174,8286,5.6
Iberville,7/1/2004,12343,11221,1122,9.1,147692,139556,8136,5.5
Iberville,8/1/2004,12283,11182,1101,9,147564,139573,7990,5.4
Iberville,9/1/2004,12290,11178,1112,9,147415,139487,7927,5.4
Iberville,10/1/2004,12333,11287,1046,8.5,147793,139732,8061,5.5
Iberville,11/1/2004,12281,11363,918,7.5,148162,140231,7932,5.4
Iberville,12/1/2004,12187,11291,896,7.4,148059,140125,7934,5.4
Iberville,1/1/2005,12008,10955,1053,8.8,148029,140245,7784,5.3
Iberville,2/1/2005,12055,11105,950,7.9,148364,140385,7980,5.4
Iberville,3/1/2005,12120,11191,929,7.7,148391,140654,7737,5.2
Iberville,4/1/2005,12242,11368,874,7.1,148926,141254,7672,5.2
Iberville,5/1/2005,12094,11192,902,7.5,149261,141609,7651,5.1
Iberville,6/1/2005,12329,11233,1096,8.9,149238,141714,7524,5
Iberville,7/1/2005,12324,11298,1026,8.3,149432,142026,7406,5
Iberville,8/1/2005,12296,11301,995,8.1,149779,142434,7345,4.9
Iberville,9/1/2005,13940,12172,1768,12.7,149954,142401,7553,5
Iberville,10/1/2005,13906,12392,1514,10.9,150001,142548,7453,5
Iberville,11/1/2005,13891,12406,1485,10.7,150065,142499,7566,5
Iberville,12/1/2005,13198,12258,940,7.1,150030,142752,7279,4.9
Iberville,1/1/2006,12443,11679,764,6.1,150214,143150,7064,4.7
Iberville,2/1/2006,12484,11824,660,5.3,150641,143457,7184,4.8
Iberville,3/1/2006,12559,11854,705,5.6,150813,143741,7072,4.7
Iberville,4/1/2006,12457,11806,651,5.2,150881,143761,7120,4.7
Iberville,5/1/2006,12436,11714,722,5.8,151069,144089,6980,4.6
Iberville,6/1/2006,12547,11643,904,7.2,151354,144353,7001,4.6
Iberville,7/1/2006,12322,11537,785,6.4,151377,144202,7175,4.7
Iberville,8/1/2006,12311,11571,740,6,151716,144625,7091,4.7
Iberville,9/1/2006,12298,11583,715,5.8,151662,144815,6847,4.5
Iberville,10/1/2006,12422,11730,692,5.6,152041,145314,6727,4.4
Iberville,11/1/2006,12410,11726,684,5.5,152406,145534,6872,4.5
Iberville,12/1/2006,12397,11741,656,5.3,152732,145970,6762,4.4
Iberville,1/1/2007,12039,11285,754,6.3,153144,146028,7116,4.6
Iberville,2/1/2007,12063,11415,648,5.4,152983,146057,6927,4.5
Iberville,3/1/2007,12193,11544,649,5.3,153051,146320,6731,4.4
Iberville,4/1/2007,12218,11571,647,5.3,152435,145586,6850,4.5
Iberville,5/1/2007,12212,11544,668,5.5,152670,145903,6766,4.4
Iberville,6/1/2007,12445,11625,820,6.6,153041,146063,6979,4.6
Iberville,7/1/2007,12532,11713,819,6.5,153054,145905,7149,4.7
Iberville,8/1/2007,12326,11594,732,5.9,152749,145682,7067,4.6
Iberville,9/1/2007,12408,11669,739,6,153414,146244,7170,4.7
Iberville,10/1/2007,12383,11764,619,5,153183,145946,7237,4.7
Iberville,11/1/2007,12416,11822,594,4.8,153835,146595,7240,4.7
Iberville,12/1/2007,12416,11756,660,5.3,153918,146273,7645,5
Iberville,1/1/2008,12134,11399,735,6.1,154063,146378,7685,5
Iberville,2/1/2008,12147,11496,651,5.4,153653,146156,7497,4.9
Iberville,3/1/2008,12296,11577,719,5.8,153908,146086,7822,5.1
Iberville,4/1/2008,12334,11686,648,5.3,153769,146132,7637,5
Iberville,5/1/2008,12324,11610,714,5.8,154303,145908,8395,5.4
Iberville,6/1/2008,12616,11734,882,7,154313,145737,8575,5.6
Iberville,7/1/2008,12630,11744,886,7,154469,145532,8937,5.8
Iberville,8/1/2008,12476,11620,856,6.9,154641,145203,9438,6.1
Iberville,9/1/2008,12668,11641,1027,8.1,154570,145076,9494,6.1
Iberville,10/1/2008,12661,11783,878,6.9,154876,144802,10074,6.5
Iberville,11/1/2008,12632,11777,855,6.8,154639,144100,10538,6.8
Iberville,12/1/2008,12651,11719,932,7.4,154655,143369,11286,7.3
Iberville,1/1/2009,12291,11213,1078,8.8,154210,142152,12058,7.8
Iberville,2/1/2009,12357,11308,1049,8.5,154538,141640,12898,8.3
Iberville,3/1/2009,12480,11359,1121,9,154133,140707,13426,8.7
Iberville,4/1/2009,12496,11422,1074,8.6,154509,140656,13853,9
Iberville,5/1/2009,12457,11318,1139,9.1,154747,140248,14499,9.4
Iberville,6/1/2009,12663,11339,1324,10.5,154716,140009,14707,9.5
Iberville,7/1/2009,12830,11469,1361,10.6,154502,139901,14601,9.5
Iberville,8/1/2009,12622,11373,1249,9.9,154307,139492,14814,9.6
Iberville,9/1/2009,12610,11413,1197,9.5,153827,138818,15009,9.8
Iberville,10/1/2009,12517,11377,1140,9.1,153784,138432,15352,10
Iberville,11/1/2009,12510,11414,1096,8.8,153878,138659,15219,9.9
Iberville,12/1/2009,12364,11232,1132,9.2,153111,138013,15098,9.9
Iberville,1/1/2010,13766,12457,1309,9.5,153484,138438,15046,9.8
Iberville,2/1/2010,13773,12591,1182,8.6,153694,138581,15113,9.8
Iberville,3/1/2010,13907,12686,1221,8.8,153954,138751,15202,9.9
Iberville,4/1/2010,13981,12832,1149,8.2,154622,139297,15325,9.9
Iberville,5/1/2010,13989,12727,1262,9,154091,139241,14849,9.6
Iberville,6/1/2010,14208,12775,1433,10.1,153616,139141,14474,9.4
Iberville,7/1/2010,14266,12850,1416,9.9,153691,139179,14512,9.4
Iberville,8/1/2010,14180,12781,1399,9.9,154086,139438,14648,9.5
Iberville,9/1/2010,14117,12731,1386,9.8,153975,139396,14579,9.5
Iberville,10/1/2010,14159,12820,1339,9.5,153635,139119,14516,9.4
Iberville,11/1/2010,14095,12743,1352,9.6,154125,139044,15081,9.8
Iberville,12/1/2010,13984,12631,1353,9.7,153650,139301,14348,9.3
Iberville,1/1/2011,13914,12423,1491,10.7,153263,139250,14013,9.1
Iberville,2/1/2011,13958,12556,1402,10,153214,139394,13820,9
Iberville,3/1/2011,13992,12616,1376,9.8,153376,139639,13737,9
Iberville,4/1/2011,14003,12726,1277,9.1,153543,139586,13957,9.1
Iberville,5/1/2011,13974,12652,1322,9.5,153479,139624,13855,9
Iberville,6/1/2011,14106,12592,1514,10.7,153346,139384,13962,9.1
Iberville,7/1/2011,14148,12694,1454,10.3,153288,139524,13763,9
Iberville,8/1/2011,13971,12598,1373,9.8,153760,139942,13818,9
Iberville,9/1/2011,14081,12704,1377,9.8,154131,140183,13948,9
Iberville,10/1/2011,14109,12824,1285,9.1,153961,140368,13594,8.8
Iberville,11/1/2011,14052,12816,1236,8.8,154128,140826,13302,8.6
Iberville,12/1/2011,14020,12711,1309,9.3,153995,140902,13093,8.5
Iberville,1/1/2012,13811,12389,1422,10.3,154381,141584,12797,8.3
Iberville,2/1/2012,13897,12574,1323,9.5,154671,141858,12813,8.3
Iberville,3/1/2012,13906,12634,1272,9.1,154749,142036,12713,8.2
Iberville,4/1/2012,13880,12724,1156,8.3,154545,141899,12646,8.2
Iberville,5/1/2012,13908,12691,1217,8.8,154866,142206,12660,8.2
Iberville,6/1/2012,14103,12687,1416,10,155083,142391,12692,8.2
Iberville,7/1/2012,14110,12725,1385,9.8,154948,142292,12656,8.2
Iberville,8/1/2012,13960,12681,1279,9.2,154763,142291,12471,8.1
Iberville,9/1/2012,13986,12784,1202,8.6,155160,143044,12115,7.8
Iberville,10/1/2012,14053,12933,1120,8,155554,143431,12124,7.8
Iberville,11/1/2012,13940,12921,1019,7.3,155338,143333,12005,7.7
Iberville,12/1/2012,13875,12797,1078,7.8,155628,143330,12298,7.9
Iberville,1/1/2013,13789,12556,1233,8.9,155763,143292,12471,8
Iberville,2/1/2013,13844,12696,1148,8.3,155312,143362,11950,7.7
Iberville,3/1/2013,13903,12764,1139,8.2,155005,143316,11689,7.5
Iberville,4/1/2013,13982,12925,1057,7.6,155394,143635,11760,7.6
Iberville,5/1/2013,14080,12946,1134,8.1,155536,143882,11654,7.5
Iberville,6/1/2013,14236,12943,1293,9.1,155749,143999,11751,7.5
Iberville,7/1/2013,14239,13054,1185,8.3,155599,144264,11335,7.3
Iberville,8/1/2013,14104,12984,1120,7.9,155605,144326,11279,7.2
Iberville,9/1/2013,14149,13035,1114,7.9,155687,144418,11270,7.2
Iberville,10/1/2013,14053,13030,1023,7.3,154673,143537,11136,7.2
Iberville,11/1/2013,14064,13076,988,7,155265,144479,10787,6.9
Iberville,12/1/2013,13924,12946,978,7,155182,144778,10404,6.7
Iberville,1/1/2014,13775,12733,1042,7.6,155352,145150,10202,6.6
Iberville,2/1/2014,13864,12902,962,6.9,155483,145134,10349,6.7
Iberville,3/1/2014,13987,13016,971,6.9,156028,145648,10380,6.7
Iberville,4/1/2014,14033,13105,928,6.6,155369,145667,9702,6.2
Iberville,5/1/2014,14144,13107,1037,7.3,155684,145825,9859,6.3
Iberville,6/1/2014,14344,13163,1181,8.2,155707,146247,9460,6.1
Iberville,7/1/2014,14565,13309,1256,8.6,156007,146399,9608,6.2
Iberville,8/1/2014,14530,13302,1228,8.5,156130,146530,9599,6.1
Iberville,9/1/2014,14565,13400,1165,8,156040,146778,9262,5.9
Iberville,10/1/2014,14628,13530,1098,7.5,156417,147427,8990,5.7
Iberville,11/1/2014,14572,13431,1141,7.8,156494,147404,9090,5.8
Iberville,12/1/2014,14452,13321,1131,7.8,156332,147615,8717,5.6
Iberville,1/1/2015,14272,13035,1237,8.7,157030,148145,8885,5.7
Iberville,2/1/2015,14270,13163,1107,7.8,156644,148045,8599,5.5
Iberville,3/1/2015,14339,13259,1080,7.5,156643,148128,8515,5.4
Iberville,4/1/2015,14302,13292,1010,7.1,157060,148511,8550,5.4
Iberville,5/1/2015,14363,13303,1060,7.4,157651,148817,8834,5.6
Iberville,6/1/2015,14468,13338,1130,7.8,157062,148816,8247,5.3
Iberville,7/1/2015,14511,13430,1081,7.4,156997,148830,8167,5.2
Iberville,8/1/2015,14351,13342,1009,7,157172,149181,7992,5.1
Iberville,9/1/2015,14289,13302,987,6.9,156733,148826,7907,5
Iberville,10/1/2015,14314,13372,942,6.6,157167,149246,7922,5
Iberville,11/1/2015,14313,13404,909,6.4,157463,149463,8000,5.1
Iberville,12/1/2015,14194,13300,894,6.3,158035,150128,7907,5
Iberville,1/1/2016,13961,12981,980,7,158280,150653,7627,4.8
Iberville,2/1/2016,14090,13143,947,6.7,158640,150939,7702,4.9
Iberville,3/1/2016,14209,13268,941,6.6,159179,151218,7961,5
Iberville,4/1/2016,14184,13261,923,6.5,159141,151074,8067,5.1
Iberville,5/1/2016,14133,13198,935,6.6,158784,151132,7652,4.8
Iberville,6/1/2016,14348,13237,1111,7.7,158967,151223,7744,4.9
Iberville,7/1/2016,14354,13271,1083,7.5,159194,151554,7641,4.8
Iberville,8/1/2016,14043,13012,1031,7.3,159562,151779,7784,4.9
Iberville,9/1/2016,14087,13090,997,7.1,159714,151761,7953,5
Iberville,10/1/2016,14039,13157,882,6.3,159605,151793,7811,4.9
Iberville,11/1/2016,13963,13134,829,5.9,159506,151954,7553,4.7
Iberville,12/1/2016,13831,12951,880,6.4,159678,152157,7521,4.7
Iberville,1/1/2017,13977,13001,976,7,159620,152152,7468,4.7
Iberville,2/1/2017,14126,13214,912,6.5,159859,152480,7379,4.6
Iberville,3/1/2017,14174,13312,862,6.1,160137,153065,7073,4.4
Iberville,4/1/2017,14165,13301,864,6.1,160345,153255,7089,4.4
Iberville,5/1/2017,14072,13222,850,6,160068,153069,7000,4.4
Iberville,6/1/2017,14264,13265,999,7,160192,153318,6873,4.3
Iberville,7/1/2017,14263,13325,938,6.6,160462,153569,6892,4.3
Iberville,8/1/2017,14180,13270,910,6.4,160586,153503,7082,4.4
Iberville,9/1/2017,14199,13362,837,5.9,161140,154286,6854,4.3
Iberville,10/1/2017,14138,13364,774,5.5,160309,153609,6700,4.2
Iberville,11/1/2017,14100,13350,750,5.3,160579,153805,6774,4.2
Iberville,12/1/2017,14019,13249,770,5.5,160535,153904,6632,4.1
Iberville,1/1/2018,13877,12987,890,6.4,160914,154425,6489,4
Iberville,2/1/2018,14071,13195,876,6.2,161778,155197,6581,4.1
Iberville,3/1/2018,14258,13395,863,6.1,161686,155214,6472,4
Iberville,4/1/2018,14151,13341,810,5.7,161771,155312,6459,4
Iberville,5/1/2018,14045,13238,807,5.7,161848,155652,6196,3.8
Iberville,6/1/2018,14307,13279,1028,7.2,162210,155762,6447,4
Iberville,7/1/2018,14274,13287,987,6.9,162341,156146,6195,3.8
Iberville,8/1/2018,14063,13146,917,6.5,161660,155504,6156,3.8
Iberville,9/1/2018,14092,13239,853,6.1,162087,156015,6073,3.7
Iberville,10/1/2018,14191,13384,807,5.7,162602,156391,6211,3.8
Iberville,11/1/2018,14166,13419,747,5.3,162836,156721,6115,3.8
Iberville,12/1/2018,14097,13304,793,5.6,163206,156817,6389,3.9
Iberville,1/1/2019,13903,13033,870,6.3,162963,156487,6475,4
Iberville,2/1/2019,14009,13247,762,5.4,162999,156863,6136,3.8
Iberville,3/1/2019,14005,13298,707,5,162904,156701,6202,3.8
Iberville,4/1/2019,13875,13206,669,4.8,162586,156625,5961,3.7
Iberville,5/1/2019,13836,13118,718,5.2,162751,156821,5930,3.6
Iberville,6/1/2019,13948,13054,894,6.4,163168,157232,5935,3.6
Iberville,7/1/2019,13881,13009,872,6.3,163590,157529,6061,3.7
Iberville,8/1/2019,13914,13031,883,6.3,163774,157829,5945,3.6
Iberville,9/1/2019,13959,13144,815,5.8,164092,158339,5753,3.5
Iberville,10/1/2019,14020,13189,831,5.9,164416,158545,5871,3.6
Iberville,11/1/2019,13994,13196,798,5.7,164496,158629,5868,3.6
Iberville,12/1/2019,13790,13012,778,5.6,164699,158845,5853,3.6
Iberville,1/1/2020,13405,12589,816,6.1,164377,158508,5869,3.6
Iberville,2/1/2020,13495,12783,712,5.3,164467,158714,5753,3.5
Iberville,3/1/2020,13902,12640,1262,9.1,162559,155353,7206,4.4
Iberville,4/1/2020,12662,10970,1692,13.4,156269,133185,23084,14.8
Iberville,5/1/2020,13125,11288,1837,14,158101,137173,20929,13.2
Iberville,6/1/2020,13508,11644,1864,13.8,159994,142342,17652,11
Iberville,7/1/2020,13586,11784,1802,13.3,160132,143779,16352,10.2
Iberville,8/1/2020,13670,12126,1544,11.3,160706,147245,13461,8.4
Iberville,9/1/2020,13900,12327,1573,11.3,160174,147620,12554,7.8
Iberville,10/1/2020,13984,12605,1379,9.9,161003,149931,11072,6.9
Iberville,11/1/2020,13722,12519,1203,8.8,160629,149934,10694,6.7
Iberville,12/1/2020,13648,12443,1205,8.8,160745,149975,10770,6.7
Iberville,1/1/2021,13542,12327,1215,9,160088,149852,10236,6.4
Iberville,2/1/2021,13602,12475,1127,8.3,160184,150189,9995,6.2
Iberville,3/1/2021,13630,12569,1061,7.8,160400,150644,9756,6.1
Iberville,4/1/2021,13763,12664,1099,8,160843,151081,9762,6.1
Iberville,5/1/2021,13687,12584,1103,8.1,160800,151535,9266,5.8
Iberville,6/1/2021,13733,12471,1262,9.2,161197,151734,9462,5.9
Iberville,7/1/2021,13653,12523,1130,8.3,161504,152773,8731,5.4
Iberville,8/1/2021,13561,12579,982,7.2,161527,153250,8276,5.1
Iberville,9/1/2021,13795,12964,831,6,161495,153843,7652,4.7
Iberville,10/1/2021,13714,13002,712,5.2,161754,154475,7279,4.5
Iberville,11/1/2021,13745,13095,650,4.7,162281,155530,6751,4.2
Iberville,12/1/2021,13641,13065,576,4.2,162497,156099,6398,3.9
Iberville,1/1/2022,13736,13048,688,5,163627,157115,6512,4
Iberville,2/1/2022,13895,13266,629,4.5,163899,157598,6301,3.8
Iberville,3/1/2022,13923,13324,599,4.3,164220,158206,6014,3.7
Iberville,4/1/2022,13869,13310,559,4,163893,157891,6002,3.7
Iberville,5/1/2022,13770,13178,592,4.3,164362,158378,5983,3.6
Iberville,6/1/2022,13840,13107,733,5.3,164046,158094,5951,3.6
Iberville,7/1/2022,13897,13209,688,5,164026,158258,5768,3.5
Iberville,8/1/2022,13815,13162,653,4.7,164654,158735,5919,3.6
Iberville,9/1/2022,13799,13208,591,4.3,164602,158810,5792,3.5
Iberville,10/1/2022,13781,13244,537,3.9,164648,158684,5964,3.6
Iberville,11/1/2022,13774,13234,540,3.9,164450,158507,5943,3.6
Iberville,12/1/2022,13698,13178,520,3.8,165025,159259,5766,3.5
Iberville,1/1/2023,13654,13061,593,4.3,165964,160217,5747,3.5
Iberville,2/1/2023,13776,13222,554,4,166358,160395,5962,3.6
Iberville,3/1/2023,13907,13373,534,3.8,166651,160812,5839,3.5
Iberville,4/1/2023,13846,13367,479,3.5,166725,160974,5751,3.4
Iberville,5/1/2023,13776,13208,568,4.1,166886,160796,6089,3.6
Iberville,6/1/2023,13828,13151,677,4.9,166937,160979,5958,3.6
Iberville,7/1/2023,13860,13261,599,4.3,167103,161183,5920,3.5
Iberville,8/1/2023,13867,13216,651,4.7,167759,161475,6284,3.7
Iberville,9/1/2023,13921,13315,606,4.4,167767,161442,6326,3.8
Iberville,10/1/2023,13968,13375,593,4.2,167690,161211,6479,3.9
Iberville,11/1/2023,14034,13448,586,4.2,168140,161886,6254,3.7
Iberville,12/1/2023,13881,13302,579,4.2,167439,161124,6315,3.8
Iberville,1/1/2024,13884,13220,664,4.8,167339,161190,6149,3.7
Iberville,2/1/2024,13876,13266,610,4.4,167475,161013,6462,3.9
Iberville,3/1/2024,14042,13454,588,4.2,167922,161425,6497,3.9
Iberville,4/1/2024,14030,13484,546,3.9,167988,161495,6492,3.9
Iberville,5/1/2024,13887,13336,551,4,167799,161164,6635,4
Iberville,6/1/2024,14049,13304,745,5.3,168005,161155,6849,4.1
Iberville,7/1/2024,14117,13353,764,5.4,168315,161219,7097,4.2
Iberville,8/1/2024,14036,13292,744,5.3,168496,161425,7071,4.2
Iberville,9/1/2024,13978,13278,700,5,168703,161802,6901,4.1
Iberville,10/1/2024,14089,13378,711,5,168428,161456,6972,4.1
Iberville,11/1/2024,14025,13335,690,4.9,168304,161183,7121,4.2
Iberville,12/1/2024,13919,13285,634,4.6,168547,161661,6886,4.1
Iberville,1/1/2025,12614,11952,662,5.2,170744,163895,6849,4
Iberville,2/1/2025,12591,11965,626,5,170359,163307,7052,4.1
Jackson,1/1/1990,6055,5751,304,5,125833,119081,6752,5.4
Jackson,2/1/1990,5961,5616,345,5.8,125710,119059,6651,5.3
Jackson,3/1/1990,5978,5676,302,5.1,125801,119203,6598,5.2
Jackson,4/1/1990,5847,5561,286,4.9,125649,118852,6797,5.4
Jackson,5/1/1990,5906,5668,238,4,125893,119151,6742,5.4
Jackson,6/1/1990,5896,5595,301,5.1,125573,118983,6590,5.2
Jackson,7/1/1990,5974,5707,267,4.5,125732,118810,6922,5.5
Jackson,8/1/1990,5969,5669,300,5,125990,118802,7188,5.7
Jackson,9/1/1990,6054,5738,316,5.2,125892,118524,7368,5.9
Jackson,10/1/1990,6034,5721,313,5.2,125995,118536,7459,5.9
Jackson,11/1/1990,6026,5715,311,5.2,126070,118306,7764,6.2
Jackson,12/1/1990,5972,5707,265,4.4,126142,118241,7901,6.3
Jackson,1/1/1991,5968,5606,362,6.1,125955,117940,8015,6.4
Jackson,2/1/1991,6015,5653,362,6,126020,117755,8265,6.6
Jackson,3/1/1991,6087,5773,314,5.2,126238,117652,8586,6.8
Jackson,4/1/1991,6274,5956,318,5.1,126548,118109,8439,6.7
Jackson,5/1/1991,6353,6043,310,4.9,126176,117440,8736,6.9
Jackson,6/1/1991,6536,6167,369,5.6,126331,117639,8692,6.9
Jackson,7/1/1991,6769,6419,350,5.2,126154,117568,8586,6.8
Jackson,8/1/1991,7102,6511,591,8.3,126150,117484,8666,6.9
Jackson,9/1/1991,6801,6495,306,4.5,126650,117928,8722,6.9
Jackson,10/1/1991,6710,6402,308,4.6,126642,117800,8842,7
Jackson,11/1/1991,6635,6382,253,3.8,126701,117770,8931,7
Jackson,12/1/1991,6670,6383,287,4.3,126664,117466,9198,7.3
Jackson,1/1/1992,6406,6020,386,6,127261,117978,9283,7.3
Jackson,2/1/1992,6274,5900,374,6,127207,117753,9454,7.4
Jackson,3/1/1992,6309,5923,386,6.1,127604,118144,9460,7.4
Jackson,4/1/1992,6301,5960,341,5.4,127841,118426,9415,7.4
Jackson,5/1/1992,6335,6017,318,5,128119,118375,9744,7.6
Jackson,6/1/1992,6477,6051,426,6.6,128459,118419,10040,7.8
Jackson,7/1/1992,6727,6349,378,5.6,128563,118713,9850,7.7
Jackson,8/1/1992,6704,6341,363,5.4,128613,118826,9787,7.6
Jackson,9/1/1992,6725,6366,359,5.3,128501,118720,9781,7.6
Jackson,10/1/1992,6469,6159,310,4.8,128026,118628,9398,7.3
Jackson,11/1/1992,6414,6110,304,4.7,128441,118876,9565,7.4
Jackson,12/1/1992,6293,5992,301,4.8,128554,118997,9557,7.4
Jackson,1/1/1993,6111,5770,341,5.6,128400,119075,9325,7.3
Jackson,2/1/1993,6132,5805,327,5.3,128458,119275,9183,7.1
Jackson,3/1/1993,6186,5873,313,5.1,128598,119542,9056,7
Jackson,4/1/1993,6139,5847,292,4.8,128584,119474,9110,7.1
Jackson,5/1/1993,6257,5941,316,5.1,129264,120115,9149,7.1
Jackson,6/1/1993,6289,5908,381,6.1,129411,120290,9121,7
Jackson,7/1/1993,6309,5987,322,5.1,129397,120467,8930,6.9
Jackson,8/1/1993,6281,5971,310,4.9,129619,120856,8763,6.8
Jackson,9/1/1993,6224,5905,319,5.1,129268,120554,8714,6.7
Jackson,10/1/1993,6246,5940,306,4.9,129573,120823,8750,6.8
Jackson,11/1/1993,6291,6023,268,4.3,129711,121169,8542,6.6
Jackson,12/1/1993,6312,6030,282,4.5,129941,121464,8477,6.5
Jackson,1/1/1994,6267,5906,361,5.8,130596,121966,8630,6.6
Jackson,2/1/1994,6346,6001,345,5.4,130669,122086,8583,6.6
Jackson,3/1/1994,6305,5988,317,5,130400,121930,8470,6.5
Jackson,4/1/1994,6401,6090,311,4.9,130621,122290,8331,6.4
Jackson,5/1/1994,6536,6191,345,5.3,130779,122864,7915,6.1
Jackson,6/1/1994,6501,6083,418,6.4,130561,122634,7927,6.1
Jackson,7/1/1994,6480,6102,378,5.8,130652,122706,7946,6.1
Jackson,8/1/1994,6443,6086,357,5.5,131275,123342,7933,6
Jackson,9/1/1994,6290,5866,424,6.7,131421,123687,7734,5.9
Jackson,10/1/1994,6378,5933,445,7,131744,124112,7632,5.8
Jackson,11/1/1994,6326,5933,393,6.2,131891,124516,7375,5.6
Jackson,12/1/1994,6325,5961,364,5.8,131951,124721,7230,5.5
Jackson,1/1/1995,6306,5866,440,7,132038,124663,7375,5.6
Jackson,2/1/1995,6273,5895,378,6,132115,124928,7187,5.4
Jackson,3/1/1995,6263,5895,368,5.9,132108,124955,7153,5.4
Jackson,4/1/1995,6306,5960,346,5.5,132590,124945,7645,5.8
Jackson,5/1/1995,6324,5990,334,5.3,131851,124421,7430,5.6
Jackson,6/1/1995,6470,6049,421,6.5,131949,124522,7427,5.6
Jackson,7/1/1995,6434,6073,361,5.6,132343,124816,7527,5.7
Jackson,8/1/1995,6394,6025,369,5.8,132336,124852,7484,5.7
Jackson,9/1/1995,6277,5921,356,5.7,132611,125133,7478,5.6
Jackson,10/1/1995,6344,5984,360,5.7,132716,125388,7328,5.5
Jackson,11/1/1995,6250,5917,333,5.3,132614,125188,7426,5.6
Jackson,12/1/1995,6233,5922,311,5,132511,125088,7423,5.6
Jackson,1/1/1996,6460,5949,511,7.9,132616,125125,7491,5.6
Jackson,2/1/1996,6317,5981,336,5.3,132952,125639,7313,5.5
Jackson,3/1/1996,6339,6011,328,5.2,133180,125862,7318,5.5
Jackson,4/1/1996,6571,6227,344,5.2,133409,125994,7415,5.6
Jackson,5/1/1996,6565,6215,350,5.3,133667,126244,7423,5.6
Jackson,6/1/1996,6626,6195,431,6.5,133697,126602,7095,5.3
Jackson,7/1/1996,6254,5866,388,6.2,134284,126947,7337,5.5
Jackson,8/1/1996,6231,5843,388,6.2,134054,127172,6882,5.1
Jackson,9/1/1996,6406,6028,378,5.9,134515,127536,6979,5.2
Jackson,10/1/1996,6350,5973,377,5.9,134921,127890,7031,5.2
Jackson,11/1/1996,6319,5940,379,6,135007,127771,7236,5.4
Jackson,12/1/1996,6310,5899,411,6.5,135113,127860,7253,5.4
Jackson,1/1/1997,6258,5763,495,7.9,135456,128298,7158,5.3
Jackson,2/1/1997,6209,5749,460,7.4,135400,128298,7102,5.2
Jackson,3/1/1997,6295,5789,506,8,135891,128891,7000,5.2
Jackson,4/1/1997,6147,5686,461,7.5,136016,129143,6873,5.1
Jackson,5/1/1997,6182,5709,473,7.7,136119,129464,6655,4.9
Jackson,6/1/1997,6167,5617,550,8.9,136211,129412,6799,5
Jackson,7/1/1997,5944,5432,512,8.6,136477,129822,6655,4.9
Jackson,8/1/1997,5918,5462,456,7.7,136618,130010,6608,4.8
Jackson,9/1/1997,6023,5593,430,7.1,136675,130019,6656,4.9
Jackson,10/1/1997,6012,5621,391,6.5,136633,130179,6454,4.7
Jackson,11/1/1997,5975,5609,366,6.1,136961,130653,6308,4.6
Jackson,12/1/1997,5820,5494,326,5.6,137155,130679,6476,4.7
Jackson,1/1/1998,5911,5490,421,7.1,137095,130726,6368,4.6
Jackson,2/1/1998,5842,5516,326,5.6,137112,130807,6306,4.6
Jackson,3/1/1998,5923,5558,365,6.2,137236,130814,6422,4.7
Jackson,4/1/1998,5866,5535,331,5.6,137150,131209,5941,4.3
Jackson,5/1/1998,5945,5607,338,5.7,137372,131325,6047,4.4
Jackson,6/1/1998,5988,5616,372,6.2,137455,131244,6212,4.5
Jackson,7/1/1998,5960,5565,395,6.6,137588,131329,6259,4.5
Jackson,8/1/1998,5946,5546,400,6.7,137570,131390,6179,4.5
Jackson,9/1/1998,5946,5547,399,6.7,138286,131986,6300,4.6
Jackson,10/1/1998,5977,5596,381,6.4,138279,131999,6280,4.5
Jackson,11/1/1998,5960,5625,335,5.6,138381,132280,6100,4.4
Jackson,12/1/1998,5937,5612,325,5.5,138634,132602,6032,4.4
Jackson,1/1/1999,5838,5471,367,6.3,139003,133027,5976,4.3
Jackson,2/1/1999,5735,5424,311,5.4,138967,132856,6111,4.4
Jackson,3/1/1999,5745,5465,280,4.9,138730,132947,5783,4.2
Jackson,4/1/1999,5658,5399,259,4.6,138959,132955,6004,4.3
Jackson,5/1/1999,5687,5435,252,4.4,139107,133311,5796,4.2
Jackson,6/1/1999,5640,5338,302,5.4,139329,133378,5951,4.3
Jackson,7/1/1999,5530,5235,295,5.3,139439,133414,6025,4.3
Jackson,8/1/1999,5575,5295,280,5,139430,133591,5838,4.2
Jackson,9/1/1999,5475,5164,311,5.7,139622,133707,5915,4.2
Jackson,10/1/1999,5511,5240,271,4.9,139771,133993,5778,4.1
Jackson,11/1/1999,5486,5223,263,4.8,140025,134309,5716,4.1
Jackson,12/1/1999,5412,5160,252,4.7,140177,134523,5653,4
Jackson,1/1/2000,6618,6269,349,5.3,142267,136559,5708,4
Jackson,2/1/2000,6705,6372,333,5,142456,136598,5858,4.1
Jackson,3/1/2000,6725,6389,336,5,142434,136701,5733,4
Jackson,4/1/2000,6724,6419,305,4.5,142751,137270,5481,3.8
Jackson,5/1/2000,6761,6431,330,4.9,142388,136630,5758,4
Jackson,6/1/2000,6714,6324,390,5.8,142591,136940,5651,4
Jackson,7/1/2000,6631,6286,345,5.2,142278,136531,5747,4
Jackson,8/1/2000,6572,6210,362,5.5,142514,136662,5853,4.1
Jackson,9/1/2000,6601,6217,384,5.8,142518,136893,5625,3.9
Jackson,10/1/2000,6738,6248,490,7.3,142622,137088,5534,3.9
Jackson,11/1/2000,6665,6262,403,6,142962,137322,5639,3.9
Jackson,12/1/2000,6687,6282,405,6.1,143248,137614,5634,3.9
Jackson,1/1/2001,6736,6226,510,7.6,143800,137778,6023,4.2
Jackson,2/1/2001,6734,6254,480,7.1,143701,137612,6089,4.2
Jackson,3/1/2001,6761,6257,504,7.5,143924,137783,6141,4.3
Jackson,4/1/2001,6771,6284,487,7.2,143569,137299,6271,4.4
Jackson,5/1/2001,6679,6260,419,6.3,143318,137092,6226,4.3
Jackson,6/1/2001,6628,6163,465,7,143357,136873,6484,4.5
Jackson,7/1/2001,6631,6225,406,6.1,143654,137071,6583,4.6
Jackson,8/1/2001,6504,6126,378,5.8,143284,136241,7042,4.9
Jackson,9/1/2001,6624,6217,407,6.1,143989,136846,7142,5
Jackson,10/1/2001,6606,6212,394,6,144086,136392,7694,5.3
Jackson,11/1/2001,6633,6237,396,6,144240,136238,8003,5.5
Jackson,12/1/2001,6602,6206,396,6,144305,136047,8258,5.7
Jackson,1/1/2002,6525,6078,447,6.9,143883,135701,8182,5.7
Jackson,2/1/2002,6568,6185,383,5.8,144653,136438,8215,5.7
Jackson,3/1/2002,6585,6182,403,6.1,144481,136177,8304,5.7
Jackson,4/1/2002,6604,6199,405,6.1,144725,136126,8599,5.9
Jackson,5/1/2002,6630,6216,414,6.2,144938,136539,8399,5.8
Jackson,6/1/2002,6666,6207,459,6.9,144808,136415,8393,5.8
Jackson,7/1/2002,6618,6186,432,6.5,144803,136413,8390,5.8
Jackson,8/1/2002,6545,6139,406,6.2,145009,136705,8304,5.7
Jackson,9/1/2002,6585,6175,410,6.2,145552,137302,8251,5.7
Jackson,10/1/2002,6564,6198,366,5.6,145314,137008,8307,5.7
Jackson,11/1/2002,6570,6146,424,6.5,145041,136521,8520,5.9
Jackson,12/1/2002,6539,6097,442,6.8,145066,136426,8640,6
Jackson,1/1/2003,6647,5974,673,10.1,145937,137417,8520,5.8
Jackson,2/1/2003,6612,5995,617,9.3,146100,137482,8618,5.9
Jackson,3/1/2003,6636,6000,636,9.6,146022,137434,8588,5.9
Jackson,4/1/2003,6657,6042,615,9.2,146474,137633,8842,6
Jackson,5/1/2003,6604,5986,618,9.4,146500,137544,8957,6.1
Jackson,6/1/2003,6668,6011,657,9.9,147056,137790,9266,6.3
Jackson,7/1/2003,6548,5989,559,8.5,146485,137474,9011,6.2
Jackson,8/1/2003,6509,5996,513,7.9,146445,137549,8896,6.1
Jackson,9/1/2003,6483,6014,469,7.2,146530,137609,8921,6.1
Jackson,10/1/2003,6495,6059,436,6.7,146716,137984,8732,6
Jackson,11/1/2003,6483,6042,441,6.8,147000,138424,8576,5.8
Jackson,12/1/2003,6420,6005,415,6.5,146729,138411,8317,5.7
Jackson,1/1/2004,6364,5892,472,7.4,146842,138472,8370,5.7
Jackson,2/1/2004,6369,5934,435,6.8,146709,138542,8167,5.6
Jackson,3/1/2004,6378,5945,433,6.8,146944,138453,8491,5.8
Jackson,4/1/2004,6378,5968,410,6.4,146850,138680,8170,5.6
Jackson,5/1/2004,6408,6008,400,6.2,147065,138852,8212,5.6
Jackson,6/1/2004,6428,5957,471,7.3,147460,139174,8286,5.6
Jackson,7/1/2004,6481,6042,439,6.8,147692,139556,8136,5.5
Jackson,8/1/2004,6418,6021,397,6.2,147564,139573,7990,5.4
Jackson,9/1/2004,6463,6065,398,6.2,147415,139487,7927,5.4
Jackson,10/1/2004,6408,6040,368,5.7,147793,139732,8061,5.5
Jackson,11/1/2004,6458,6093,365,5.7,148162,140231,7932,5.4
Jackson,12/1/2004,6380,6017,363,5.7,148059,140125,7934,5.4
Jackson,1/1/2005,6289,5904,385,6.1,148029,140245,7784,5.3
Jackson,2/1/2005,6290,5912,378,6,148364,140385,7980,5.4
Jackson,3/1/2005,6307,5954,353,5.6,148391,140654,7737,5.2
Jackson,4/1/2005,6312,5967,345,5.5,148926,141254,7672,5.2
Jackson,5/1/2005,6341,5990,351,5.5,149261,141609,7651,5.1
Jackson,6/1/2005,6332,5941,391,6.2,149238,141714,7524,5
Jackson,7/1/2005,6313,5962,351,5.6,149432,142026,7406,5
Jackson,8/1/2005,6231,5884,347,5.6,149779,142434,7345,4.9
Jackson,9/1/2005,6819,6354,465,6.8,149954,142401,7553,5
Jackson,10/1/2005,6866,6436,430,6.3,150001,142548,7453,5
Jackson,11/1/2005,6808,6358,450,6.6,150065,142499,7566,5
Jackson,12/1/2005,6581,6289,292,4.4,150030,142752,7279,4.9
Jackson,1/1/2006,6500,6240,260,4,150214,143150,7064,4.7
Jackson,2/1/2006,6470,6243,227,3.5,150641,143457,7184,4.8
Jackson,3/1/2006,6554,6309,245,3.7,150813,143741,7072,4.7
Jackson,4/1/2006,6611,6388,223,3.4,150881,143761,7120,4.7
Jackson,5/1/2006,6597,6354,243,3.7,151069,144089,6980,4.6
Jackson,6/1/2006,6669,6357,312,4.7,151354,144353,7001,4.6
Jackson,7/1/2006,6609,6344,265,4,151377,144202,7175,4.7
Jackson,8/1/2006,6504,6221,283,4.4,151716,144625,7091,4.7
Jackson,9/1/2006,6583,6298,285,4.3,151662,144815,6847,4.5
Jackson,10/1/2006,6681,6409,272,4.1,152041,145314,6727,4.4
Jackson,11/1/2006,6712,6417,295,4.4,152406,145534,6872,4.5
Jackson,12/1/2006,6585,6315,270,4.1,152732,145970,6762,4.4
Jackson,1/1/2007,6405,6092,313,4.9,153144,146028,7116,4.6
Jackson,2/1/2007,6453,6175,278,4.3,152983,146057,6927,4.5
Jackson,3/1/2007,6488,6210,278,4.3,153051,146320,6731,4.4
Jackson,4/1/2007,6491,6227,264,4.1,152435,145586,6850,4.5
Jackson,5/1/2007,6535,6239,296,4.5,152670,145903,6766,4.4
Jackson,6/1/2007,6532,6223,309,4.7,153041,146063,6979,4.6
Jackson,7/1/2007,6518,6240,278,4.3,153054,145905,7149,4.7
Jackson,8/1/2007,6391,6144,247,3.9,152749,145682,7067,4.6
Jackson,9/1/2007,6549,6284,265,4,153414,146244,7170,4.7
Jackson,10/1/2007,6539,6316,223,3.4,153183,145946,7237,4.7
Jackson,11/1/2007,6558,6307,251,3.8,153835,146595,7240,4.7
Jackson,12/1/2007,6458,6197,261,4,153918,146273,7645,5
Jackson,1/1/2008,6510,6207,303,4.7,154063,146378,7685,5
Jackson,2/1/2008,6473,6228,245,3.8,153653,146156,7497,4.9
Jackson,3/1/2008,6613,6319,294,4.4,153908,146086,7822,5.1
Jackson,4/1/2008,6646,6386,260,3.9,153769,146132,7637,5
Jackson,5/1/2008,6696,6392,304,4.5,154303,145908,8395,5.4
Jackson,6/1/2008,6696,6340,356,5.3,154313,145737,8575,5.6
Jackson,7/1/2008,6707,6346,361,5.4,154469,145532,8937,5.8
Jackson,8/1/2008,6629,6307,322,4.9,154641,145203,9438,6.1
Jackson,9/1/2008,6765,6487,278,4.1,154570,145076,9494,6.1
Jackson,10/1/2008,6695,6382,313,4.7,154876,144802,10074,6.5
Jackson,11/1/2008,6702,6367,335,5,154639,144100,10538,6.8
Jackson,12/1/2008,6595,6249,346,5.2,154655,143369,11286,7.3
Jackson,1/1/2009,6551,6072,479,7.3,154210,142152,12058,7.8
Jackson,2/1/2009,6551,6060,491,7.5,154538,141640,12898,8.3
Jackson,3/1/2009,6545,6073,472,7.2,154133,140707,13426,8.7
Jackson,4/1/2009,6610,6125,485,7.3,154509,140656,13853,9
Jackson,5/1/2009,6631,6132,499,7.5,154747,140248,14499,9.4
Jackson,6/1/2009,6651,6063,588,8.8,154716,140009,14707,9.5
Jackson,7/1/2009,6636,6084,552,8.3,154502,139901,14601,9.5
Jackson,8/1/2009,6488,5988,500,7.7,154307,139492,14814,9.6
Jackson,9/1/2009,6476,5994,482,7.4,153827,138818,15009,9.8
Jackson,10/1/2009,6573,6101,472,7.2,153784,138432,15352,10
Jackson,11/1/2009,6552,6120,432,6.6,153878,138659,15219,9.9
Jackson,12/1/2009,6500,6027,473,7.3,153111,138013,15098,9.9
Jackson,1/1/2010,6874,6358,516,7.5,153484,138438,15046,9.8
Jackson,2/1/2010,6947,6484,463,6.7,153694,138581,15113,9.8
Jackson,3/1/2010,7055,6581,474,6.7,153954,138751,15202,9.9
Jackson,4/1/2010,7209,6752,457,6.3,154622,139297,15325,9.9
Jackson,5/1/2010,7209,6737,472,6.5,154091,139241,14849,9.6
Jackson,6/1/2010,7243,6722,521,7.2,153616,139141,14474,9.4
Jackson,7/1/2010,7275,6753,522,7.2,153691,139179,14512,9.4
Jackson,8/1/2010,7131,6631,500,7,154086,139438,14648,9.5
Jackson,9/1/2010,7117,6646,471,6.6,153975,139396,14579,9.5
Jackson,10/1/2010,7124,6657,467,6.6,153635,139119,14516,9.4
Jackson,11/1/2010,7047,6585,462,6.6,154125,139044,15081,9.8
Jackson,12/1/2010,6974,6506,468,6.7,153650,139301,14348,9.3
Jackson,1/1/2011,6906,6377,529,7.7,153263,139250,14013,9.1
Jackson,2/1/2011,6919,6440,479,6.9,153214,139394,13820,9
Jackson,3/1/2011,6960,6494,466,6.7,153376,139639,13737,9
Jackson,4/1/2011,7027,6585,442,6.3,153543,139586,13957,9.1
Jackson,5/1/2011,7036,6570,466,6.6,153479,139624,13855,9
Jackson,6/1/2011,7131,6602,529,7.4,153346,139384,13962,9.1
Jackson,7/1/2011,7018,6514,504,7.2,153288,139524,13763,9
Jackson,8/1/2011,6971,6489,482,6.9,153760,139942,13818,9
Jackson,9/1/2011,6985,6498,487,7,154131,140183,13948,9
Jackson,10/1/2011,6960,6459,501,7.2,153961,140368,13594,8.8
Jackson,11/1/2011,6981,6510,471,6.7,154128,140826,13302,8.6
Jackson,12/1/2011,6907,6438,469,6.8,153995,140902,13093,8.5
Jackson,1/1/2012,6755,6254,501,7.4,154381,141584,12797,8.3
Jackson,2/1/2012,6760,6303,457,6.8,154671,141858,12813,8.3
Jackson,3/1/2012,6769,6328,441,6.5,154749,142036,12713,8.2
Jackson,4/1/2012,6841,6424,417,6.1,154545,141899,12646,8.2
Jackson,5/1/2012,6989,6551,438,6.3,154866,142206,12660,8.2
Jackson,6/1/2012,7064,6575,489,6.9,155083,142391,12692,8.2
Jackson,7/1/2012,7003,6530,473,6.8,154948,142292,12656,8.2
Jackson,8/1/2012,6832,6362,470,6.9,154763,142291,12471,8.1
Jackson,9/1/2012,6804,6380,424,6.2,155160,143044,12115,7.8
Jackson,10/1/2012,6879,6462,417,6.1,155554,143431,12124,7.8
Jackson,11/1/2012,6888,6520,368,5.3,155338,143333,12005,7.7
Jackson,12/1/2012,6871,6447,424,6.2,155628,143330,12298,7.9
Jackson,1/1/2013,6885,6393,492,7.1,155763,143292,12471,8
Jackson,2/1/2013,6874,6433,441,6.4,155312,143362,11950,7.7
Jackson,3/1/2013,6815,6392,423,6.2,155005,143316,11689,7.5
Jackson,4/1/2013,6871,6454,417,6.1,155394,143635,11760,7.6
Jackson,5/1/2013,6940,6492,448,6.5,155536,143882,11654,7.5
Jackson,6/1/2013,7064,6545,519,7.3,155749,143999,11751,7.5
Jackson,7/1/2013,6963,6490,473,6.8,155599,144264,11335,7.3
Jackson,8/1/2013,6807,6347,460,6.8,155605,144326,11279,7.2
Jackson,9/1/2013,7047,6606,441,6.3,155687,144418,11270,7.2
Jackson,10/1/2013,7361,6951,410,5.6,154673,143537,11136,7.2
Jackson,11/1/2013,7356,6976,380,5.2,155265,144479,10787,6.9
Jackson,12/1/2013,7341,7001,340,4.6,155182,144778,10404,6.7
Jackson,1/1/2014,6856,6473,383,5.6,155352,145150,10202,6.6
Jackson,2/1/2014,6978,6628,350,5,155483,145134,10349,6.7
Jackson,3/1/2014,7167,6801,366,5.1,156028,145648,10380,6.7
Jackson,4/1/2014,7237,6891,346,4.8,155369,145667,9702,6.2
Jackson,5/1/2014,7229,6843,386,5.3,155684,145825,9859,6.3
Jackson,6/1/2014,7367,6936,431,5.9,155707,146247,9460,6.1
Jackson,7/1/2014,7322,6844,478,6.5,156007,146399,9608,6.2
Jackson,8/1/2014,7216,6737,479,6.6,156130,146530,9599,6.1
Jackson,9/1/2014,7294,6850,444,6.1,156040,146778,9262,5.9
Jackson,10/1/2014,7250,6807,443,6.1,156417,147427,8990,5.7
Jackson,11/1/2014,7264,6814,450,6.2,156494,147404,9090,5.8
Jackson,12/1/2014,7242,6831,411,5.7,156332,147615,8717,5.6
Jackson,1/1/2015,7281,6828,453,6.2,157030,148145,8885,5.7
Jackson,2/1/2015,7159,6735,424,5.9,156644,148045,8599,5.5
Jackson,3/1/2015,7213,6770,443,6.1,156643,148128,8515,5.4
Jackson,4/1/2015,7275,6838,437,6,157060,148511,8550,5.4
Jackson,5/1/2015,7305,6850,455,6.2,157651,148817,8834,5.6
Jackson,6/1/2015,7432,6954,478,6.4,157062,148816,8247,5.3
Jackson,7/1/2015,7331,6862,469,6.4,156997,148830,8167,5.2
Jackson,8/1/2015,7139,6712,427,6,157172,149181,7992,5.1
Jackson,9/1/2015,7168,6751,417,5.8,156733,148826,7907,5
Jackson,10/1/2015,7069,6671,398,5.6,157167,149246,7922,5
Jackson,11/1/2015,7115,6740,375,5.3,157463,149463,8000,5.1
Jackson,12/1/2015,7134,6776,358,5,158035,150128,7907,5
Jackson,1/1/2016,7073,6658,415,5.9,158280,150653,7627,4.8
Jackson,2/1/2016,7118,6735,383,5.4,158640,150939,7702,4.9
Jackson,3/1/2016,7154,6760,394,5.5,159179,151218,7961,5
Jackson,4/1/2016,7192,6813,379,5.3,159141,151074,8067,5.1
Jackson,5/1/2016,7238,6847,391,5.4,158784,151132,7652,4.8
Jackson,6/1/2016,7359,6901,458,6.2,158967,151223,7744,4.9
Jackson,7/1/2016,7127,6683,444,6.2,159194,151554,7641,4.8
Jackson,8/1/2016,6984,6575,409,5.9,159562,151779,7784,4.9
Jackson,9/1/2016,6953,6549,404,5.8,159714,151761,7953,5
Jackson,10/1/2016,6896,6519,377,5.5,159605,151793,7811,4.9
Jackson,11/1/2016,6978,6640,338,4.8,159506,151954,7553,4.7
Jackson,12/1/2016,6898,6582,316,4.6,159678,152157,7521,4.7
Jackson,1/1/2017,6984,6626,358,5.1,159620,152152,7468,4.7
Jackson,2/1/2017,6982,6641,341,4.9,159859,152480,7379,4.6
Jackson,3/1/2017,7076,6748,328,4.6,160137,153065,7073,4.4
Jackson,4/1/2017,7015,6704,311,4.4,160345,153255,7089,4.4
Jackson,5/1/2017,7066,6752,314,4.4,160068,153069,7000,4.4
Jackson,6/1/2017,7182,6828,354,4.9,160192,153318,6873,4.3
Jackson,7/1/2017,7017,6664,353,5,160462,153569,6892,4.3
Jackson,8/1/2017,6868,6533,335,4.9,160586,153503,7082,4.4
Jackson,9/1/2017,6907,6598,309,4.5,161140,154286,6854,4.3
Jackson,10/1/2017,6860,6595,265,3.9,160309,153609,6700,4.2
Jackson,11/1/2017,6917,6652,265,3.8,160579,153805,6774,4.2
Jackson,12/1/2017,6833,6583,250,3.7,160535,153904,6632,4.1
Jackson,1/1/2018,6847,6555,292,4.3,160914,154425,6489,4
Jackson,2/1/2018,6879,6589,290,4.2,161778,155197,6581,4.1
Jackson,3/1/2018,6953,6660,293,4.2,161686,155214,6472,4
Jackson,4/1/2018,6947,6670,277,4,161771,155312,6459,4
Jackson,5/1/2018,7014,6701,313,4.5,161848,155652,6196,3.8
Jackson,6/1/2018,7039,6637,402,5.7,162210,155762,6447,4
Jackson,7/1/2018,6979,6605,374,5.4,162341,156146,6195,3.8
Jackson,8/1/2018,6741,6405,336,5,161660,155504,6156,3.8
Jackson,9/1/2018,6701,6387,314,4.7,162087,156015,6073,3.7
Jackson,10/1/2018,6833,6532,301,4.4,162602,156391,6211,3.8
Jackson,11/1/2018,6808,6520,288,4.2,162836,156721,6115,3.8
Jackson,12/1/2018,6731,6439,292,4.3,163206,156817,6389,3.9
Jackson,1/1/2019,6717,6379,338,5,162963,156487,6475,4
Jackson,2/1/2019,6718,6425,293,4.4,162999,156863,6136,3.8
Jackson,3/1/2019,6726,6446,280,4.2,162904,156701,6202,3.8
Jackson,4/1/2019,6745,6488,257,3.8,162586,156625,5961,3.7
Jackson,5/1/2019,6806,6521,285,4.2,162751,156821,5930,3.6
Jackson,6/1/2019,6885,6530,355,5.2,163168,157232,5935,3.6
Jackson,7/1/2019,6874,6514,360,5.2,163590,157529,6061,3.7
Jackson,8/1/2019,6751,6425,326,4.8,163774,157829,5945,3.6
Jackson,9/1/2019,6879,6562,317,4.6,164092,158339,5753,3.5
Jackson,10/1/2019,6882,6564,318,4.6,164416,158545,5871,3.6
Jackson,11/1/2019,6866,6554,312,4.5,164496,158629,5868,3.6
Jackson,12/1/2019,6804,6513,291,4.3,164699,158845,5853,3.6
Jackson,1/1/2020,6735,6414,321,4.8,164377,158508,5869,3.6
Jackson,2/1/2020,6772,6490,282,4.2,164467,158714,5753,3.5
Jackson,3/1/2020,6898,6420,478,6.9,162559,155353,7206,4.4
Jackson,4/1/2020,6294,5913,381,6.1,156269,133185,23084,14.8
Jackson,5/1/2020,6516,6062,454,7,158101,137173,20929,13.2
Jackson,6/1/2020,6698,6229,469,7,159994,142342,17652,11
Jackson,7/1/2020,6613,6159,454,6.9,160132,143779,16352,10.2
Jackson,8/1/2020,6586,6222,364,5.5,160706,147245,13461,8.4
Jackson,9/1/2020,6709,6335,374,5.6,160174,147620,12554,7.8
Jackson,10/1/2020,6805,6465,340,5,161003,149931,11072,6.9
Jackson,11/1/2020,6738,6428,310,4.6,160629,149934,10694,6.7
Jackson,12/1/2020,6762,6433,329,4.9,160745,149975,10770,6.7
Jackson,1/1/2021,6620,6302,318,4.8,160088,149852,10236,6.4
Jackson,2/1/2021,6648,6345,303,4.6,160184,150189,9995,6.2
Jackson,3/1/2021,6611,6328,283,4.3,160400,150644,9756,6.1
Jackson,4/1/2021,6682,6413,269,4,160843,151081,9762,6.1
Jackson,5/1/2021,6707,6434,273,4.1,160800,151535,9266,5.8
Jackson,6/1/2021,6700,6374,326,4.9,161197,151734,9462,5.9
Jackson,7/1/2021,6740,6446,294,4.4,161504,152773,8731,5.4
Jackson,8/1/2021,6662,6403,259,3.9,161527,153250,8276,5.1
Jackson,9/1/2021,6904,6666,238,3.4,161495,153843,7652,4.7
Jackson,10/1/2021,6809,6588,221,3.2,161754,154475,7279,4.5
Jackson,11/1/2021,6813,6613,200,2.9,162281,155530,6751,4.2
Jackson,12/1/2021,6811,6637,174,2.6,162497,156099,6398,3.9
Jackson,1/1/2022,6792,6564,228,3.4,163627,157115,6512,4
Jackson,2/1/2022,6875,6658,217,3.2,163899,157598,6301,3.8
Jackson,3/1/2022,6847,6636,211,3.1,164220,158206,6014,3.7
Jackson,4/1/2022,6901,6716,185,2.7,163893,157891,6002,3.7
Jackson,5/1/2022,6853,6650,203,3,164362,158378,5983,3.6
Jackson,6/1/2022,6999,6725,274,3.9,164046,158094,5951,3.6
Jackson,7/1/2022,6923,6669,254,3.7,164026,158258,5768,3.5
Jackson,8/1/2022,6800,6552,248,3.6,164654,158735,5919,3.6
Jackson,9/1/2022,6893,6674,219,3.2,164602,158810,5792,3.5
Jackson,10/1/2022,6910,6704,206,3,164648,158684,5964,3.6
Jackson,11/1/2022,6937,6745,192,2.8,164450,158507,5943,3.6
Jackson,12/1/2022,6908,6714,194,2.8,165025,159259,5766,3.5
Jackson,1/1/2023,6963,6728,235,3.4,165964,160217,5747,3.5
Jackson,2/1/2023,6989,6765,224,3.2,166358,160395,5962,3.6
Jackson,3/1/2023,7066,6863,203,2.9,166651,160812,5839,3.5
Jackson,4/1/2023,7130,6937,193,2.7,166725,160974,5751,3.4
Jackson,5/1/2023,7020,6802,218,3.1,166886,160796,6089,3.6
Jackson,6/1/2023,7122,6865,257,3.6,166937,160979,5958,3.6
Jackson,7/1/2023,7197,6968,229,3.2,167103,161183,5920,3.5
Jackson,8/1/2023,7076,6849,227,3.2,167759,161475,6284,3.7
Jackson,9/1/2023,7224,6976,248,3.4,167767,161442,6326,3.8
Jackson,10/1/2023,7233,6976,257,3.6,167690,161211,6479,3.9
Jackson,11/1/2023,7309,7039,270,3.7,168140,161886,6254,3.7
Jackson,12/1/2023,7229,6963,266,3.7,167439,161124,6315,3.8
Jackson,1/1/2024,7235,6936,299,4.1,167339,161190,6149,3.7
Jackson,2/1/2024,7210,6923,287,4,167475,161013,6462,3.9
Jackson,3/1/2024,7179,6903,276,3.8,167922,161425,6497,3.9
Jackson,4/1/2024,7217,6975,242,3.4,167988,161495,6492,3.9
Jackson,5/1/2024,7120,6869,251,3.5,167799,161164,6635,4
Jackson,6/1/2024,7294,6977,317,4.3,168005,161155,6849,4.1
Jackson,7/1/2024,7301,6987,314,4.3,168315,161219,7097,4.2
Jackson,8/1/2024,7187,6879,308,4.3,168496,161425,7071,4.2
Jackson,9/1/2024,7308,7012,296,4.1,168703,161802,6901,4.1
Jackson,10/1/2024,7309,7003,306,4.2,168428,161456,6972,4.1
Jackson,11/1/2024,7293,6966,327,4.5,168304,161183,7121,4.2
Jackson,12/1/2024,7221,6942,279,3.9,168547,161661,6886,4.1
Jackson,1/1/2025,5621,5333,288,5.1,170744,163895,6849,4
Jackson,2/1/2025,5631,5357,274,4.9,170359,163307,7052,4.1
Jefferson Davis,1/1/1990,11544,10738,806,7,125833,119081,6752,5.4
Jefferson Davis,2/1/1990,11333,10612,721,6.4,125710,119059,6651,5.3
Jefferson Davis,3/1/1990,11483,10819,664,5.8,125801,119203,6598,5.2
Jefferson Davis,4/1/1990,11810,11170,640,5.4,125649,118852,6797,5.4
Jefferson Davis,5/1/1990,11850,11248,602,5.1,125893,119151,6742,5.4
Jefferson Davis,6/1/1990,12174,11402,772,6.3,125573,118983,6590,5.2
Jefferson Davis,7/1/1990,12654,11462,1192,9.4,125732,118810,6922,5.5
Jefferson Davis,8/1/1990,12554,11283,1271,10.1,125990,118802,7188,5.7
Jefferson Davis,9/1/1990,11941,11091,850,7.1,125892,118524,7368,5.9
Jefferson Davis,10/1/1990,11848,11122,726,6.1,125995,118536,7459,5.9
Jefferson Davis,11/1/1990,11746,11021,725,6.2,126070,118306,7764,6.2
Jefferson Davis,12/1/1990,11639,10898,741,6.4,126142,118241,7901,6.3
Jefferson Davis,1/1/1991,12184,11295,889,7.3,125955,117940,8015,6.4
Jefferson Davis,2/1/1991,12266,11381,885,7.2,126020,117755,8265,6.6
Jefferson Davis,3/1/1991,12357,11505,852,6.9,126238,117652,8586,6.8
Jefferson Davis,4/1/1991,12383,11489,894,7.2,126548,118109,8439,6.7
Jefferson Davis,5/1/1991,12482,11513,969,7.8,126176,117440,8736,6.9
Jefferson Davis,6/1/1991,12724,11597,1127,8.9,126331,117639,8692,6.9
Jefferson Davis,7/1/1991,13556,11948,1608,11.9,126154,117568,8586,6.8
Jefferson Davis,8/1/1991,13056,11932,1124,8.6,126150,117484,8666,6.9
Jefferson Davis,9/1/1991,12839,11742,1097,8.5,126650,117928,8722,6.9
Jefferson Davis,10/1/1991,12635,11436,1199,9.5,126642,117800,8842,7
Jefferson Davis,11/1/1991,12678,11544,1134,8.9,126701,117770,8931,7
Jefferson Davis,12/1/1991,12480,11410,1070,8.6,126664,117466,9198,7.3
Jefferson Davis,1/1/1992,12248,10931,1317,10.8,127261,117978,9283,7.3
Jefferson Davis,2/1/1992,12078,10842,1236,10.2,127207,117753,9454,7.4
Jefferson Davis,3/1/1992,12234,11019,1215,9.9,127604,118144,9460,7.4
Jefferson Davis,4/1/1992,12433,11104,1329,10.7,127841,118426,9415,7.4
Jefferson Davis,5/1/1992,12537,11253,1284,10.2,128119,118375,9744,7.6
Jefferson Davis,6/1/1992,13014,11374,1640,12.6,128459,118419,10040,7.8
Jefferson Davis,7/1/1992,13475,11909,1566,11.6,128563,118713,9850,7.7
Jefferson Davis,8/1/1992,12972,11615,1357,10.5,128613,118826,9787,7.6
Jefferson Davis,9/1/1992,12718,11378,1340,10.5,128501,118720,9781,7.6
Jefferson Davis,10/1/1992,12223,11051,1172,9.6,128026,118628,9398,7.3
Jefferson Davis,11/1/1992,11974,10984,990,8.3,128441,118876,9565,7.4
Jefferson Davis,12/1/1992,11644,10659,985,8.5,128554,118997,9557,7.4
Jefferson Davis,1/1/1993,11632,10463,1169,10,128400,119075,9325,7.3
Jefferson Davis,2/1/1993,11587,10493,1094,9.4,128458,119275,9183,7.1
Jefferson Davis,3/1/1993,11662,10653,1009,8.7,128598,119542,9056,7
Jefferson Davis,4/1/1993,11852,10777,1075,9.1,128584,119474,9110,7.1
Jefferson Davis,5/1/1993,11845,10884,961,8.1,129264,120115,9149,7.1
Jefferson Davis,6/1/1993,12120,10958,1162,9.6,129411,120290,9121,7
Jefferson Davis,7/1/1993,11945,10987,958,8,129397,120467,8930,6.9
Jefferson Davis,8/1/1993,11899,10967,932,7.8,129619,120856,8763,6.8
Jefferson Davis,9/1/1993,11553,10728,825,7.1,129268,120554,8714,6.7
Jefferson Davis,10/1/1993,11501,10667,834,7.3,129573,120823,8750,6.8
Jefferson Davis,11/1/1993,11353,10507,846,7.5,129711,121169,8542,6.6
Jefferson Davis,12/1/1993,11451,10567,884,7.7,129941,121464,8477,6.5
Jefferson Davis,1/1/1994,11724,10694,1030,8.8,130596,121966,8630,6.6
Jefferson Davis,2/1/1994,11606,10647,959,8.3,130669,122086,8583,6.6
Jefferson Davis,3/1/1994,11792,10836,956,8.1,130400,121930,8470,6.5
Jefferson Davis,4/1/1994,11851,10939,912,7.7,130621,122290,8331,6.4
Jefferson Davis,5/1/1994,11683,10818,865,7.4,130779,122864,7915,6.1
Jefferson Davis,6/1/1994,11801,10734,1067,9,130561,122634,7927,6.1
Jefferson Davis,7/1/1994,11825,10851,974,8.2,130652,122706,7946,6.1
Jefferson Davis,8/1/1994,11649,10737,912,7.8,131275,123342,7933,6
Jefferson Davis,9/1/1994,12002,11043,959,8,131421,123687,7734,5.9
Jefferson Davis,10/1/1994,12221,11194,1027,8.4,131744,124112,7632,5.8
Jefferson Davis,11/1/1994,12095,11128,967,8,131891,124516,7375,5.6
Jefferson Davis,12/1/1994,11828,10926,902,7.6,131951,124721,7230,5.5
Jefferson Davis,1/1/1995,11914,10923,991,8.3,132038,124663,7375,5.6
Jefferson Davis,2/1/1995,11770,10900,870,7.4,132115,124928,7187,5.4
Jefferson Davis,3/1/1995,11778,11040,738,6.3,132108,124955,7153,5.4
Jefferson Davis,4/1/1995,11977,11127,850,7.1,132590,124945,7645,5.8
Jefferson Davis,5/1/1995,11912,11076,836,7,131851,124421,7430,5.6
Jefferson Davis,6/1/1995,12004,11188,816,6.8,131949,124522,7427,5.6
Jefferson Davis,7/1/1995,12174,11352,822,6.8,132343,124816,7527,5.7
Jefferson Davis,8/1/1995,11861,11144,717,6,132336,124852,7484,5.7
Jefferson Davis,9/1/1995,11846,11073,773,6.5,132611,125133,7478,5.6
Jefferson Davis,10/1/1995,11915,11155,760,6.4,132716,125388,7328,5.5
Jefferson Davis,11/1/1995,11685,10866,819,7,132614,125188,7426,5.6
Jefferson Davis,12/1/1995,11450,10698,752,6.6,132511,125088,7423,5.6
Jefferson Davis,1/1/1996,11416,10546,870,7.6,132616,125125,7491,5.6
Jefferson Davis,2/1/1996,11340,10596,744,6.6,132952,125639,7313,5.5
Jefferson Davis,3/1/1996,11421,10695,726,6.4,133180,125862,7318,5.5
Jefferson Davis,4/1/1996,11668,10877,791,6.8,133409,125994,7415,5.6
Jefferson Davis,5/1/1996,11661,10776,885,7.6,133667,126244,7423,5.6
Jefferson Davis,6/1/1996,12040,11026,1014,8.4,133697,126602,7095,5.3
Jefferson Davis,7/1/1996,12093,11136,957,7.9,134284,126947,7337,5.5
Jefferson Davis,8/1/1996,11720,10857,863,7.4,134054,127172,6882,5.1
Jefferson Davis,9/1/1996,11639,10842,797,6.8,134515,127536,6979,5.2
Jefferson Davis,10/1/1996,11715,10934,781,6.7,134921,127890,7031,5.2
Jefferson Davis,11/1/1996,11580,10814,766,6.6,135007,127771,7236,5.4
Jefferson Davis,12/1/1996,11520,10777,743,6.4,135113,127860,7253,5.4
Jefferson Davis,1/1/1997,11507,10685,822,7.1,135456,128298,7158,5.3
Jefferson Davis,2/1/1997,11410,10753,657,5.8,135400,128298,7102,5.2
Jefferson Davis,3/1/1997,11676,10985,691,5.9,135891,128891,7000,5.2
Jefferson Davis,4/1/1997,11575,10926,649,5.6,136016,129143,6873,5.1
Jefferson Davis,5/1/1997,11690,11001,689,5.9,136119,129464,6655,4.9
Jefferson Davis,6/1/1997,12026,11195,831,6.9,136211,129412,6799,5
Jefferson Davis,7/1/1997,12174,11467,707,5.8,136477,129822,6655,4.9
Jefferson Davis,8/1/1997,12543,11360,1183,9.4,136618,130010,6608,4.8
Jefferson Davis,9/1/1997,12306,11100,1206,9.8,136675,130019,6656,4.9
Jefferson Davis,10/1/1997,11764,11103,661,5.6,136633,130179,6454,4.7
Jefferson Davis,11/1/1997,11635,11040,595,5.1,136961,130653,6308,4.6
Jefferson Davis,12/1/1997,11548,11022,526,4.6,137155,130679,6476,4.7
Jefferson Davis,1/1/1998,11622,10955,667,5.7,137095,130726,6368,4.6
Jefferson Davis,2/1/1998,11438,10905,533,4.7,137112,130807,6306,4.6
Jefferson Davis,3/1/1998,11576,10977,599,5.2,137236,130814,6422,4.7
Jefferson Davis,4/1/1998,11628,11017,611,5.3,137150,131209,5941,4.3
Jefferson Davis,5/1/1998,11720,11027,693,5.9,137372,131325,6047,4.4
Jefferson Davis,6/1/1998,12044,11217,827,6.9,137455,131244,6212,4.5
Jefferson Davis,7/1/1998,11918,11215,703,5.9,137588,131329,6259,4.5
Jefferson Davis,8/1/1998,11958,11167,791,6.6,137570,131390,6179,4.5
Jefferson Davis,9/1/1998,11792,11025,767,6.5,138286,131986,6300,4.6
Jefferson Davis,10/1/1998,11711,10973,738,6.3,138279,131999,6280,4.5
Jefferson Davis,11/1/1998,11678,10979,699,6,138381,132280,6100,4.4
Jefferson Davis,12/1/1998,11695,11001,694,5.9,138634,132602,6032,4.4
Jefferson Davis,1/1/1999,11171,10401,770,6.9,139003,133027,5976,4.3
Jefferson Davis,2/1/1999,11010,10323,687,6.2,138967,132856,6111,4.4
Jefferson Davis,3/1/1999,11190,10516,674,6,138730,132947,5783,4.2
Jefferson Davis,4/1/1999,11308,10667,641,5.7,138959,132955,6004,4.3
Jefferson Davis,5/1/1999,11346,10687,659,5.8,139107,133311,5796,4.2
Jefferson Davis,6/1/1999,11531,10743,788,6.8,139329,133378,5951,4.3
Jefferson Davis,7/1/1999,11859,10840,1019,8.6,139439,133414,6025,4.3
Jefferson Davis,8/1/1999,11471,10823,648,5.6,139430,133591,5838,4.2
Jefferson Davis,9/1/1999,11662,10713,949,8.1,139622,133707,5915,4.2
Jefferson Davis,10/1/1999,11346,10503,843,7.4,139771,133993,5778,4.1
Jefferson Davis,11/1/1999,11200,10452,748,6.7,140025,134309,5716,4.1
Jefferson Davis,12/1/1999,10989,10329,660,6,140177,134523,5653,4
Jefferson Davis,1/1/2000,12725,12010,715,5.6,142267,136559,5708,4
Jefferson Davis,2/1/2000,12644,12001,643,5.1,142456,136598,5858,4.1
Jefferson Davis,3/1/2000,12769,12052,717,5.6,142434,136701,5733,4
Jefferson Davis,4/1/2000,12706,12070,636,5,142751,137270,5481,3.8
Jefferson Davis,5/1/2000,12749,12027,722,5.7,142388,136630,5758,4
Jefferson Davis,6/1/2000,12892,12037,855,6.6,142591,136940,5651,4
Jefferson Davis,7/1/2000,12891,12117,774,6,142278,136531,5747,4
Jefferson Davis,8/1/2000,12751,11958,793,6.2,142514,136662,5853,4.1
Jefferson Davis,9/1/2000,12625,11876,749,5.9,142518,136893,5625,3.9
Jefferson Davis,10/1/2000,12726,12016,710,5.6,142622,137088,5534,3.9
Jefferson Davis,11/1/2000,12639,11940,699,5.5,142962,137322,5639,3.9
Jefferson Davis,12/1/2000,12681,12006,675,5.3,143248,137614,5634,3.9
Jefferson Davis,1/1/2001,12649,11844,805,6.4,143800,137778,6023,4.2
Jefferson Davis,2/1/2001,12619,11942,677,5.4,143701,137612,6089,4.2
Jefferson Davis,3/1/2001,12719,12031,688,5.4,143924,137783,6141,4.3
Jefferson Davis,4/1/2001,12714,12037,677,5.3,143569,137299,6271,4.4
Jefferson Davis,5/1/2001,12669,11977,692,5.5,143318,137092,6226,4.3
Jefferson Davis,6/1/2001,13008,12141,867,6.7,143357,136873,6484,4.5
Jefferson Davis,7/1/2001,12984,12206,778,6,143654,137071,6583,4.6
Jefferson Davis,8/1/2001,12943,12181,762,5.9,143284,136241,7042,4.9
Jefferson Davis,9/1/2001,12982,12204,778,6,143989,136846,7142,5
Jefferson Davis,10/1/2001,13172,12411,761,5.8,144086,136392,7694,5.3
Jefferson Davis,11/1/2001,12939,12197,742,5.7,144240,136238,8003,5.5
Jefferson Davis,12/1/2001,12761,12028,733,5.7,144305,136047,8258,5.7
Jefferson Davis,1/1/2002,12895,12097,798,6.2,143883,135701,8182,5.7
Jefferson Davis,2/1/2002,12945,12268,677,5.2,144653,136438,8215,5.7
Jefferson Davis,3/1/2002,12958,12240,718,5.5,144481,136177,8304,5.7
Jefferson Davis,4/1/2002,12916,12198,718,5.6,144725,136126,8599,5.9
Jefferson Davis,5/1/2002,12985,12229,756,5.8,144938,136539,8399,5.8
Jefferson Davis,6/1/2002,13235,12367,868,6.6,144808,136415,8393,5.8
Jefferson Davis,7/1/2002,13304,12512,792,6,144803,136413,8390,5.8
Jefferson Davis,8/1/2002,13206,12476,730,5.5,145009,136705,8304,5.7
Jefferson Davis,9/1/2002,13124,12386,738,5.6,145552,137302,8251,5.7
Jefferson Davis,10/1/2002,13328,12653,675,5.1,145314,137008,8307,5.7
Jefferson Davis,11/1/2002,13261,12560,701,5.3,145041,136521,8520,5.9
Jefferson Davis,12/1/2002,13193,12481,712,5.4,145066,136426,8640,6
Jefferson Davis,1/1/2003,13495,12690,805,6,145937,137417,8520,5.8
Jefferson Davis,2/1/2003,13350,12598,752,5.6,146100,137482,8618,5.9
Jefferson Davis,3/1/2003,13456,12648,808,6,146022,137434,8588,5.9
Jefferson Davis,4/1/2003,13557,12794,763,5.6,146474,137633,8842,6
Jefferson Davis,5/1/2003,13503,12723,780,5.8,146500,137544,8957,6.1
Jefferson Davis,6/1/2003,13937,12973,964,6.9,147056,137790,9266,6.3
Jefferson Davis,7/1/2003,13747,12861,886,6.4,146485,137474,9011,6.2
Jefferson Davis,8/1/2003,13680,12882,798,5.8,146445,137549,8896,6.1
Jefferson Davis,9/1/2003,13444,12686,758,5.6,146530,137609,8921,6.1
Jefferson Davis,10/1/2003,13686,13013,673,4.9,146716,137984,8732,6
Jefferson Davis,11/1/2003,13638,12986,652,4.8,147000,138424,8576,5.8
Jefferson Davis,12/1/2003,13422,12795,627,4.7,146729,138411,8317,5.7
Jefferson Davis,1/1/2004,13508,12734,774,5.7,146842,138472,8370,5.7
Jefferson Davis,2/1/2004,13316,12667,649,4.9,146709,138542,8167,5.6
Jefferson Davis,3/1/2004,13428,12732,696,5.2,146944,138453,8491,5.8
Jefferson Davis,4/1/2004,13368,12723,645,4.8,146850,138680,8170,5.6
Jefferson Davis,5/1/2004,13352,12685,667,5,147065,138852,8212,5.6
Jefferson Davis,6/1/2004,13648,12864,784,5.7,147460,139174,8286,5.6
Jefferson Davis,7/1/2004,13648,12949,699,5.1,147692,139556,8136,5.5
Jefferson Davis,8/1/2004,13540,12931,609,4.5,147564,139573,7990,5.4
Jefferson Davis,9/1/2004,13357,12729,628,4.7,147415,139487,7927,5.4
Jefferson Davis,10/1/2004,13793,13179,614,4.5,147793,139732,8061,5.5
Jefferson Davis,11/1/2004,13758,13138,620,4.5,148162,140231,7932,5.4
Jefferson Davis,12/1/2004,13574,12967,607,4.5,148059,140125,7934,5.4
Jefferson Davis,1/1/2005,13796,13108,688,5,148029,140245,7784,5.3
Jefferson Davis,2/1/2005,13636,13004,632,4.6,148364,140385,7980,5.4
Jefferson Davis,3/1/2005,13700,13086,614,4.5,148391,140654,7737,5.2
Jefferson Davis,4/1/2005,13626,13040,586,4.3,148926,141254,7672,5.2
Jefferson Davis,5/1/2005,13830,13193,637,4.6,149261,141609,7651,5.1
Jefferson Davis,6/1/2005,14199,13449,750,5.3,149238,141714,7524,5
Jefferson Davis,7/1/2005,14078,13409,669,4.8,149432,142026,7406,5
Jefferson Davis,8/1/2005,13928,13302,626,4.5,149779,142434,7345,4.9
Jefferson Davis,9/1/2005,15133,14101,1032,6.8,149954,142401,7553,5
Jefferson Davis,10/1/2005,16295,14328,1967,12.1,150001,142548,7453,5
Jefferson Davis,11/1/2005,16183,14238,1945,12,150065,142499,7566,5
Jefferson Davis,12/1/2005,14643,14035,608,4.2,150030,142752,7279,4.9
Jefferson Davis,1/1/2006,14372,13873,499,3.5,150214,143150,7064,4.7
Jefferson Davis,2/1/2006,14380,13986,394,2.7,150641,143457,7184,4.8
Jefferson Davis,3/1/2006,14568,14170,398,2.7,150813,143741,7072,4.7
Jefferson Davis,4/1/2006,14673,14291,382,2.6,150881,143761,7120,4.7
Jefferson Davis,5/1/2006,14636,14196,440,3,151069,144089,6980,4.6
Jefferson Davis,6/1/2006,14833,14263,570,3.8,151354,144353,7001,4.6
Jefferson Davis,7/1/2006,14778,14288,490,3.3,151377,144202,7175,4.7
Jefferson Davis,8/1/2006,14578,14094,484,3.3,151716,144625,7091,4.7
Jefferson Davis,9/1/2006,14526,14057,469,3.2,151662,144815,6847,4.5
Jefferson Davis,10/1/2006,14718,14272,446,3,152041,145314,6727,4.4
Jefferson Davis,11/1/2006,14659,14197,462,3.2,152406,145534,6872,4.5
Jefferson Davis,12/1/2006,14478,14067,411,2.8,152732,145970,6762,4.4
Jefferson Davis,1/1/2007,14447,13953,494,3.4,153144,146028,7116,4.6
Jefferson Davis,2/1/2007,14407,13985,422,2.9,152983,146057,6927,4.5
Jefferson Davis,3/1/2007,14520,14070,450,3.1,153051,146320,6731,4.4
Jefferson Davis,4/1/2007,14434,14007,427,3,152435,145586,6850,4.5
Jefferson Davis,5/1/2007,14460,13964,496,3.4,152670,145903,6766,4.4
Jefferson Davis,6/1/2007,14718,14095,623,4.2,153041,146063,6979,4.6
Jefferson Davis,7/1/2007,14908,14345,563,3.8,153054,145905,7149,4.7
Jefferson Davis,8/1/2007,14911,14392,519,3.5,152749,145682,7067,4.6
Jefferson Davis,9/1/2007,14742,14234,508,3.4,153414,146244,7170,4.7
Jefferson Davis,10/1/2007,14733,14316,417,2.8,153183,145946,7237,4.7
Jefferson Davis,11/1/2007,14862,14408,454,3.1,153835,146595,7240,4.7
Jefferson Davis,12/1/2007,14723,14243,480,3.3,153918,146273,7645,5
Jefferson Davis,1/1/2008,14779,14197,582,3.9,154063,146378,7685,5
Jefferson Davis,2/1/2008,14765,14279,486,3.3,153653,146156,7497,4.9
Jefferson Davis,3/1/2008,14937,14416,521,3.5,153908,146086,7822,5.1
Jefferson Davis,4/1/2008,14867,14422,445,3,153769,146132,7637,5
Jefferson Davis,5/1/2008,14929,14388,541,3.6,154303,145908,8395,5.4
Jefferson Davis,6/1/2008,15132,14445,687,4.5,154313,145737,8575,5.6
Jefferson Davis,7/1/2008,15353,14733,620,4,154469,145532,8937,5.8
Jefferson Davis,8/1/2008,15172,14560,612,4,154641,145203,9438,6.1
Jefferson Davis,9/1/2008,14984,14434,550,3.7,154570,145076,9494,6.1
Jefferson Davis,10/1/2008,15088,14479,609,4,154876,144802,10074,6.5
Jefferson Davis,11/1/2008,15065,14480,585,3.9,154639,144100,10538,6.8
Jefferson Davis,12/1/2008,14648,14055,593,4,154655,143369,11286,7.3
Jefferson Davis,1/1/2009,14585,13906,679,4.7,154210,142152,12058,7.8
Jefferson Davis,2/1/2009,14655,13949,706,4.8,154538,141640,12898,8.3
Jefferson Davis,3/1/2009,14732,13980,752,5.1,154133,140707,13426,8.7
Jefferson Davis,4/1/2009,14848,14067,781,5.3,154509,140656,13853,9
Jefferson Davis,5/1/2009,14960,14117,843,5.6,154747,140248,14499,9.4
Jefferson Davis,6/1/2009,15204,14140,1064,7,154716,140009,14707,9.5
Jefferson Davis,7/1/2009,15174,14167,1007,6.6,154502,139901,14601,9.5
Jefferson Davis,8/1/2009,14834,13928,906,6.1,154307,139492,14814,9.6
Jefferson Davis,9/1/2009,14684,13808,876,6,153827,138818,15009,9.8
Jefferson Davis,10/1/2009,14683,13826,857,5.8,153784,138432,15352,10
Jefferson Davis,11/1/2009,14737,13932,805,5.5,153878,138659,15219,9.9
Jefferson Davis,12/1/2009,14498,13674,824,5.7,153111,138013,15098,9.9
Jefferson Davis,1/1/2010,12799,11851,948,7.4,153484,138438,15046,9.8
Jefferson Davis,2/1/2010,12824,11988,836,6.5,153694,138581,15113,9.8
Jefferson Davis,3/1/2010,12905,12069,836,6.5,153954,138751,15202,9.9
Jefferson Davis,4/1/2010,13365,12523,842,6.3,154622,139297,15325,9.9
Jefferson Davis,5/1/2010,13437,12522,915,6.8,154091,139241,14849,9.6
Jefferson Davis,6/1/2010,13596,12540,1056,7.8,153616,139141,14474,9.4
Jefferson Davis,7/1/2010,13503,12510,993,7.4,153691,139179,14512,9.4
Jefferson Davis,8/1/2010,13347,12341,1006,7.5,154086,139438,14648,9.5
Jefferson Davis,9/1/2010,13064,12123,941,7.2,153975,139396,14579,9.5
Jefferson Davis,10/1/2010,13075,12141,934,7.1,153635,139119,14516,9.4
Jefferson Davis,11/1/2010,12966,12033,933,7.2,154125,139044,15081,9.8
Jefferson Davis,12/1/2010,12798,11947,851,6.6,153650,139301,14348,9.3
Jefferson Davis,1/1/2011,12709,11734,975,7.7,153263,139250,14013,9.1
Jefferson Davis,2/1/2011,12646,11778,868,6.9,153214,139394,13820,9
Jefferson Davis,3/1/2011,12709,11845,864,6.8,153376,139639,13737,9
Jefferson Davis,4/1/2011,12983,12164,819,6.3,153543,139586,13957,9.1
Jefferson Davis,5/1/2011,13085,12217,868,6.6,153479,139624,13855,9
Jefferson Davis,6/1/2011,13257,12271,986,7.4,153346,139384,13962,9.1
Jefferson Davis,7/1/2011,13231,12287,944,7.1,153288,139524,13763,9
Jefferson Davis,8/1/2011,13107,12207,900,6.9,153760,139942,13818,9
Jefferson Davis,9/1/2011,12974,12102,872,6.7,154131,140183,13948,9
Jefferson Davis,10/1/2011,13073,12214,859,6.6,153961,140368,13594,8.8
Jefferson Davis,11/1/2011,13015,12205,810,6.2,154128,140826,13302,8.6
Jefferson Davis,12/1/2011,12960,12177,783,6,153995,140902,13093,8.5
Jefferson Davis,1/1/2012,12865,11999,866,6.7,154381,141584,12797,8.3
Jefferson Davis,2/1/2012,12871,12065,806,6.3,154671,141858,12813,8.3
Jefferson Davis,3/1/2012,12723,11935,788,6.2,154749,142036,12713,8.2
Jefferson Davis,4/1/2012,12972,12216,756,5.8,154545,141899,12646,8.2
Jefferson Davis,5/1/2012,13149,12311,838,6.4,154866,142206,12660,8.2
Jefferson Davis,6/1/2012,13320,12350,970,7.3,155083,142391,12692,8.2
Jefferson Davis,7/1/2012,13438,12528,910,6.8,154948,142292,12656,8.2
Jefferson Davis,8/1/2012,13247,12409,838,6.3,154763,142291,12471,8.1
Jefferson Davis,9/1/2012,13031,12273,758,5.8,155160,143044,12115,7.8
Jefferson Davis,10/1/2012,13203,12467,736,5.6,155554,143431,12124,7.8
Jefferson Davis,11/1/2012,12995,12339,656,5,155338,143333,12005,7.7
Jefferson Davis,12/1/2012,12824,12098,726,5.7,155628,143330,12298,7.9
Jefferson Davis,1/1/2013,12950,12061,889,6.9,155763,143292,12471,8
Jefferson Davis,2/1/2013,12866,12128,738,5.7,155312,143362,11950,7.7
Jefferson Davis,3/1/2013,12779,12048,731,5.7,155005,143316,11689,7.5
Jefferson Davis,4/1/2013,13090,12348,742,5.7,155394,143635,11760,7.6
Jefferson Davis,5/1/2013,13272,12445,827,6.2,155536,143882,11654,7.5
Jefferson Davis,6/1/2013,13370,12426,944,7.1,155749,143999,11751,7.5
Jefferson Davis,7/1/2013,13623,12761,862,6.3,155599,144264,11335,7.3
Jefferson Davis,8/1/2013,13537,12720,817,6,155605,144326,11279,7.2
Jefferson Davis,9/1/2013,13450,12691,759,5.6,155687,144418,11270,7.2
Jefferson Davis,10/1/2013,13184,12438,746,5.7,154673,143537,11136,7.2
Jefferson Davis,11/1/2013,13065,12365,700,5.4,155265,144479,10787,6.9
Jefferson Davis,12/1/2013,12843,12231,612,4.8,155182,144778,10404,6.7
Jefferson Davis,1/1/2014,12963,12264,699,5.4,155352,145150,10202,6.6
Jefferson Davis,2/1/2014,13074,12421,653,5,155483,145134,10349,6.7
Jefferson Davis,3/1/2014,13025,12335,690,5.3,156028,145648,10380,6.7
Jefferson Davis,4/1/2014,13327,12687,640,4.8,155369,145667,9702,6.2
Jefferson Davis,5/1/2014,13429,12693,736,5.5,155684,145825,9859,6.3
Jefferson Davis,6/1/2014,13645,12825,820,6,155707,146247,9460,6.1
Jefferson Davis,7/1/2014,13802,12919,883,6.4,156007,146399,9608,6.2
Jefferson Davis,8/1/2014,13837,12942,895,6.5,156130,146530,9599,6.1
Jefferson Davis,9/1/2014,13792,12952,840,6.1,156040,146778,9262,5.9
Jefferson Davis,10/1/2014,13776,12940,836,6.1,156417,147427,8990,5.7
Jefferson Davis,11/1/2014,13783,12935,848,6.2,156494,147404,9090,5.8
Jefferson Davis,12/1/2014,13547,12772,775,5.7,156332,147615,8717,5.6
Jefferson Davis,1/1/2015,13413,12534,879,6.6,157030,148145,8885,5.7
Jefferson Davis,2/1/2015,13411,12591,820,6.1,156644,148045,8599,5.5
Jefferson Davis,3/1/2015,13362,12527,835,6.2,156643,148128,8515,5.4
Jefferson Davis,4/1/2015,13565,12766,799,5.9,157060,148511,8550,5.4
Jefferson Davis,5/1/2015,13520,12657,863,6.4,157651,148817,8834,5.6
Jefferson Davis,6/1/2015,13703,12785,918,6.7,157062,148816,8247,5.3
Jefferson Davis,7/1/2015,13706,12809,897,6.5,156997,148830,8167,5.2
Jefferson Davis,8/1/2015,13690,12861,829,6.1,157172,149181,7992,5.1
Jefferson Davis,9/1/2015,13494,12662,832,6.2,156733,148826,7907,5
Jefferson Davis,10/1/2015,13614,12805,809,5.9,157167,149246,7922,5
Jefferson Davis,11/1/2015,13559,12794,765,5.6,157463,149463,8000,5.1
Jefferson Davis,12/1/2015,13317,12603,714,5.4,158035,150128,7907,5
Jefferson Davis,1/1/2016,13456,12610,846,6.3,158280,150653,7627,4.8
Jefferson Davis,2/1/2016,13439,12661,778,5.8,158640,150939,7702,4.9
Jefferson Davis,3/1/2016,13374,12581,793,5.9,159179,151218,7961,5
Jefferson Davis,4/1/2016,13575,12791,784,5.8,159141,151074,8067,5.1
Jefferson Davis,5/1/2016,13677,12879,798,5.8,158784,151132,7652,4.8
Jefferson Davis,6/1/2016,13779,12854,925,6.7,158967,151223,7744,4.9
Jefferson Davis,7/1/2016,13914,13027,887,6.4,159194,151554,7641,4.8
Jefferson Davis,8/1/2016,13756,12889,867,6.3,159562,151779,7784,4.9
Jefferson Davis,9/1/2016,13514,12640,874,6.5,159714,151761,7953,5
Jefferson Davis,10/1/2016,13581,12803,778,5.7,159605,151793,7811,4.9
Jefferson Davis,11/1/2016,13500,12783,717,5.3,159506,151954,7553,4.7
Jefferson Davis,12/1/2016,13291,12583,708,5.3,159678,152157,7521,4.7
Jefferson Davis,1/1/2017,13453,12663,790,5.9,159620,152152,7468,4.7
Jefferson Davis,2/1/2017,13448,12738,710,5.3,159859,152480,7379,4.6
Jefferson Davis,3/1/2017,13446,12776,670,5,160137,153065,7073,4.4
Jefferson Davis,4/1/2017,13645,13000,645,4.7,160345,153255,7089,4.4
Jefferson Davis,5/1/2017,13654,13006,648,4.7,160068,153069,7000,4.4
Jefferson Davis,6/1/2017,13877,13160,717,5.2,160192,153318,6873,4.3
Jefferson Davis,7/1/2017,13928,13206,722,5.2,160462,153569,6892,4.3
Jefferson Davis,8/1/2017,13775,13074,701,5.1,160586,153503,7082,4.4
Jefferson Davis,9/1/2017,13565,12915,650,4.8,161140,154286,6854,4.3
Jefferson Davis,10/1/2017,13588,13020,568,4.2,160309,153609,6700,4.2
Jefferson Davis,11/1/2017,13524,12938,586,4.3,160579,153805,6774,4.2
Jefferson Davis,12/1/2017,13363,12827,536,4,160535,153904,6632,4.1
Jefferson Davis,1/1/2018,13474,12850,624,4.6,160914,154425,6489,4
Jefferson Davis,2/1/2018,13563,12977,586,4.3,161778,155197,6581,4.1
Jefferson Davis,3/1/2018,13583,12970,613,4.5,161686,155214,6472,4
Jefferson Davis,4/1/2018,13625,13012,613,4.5,161771,155312,6459,4
Jefferson Davis,5/1/2018,13600,12969,631,4.6,161848,155652,6196,3.8
Jefferson Davis,6/1/2018,13782,12965,817,5.9,162210,155762,6447,4
Jefferson Davis,7/1/2018,13732,12990,742,5.4,162341,156146,6195,3.8
Jefferson Davis,8/1/2018,13481,12820,661,4.9,161660,155504,6156,3.8
Jefferson Davis,9/1/2018,13271,12670,601,4.5,162087,156015,6073,3.7
Jefferson Davis,10/1/2018,13439,12858,581,4.3,162602,156391,6211,3.8
Jefferson Davis,11/1/2018,13342,12782,560,4.2,162836,156721,6115,3.8
Jefferson Davis,12/1/2018,13066,12508,558,4.3,163206,156817,6389,3.9
Jefferson Davis,1/1/2019,13073,12410,663,5.1,162963,156487,6475,4
Jefferson Davis,2/1/2019,13061,12502,559,4.3,162999,156863,6136,3.8
Jefferson Davis,3/1/2019,13070,12553,517,4,162904,156701,6202,3.8
Jefferson Davis,4/1/2019,13174,12689,485,3.7,162586,156625,5961,3.7
Jefferson Davis,5/1/2019,13362,12821,541,4,162751,156821,5930,3.6
Jefferson Davis,6/1/2019,13460,12757,703,5.2,163168,157232,5935,3.6
Jefferson Davis,7/1/2019,13556,12850,706,5.2,163590,157529,6061,3.7
Jefferson Davis,8/1/2019,13526,12866,660,4.9,163774,157829,5945,3.6
Jefferson Davis,9/1/2019,13388,12780,608,4.5,164092,158339,5753,3.5
Jefferson Davis,10/1/2019,13400,12789,611,4.6,164416,158545,5871,3.6
Jefferson Davis,11/1/2019,13194,12598,596,4.5,164496,158629,5868,3.6
Jefferson Davis,12/1/2019,13008,12457,551,4.2,164699,158845,5853,3.6
Jefferson Davis,1/1/2020,12858,12228,630,4.9,164377,158508,5869,3.6
Jefferson Davis,2/1/2020,12838,12337,501,3.9,164467,158714,5753,3.5
Jefferson Davis,3/1/2020,13095,12226,869,6.6,162559,155353,7206,4.4
Jefferson Davis,4/1/2020,12181,10840,1341,11,156269,133185,23084,14.8
Jefferson Davis,5/1/2020,12546,11126,1420,11.3,158101,137173,20929,13.2
Jefferson Davis,6/1/2020,12746,11436,1310,10.3,159994,142342,17652,11
Jefferson Davis,7/1/2020,12814,11551,1263,9.9,160132,143779,16352,10.2
Jefferson Davis,8/1/2020,12715,11729,986,7.8,160706,147245,13461,8.4
Jefferson Davis,9/1/2020,12506,11311,1195,9.6,160174,147620,12554,7.8
Jefferson Davis,10/1/2020,12510,11555,955,7.6,161003,149931,11072,6.9
Jefferson Davis,11/1/2020,12428,11594,834,6.7,160629,149934,10694,6.7
Jefferson Davis,12/1/2020,12513,11701,812,6.5,160745,149975,10770,6.7
Jefferson Davis,1/1/2021,12357,11580,777,6.3,160088,149852,10236,6.4
Jefferson Davis,2/1/2021,12369,11619,750,6.1,160184,150189,9995,6.2
Jefferson Davis,3/1/2021,12381,11664,717,5.8,160400,150644,9756,6.1
Jefferson Davis,4/1/2021,12320,11638,682,5.5,160843,151081,9762,6.1
Jefferson Davis,5/1/2021,12329,11643,686,5.6,160800,151535,9266,5.8
Jefferson Davis,6/1/2021,12558,11782,776,6.2,161197,151734,9462,5.9
Jefferson Davis,7/1/2021,12553,11894,659,5.2,161504,152773,8731,5.4
Jefferson Davis,8/1/2021,12457,11872,585,4.7,161527,153250,8276,5.1
Jefferson Davis,9/1/2021,12635,12114,521,4.1,161495,153843,7652,4.7
Jefferson Davis,10/1/2021,12287,11821,466,3.8,161754,154475,7279,4.5
Jefferson Davis,11/1/2021,12215,11798,417,3.4,162281,155530,6751,4.2
Jefferson Davis,12/1/2021,12179,11808,371,3,162497,156099,6398,3.9
Jefferson Davis,1/1/2022,12256,11793,463,3.8,163627,157115,6512,4
Jefferson Davis,2/1/2022,12307,11889,418,3.4,163899,157598,6301,3.8
Jefferson Davis,3/1/2022,12334,11929,405,3.3,164220,158206,6014,3.7
Jefferson Davis,4/1/2022,12278,11897,381,3.1,163893,157891,6002,3.7
Jefferson Davis,5/1/2022,12160,11737,423,3.5,164362,158378,5983,3.6
Jefferson Davis,6/1/2022,12414,11878,536,4.3,164046,158094,5951,3.6
Jefferson Davis,7/1/2022,12381,11898,483,3.9,164026,158258,5768,3.5
Jefferson Davis,8/1/2022,12199,11754,445,3.6,164654,158735,5919,3.6
Jefferson Davis,9/1/2022,12248,11828,420,3.4,164602,158810,5792,3.5
Jefferson Davis,10/1/2022,12242,11847,395,3.2,164648,158684,5964,3.6
Jefferson Davis,11/1/2022,12129,11742,387,3.2,164450,158507,5943,3.6
Jefferson Davis,12/1/2022,12115,11723,392,3.2,165025,159259,5766,3.5
Jefferson Davis,1/1/2023,12120,11654,466,3.8,165964,160217,5747,3.5
Jefferson Davis,2/1/2023,12088,11658,430,3.6,166358,160395,5962,3.6
Jefferson Davis,3/1/2023,12214,11811,403,3.3,166651,160812,5839,3.5
Jefferson Davis,4/1/2023,12186,11806,380,3.1,166725,160974,5751,3.4
Jefferson Davis,5/1/2023,12146,11697,449,3.7,166886,160796,6089,3.6
Jefferson Davis,6/1/2023,12356,11811,545,4.4,166937,160979,5958,3.6
Jefferson Davis,7/1/2023,12262,11807,455,3.7,167103,161183,5920,3.5
Jefferson Davis,8/1/2023,12161,11688,473,3.9,167759,161475,6284,3.7
Jefferson Davis,9/1/2023,12172,11679,493,4.1,167767,161442,6326,3.8
Jefferson Davis,10/1/2023,12170,11676,494,4.1,167690,161211,6479,3.9
Jefferson Davis,11/1/2023,12173,11692,481,4,168140,161886,6254,3.7
Jefferson Davis,12/1/2023,12111,11610,501,4.1,167439,161124,6315,3.8
Jefferson Davis,1/1/2024,12131,11577,554,4.6,167339,161190,6149,3.7
Jefferson Davis,2/1/2024,12063,11496,567,4.7,167475,161013,6462,3.9
Jefferson Davis,3/1/2024,12254,11702,552,4.5,167922,161425,6497,3.9
Jefferson Davis,4/1/2024,12269,11765,504,4.1,167988,161495,6492,3.9
Jefferson Davis,5/1/2024,12106,11610,496,4.1,167799,161164,6635,4
Jefferson Davis,6/1/2024,12674,12014,660,5.2,168005,161155,6849,4.1
Jefferson Davis,7/1/2024,12710,12076,634,5,168315,161219,7097,4.2
Jefferson Davis,8/1/2024,12598,11948,650,5.2,168496,161425,7071,4.2
Jefferson Davis,9/1/2024,12522,11891,631,5,168703,161802,6901,4.1
Jefferson Davis,10/1/2024,12501,11864,637,5.1,168428,161456,6972,4.1
Jefferson Davis,11/1/2024,12334,11713,621,5,168304,161183,7121,4.2
Jefferson Davis,12/1/2024,12298,11728,570,4.6,168547,161661,6886,4.1
Jefferson Davis,1/1/2025,12130,11537,593,4.9,170744,163895,6849,4
Jefferson Davis,2/1/2025,12092,11529,563,4.7,170359,163307,7052,4.1
Jefferson,1/1/1990,221384,208384,13000,5.9,125833,119081,6752,5.4
Jefferson,2/1/1990,222187,210130,12057,5.4,125710,119059,6651,5.3
Jefferson,3/1/1990,223198,211881,11317,5.1,125801,119203,6598,5.2
Jefferson,4/1/1990,224853,213366,11487,5.1,125649,118852,6797,5.4
Jefferson,5/1/1990,226984,215017,11967,5.3,125893,119151,6742,5.4
Jefferson,6/1/1990,231843,217362,14481,6.2,125573,118983,6590,5.2
Jefferson,7/1/1990,229721,215909,13812,6,125732,118810,6922,5.5
Jefferson,8/1/1990,225228,212337,12891,5.7,125990,118802,7188,5.7
Jefferson,9/1/1990,223891,210694,13197,5.9,125892,118524,7368,5.9
Jefferson,10/1/1990,226989,214134,12855,5.7,125995,118536,7459,5.9
Jefferson,11/1/1990,227223,213502,13721,6,126070,118306,7764,6.2
Jefferson,12/1/1990,225882,212609,13273,5.9,126142,118241,7901,6.3
Jefferson,1/1/1991,227001,212806,14195,6.3,125955,117940,8015,6.4
Jefferson,2/1/1991,228353,214121,14232,6.2,126020,117755,8265,6.6
Jefferson,3/1/1991,228942,215061,13881,6.1,126238,117652,8586,6.8
Jefferson,4/1/1991,231624,218258,13366,5.8,126548,118109,8439,6.7
Jefferson,5/1/1991,232898,217674,15224,6.5,126176,117440,8736,6.9
Jefferson,6/1/1991,239434,221090,18344,7.7,126331,117639,8692,6.9
Jefferson,7/1/1991,237325,219816,17509,7.4,126154,117568,8586,6.8
Jefferson,8/1/1991,231295,215553,15742,6.8,126150,117484,8666,6.9
Jefferson,9/1/1991,231117,215684,15433,6.7,126650,117928,8722,6.9
Jefferson,10/1/1991,234517,218816,15701,6.7,126642,117800,8842,7
Jefferson,11/1/1991,235030,218710,16320,6.9,126701,117770,8931,7
Jefferson,12/1/1991,233263,217201,16062,6.9,126664,117466,9198,7.3
Jefferson,1/1/1992,234400,217213,17187,7.3,127261,117978,9283,7.3
Jefferson,2/1/1992,235349,218161,17188,7.3,127207,117753,9454,7.4
Jefferson,3/1/1992,236318,219623,16695,7.1,127604,118144,9460,7.4
Jefferson,4/1/1992,238499,221923,16576,7,127841,118426,9415,7.4
Jefferson,5/1/1992,240533,222216,18317,7.6,128119,118375,9744,7.6
Jefferson,6/1/1992,247923,224998,22925,9.2,128459,118419,10040,7.8
Jefferson,7/1/1992,230194,207973,22221,9.7,128563,118713,9850,7.7
Jefferson,8/1/1992,223833,203629,20204,9,128613,118826,9787,7.6
Jefferson,9/1/1992,222345,202331,20014,9,128501,118720,9781,7.6
Jefferson,10/1/1992,223543,204880,18663,8.3,128026,118628,9398,7.3
Jefferson,11/1/1992,224645,205292,19353,8.6,128441,118876,9565,7.4
Jefferson,12/1/1992,229866,211282,18584,8.1,128554,118997,9557,7.4
Jefferson,1/1/1993,228289,208899,19390,8.5,128400,119075,9325,7.3
Jefferson,2/1/1993,228804,211067,17737,7.8,128458,119275,9183,7.1
Jefferson,3/1/1993,229878,212205,17673,7.7,128598,119542,9056,7
Jefferson,4/1/1993,230487,213904,16583,7.2,128584,119474,9110,7.1
Jefferson,5/1/1993,233647,215862,17785,7.6,129264,120115,9149,7.1
Jefferson,6/1/1993,238885,217926,20959,8.8,129411,120290,9121,7
Jefferson,7/1/1993,235808,215357,20451,8.7,129397,120467,8930,6.9
Jefferson,8/1/1993,229927,211855,18072,7.9,129619,120856,8763,6.8
Jefferson,9/1/1993,228689,211047,17642,7.7,129268,120554,8714,6.7
Jefferson,10/1/1993,233608,214826,18782,8,129573,120823,8750,6.8
Jefferson,11/1/1993,235624,216049,19575,8.3,129711,121169,8542,6.6
Jefferson,12/1/1993,233143,215411,17732,7.6,129941,121464,8477,6.5
Jefferson,1/1/1994,233820,213796,20024,8.6,130596,121966,8630,6.6
Jefferson,2/1/1994,234134,216091,18043,7.7,130669,122086,8583,6.6
Jefferson,3/1/1994,234820,217001,17819,7.6,130400,121930,8470,6.5
Jefferson,4/1/1994,235340,218510,16830,7.2,130621,122290,8331,6.4
Jefferson,5/1/1994,237647,220164,17483,7.4,130779,122864,7915,6.1
Jefferson,6/1/1994,241599,221414,20185,8.4,130561,122634,7927,6.1
Jefferson,7/1/1994,239646,219672,19974,8.3,130652,122706,7946,6.1
Jefferson,8/1/1994,235007,216731,18276,7.8,131275,123342,7933,6
Jefferson,9/1/1994,234050,217165,16885,7.2,131421,123687,7734,5.9
Jefferson,10/1/1994,237334,219979,17355,7.3,131744,124112,7632,5.8
Jefferson,11/1/1994,238474,221455,17019,7.1,131891,124516,7375,5.6
Jefferson,12/1/1994,235077,219897,15180,6.5,131951,124721,7230,5.5
Jefferson,1/1/1995,233981,217500,16481,7,132038,124663,7375,5.6
Jefferson,2/1/1995,234394,219309,15085,6.4,132115,124928,7187,5.4
Jefferson,3/1/1995,236129,221156,14973,6.3,132108,124955,7153,5.4
Jefferson,4/1/1995,237343,222283,15060,6.3,132590,124945,7645,5.8
Jefferson,5/1/1995,238127,222800,15327,6.4,131851,124421,7430,5.6
Jefferson,6/1/1995,242335,224189,18146,7.5,131949,124522,7427,5.6
Jefferson,7/1/1995,240814,222826,17988,7.5,132343,124816,7527,5.7
Jefferson,8/1/1995,234330,218726,15604,6.7,132336,124852,7484,5.7
Jefferson,9/1/1995,234385,219365,15020,6.4,132611,125133,7478,5.6
Jefferson,10/1/1995,236179,221280,14899,6.3,132716,125388,7328,5.5
Jefferson,11/1/1995,236678,222107,14571,6.2,132614,125188,7426,5.6
Jefferson,12/1/1995,233743,220365,13378,5.7,132511,125088,7423,5.6
Jefferson,1/1/1996,233257,218319,14938,6.4,132616,125125,7491,5.6
Jefferson,2/1/1996,234533,220947,13586,5.8,132952,125639,7313,5.5
Jefferson,3/1/1996,236998,223395,13603,5.7,133180,125862,7318,5.5
Jefferson,4/1/1996,237853,224717,13136,5.5,133409,125994,7415,5.6
Jefferson,5/1/1996,240769,226225,14544,6,133667,126244,7423,5.6
Jefferson,6/1/1996,244250,228056,16194,6.6,133697,126602,7095,5.3
Jefferson,7/1/1996,242658,226574,16084,6.6,134284,126947,7337,5.5
Jefferson,8/1/1996,236107,222893,13214,5.6,134054,127172,6882,5.1
Jefferson,9/1/1996,237581,224553,13028,5.5,134515,127536,6979,5.2
Jefferson,10/1/1996,239538,226368,13170,5.5,134921,127890,7031,5.2
Jefferson,11/1/1996,240255,227486,12769,5.3,135007,127771,7236,5.4
Jefferson,12/1/1996,238445,226644,11801,4.9,135113,127860,7253,5.4
Jefferson,1/1/1997,236548,223662,12886,5.4,135456,128298,7158,5.3
Jefferson,2/1/1997,236955,224843,12112,5.1,135400,128298,7102,5.2
Jefferson,3/1/1997,239644,228009,11635,4.9,135891,128891,7000,5.2
Jefferson,4/1/1997,240141,229462,10679,4.4,136016,129143,6873,5.1
Jefferson,5/1/1997,242885,230648,12237,5,136119,129464,6655,4.9
Jefferson,6/1/1997,246324,231165,15159,6.2,136211,129412,6799,5
Jefferson,7/1/1997,244338,230367,13971,5.7,136477,129822,6655,4.9
Jefferson,8/1/1997,238114,226321,11793,5,136618,130010,6608,4.8
Jefferson,9/1/1997,238159,226797,11362,4.8,136675,130019,6656,4.9
Jefferson,10/1/1997,239875,228898,10977,4.6,136633,130179,6454,4.7
Jefferson,11/1/1997,241631,231179,10452,4.3,136961,130653,6308,4.6
Jefferson,12/1/1997,240382,230602,9780,4.1,137155,130679,6476,4.7
Jefferson,1/1/1998,237756,227022,10734,4.5,137095,130726,6368,4.6
Jefferson,2/1/1998,238394,228876,9518,4,137112,130807,6306,4.6
Jefferson,3/1/1998,241153,231159,9994,4.1,137236,130814,6422,4.7
Jefferson,4/1/1998,242538,233254,9284,3.8,137150,131209,5941,4.3
Jefferson,5/1/1998,245438,234585,10853,4.4,137372,131325,6047,4.4
Jefferson,6/1/1998,247988,234404,13584,5.5,137455,131244,6212,4.5
Jefferson,7/1/1998,245554,232359,13195,5.4,137588,131329,6259,4.5
Jefferson,8/1/1998,239290,227744,11546,4.8,137570,131390,6179,4.5
Jefferson,9/1/1998,240442,229136,11306,4.7,138286,131986,6300,4.6
Jefferson,10/1/1998,240721,229935,10786,4.5,138279,131999,6280,4.5
Jefferson,11/1/1998,241726,231413,10313,4.3,138381,132280,6100,4.4
Jefferson,12/1/1998,240643,230901,9742,4,138634,132602,6032,4.4
Jefferson,1/1/1999,239023,228366,10657,4.5,139003,133027,5976,4.3
Jefferson,2/1/1999,239835,229649,10186,4.2,138967,132856,6111,4.4
Jefferson,3/1/1999,240740,231752,8988,3.7,138730,132947,5783,4.2
Jefferson,4/1/1999,240677,232134,8543,3.5,138959,132955,6004,4.3
Jefferson,5/1/1999,242112,233091,9021,3.7,139107,133311,5796,4.2
Jefferson,6/1/1999,245564,233513,12051,4.9,139329,133378,5951,4.3
Jefferson,7/1/1999,243427,231415,12012,4.9,139439,133414,6025,4.3
Jefferson,8/1/1999,237195,226805,10390,4.4,139430,133591,5838,4.2
Jefferson,9/1/1999,237701,227445,10256,4.3,139622,133707,5915,4.2
Jefferson,10/1/1999,239459,229175,10284,4.3,139771,133993,5778,4.1
Jefferson,11/1/1999,240885,231399,9486,3.9,140025,134309,5716,4.1
Jefferson,12/1/1999,238659,230069,8590,3.6,140177,134523,5653,4
Jefferson,1/1/2000,229556,219156,10400,4.5,142267,136559,5708,4
Jefferson,2/1/2000,230530,220792,9738,4.2,142456,136598,5858,4.1
Jefferson,3/1/2000,232145,222742,9403,4.1,142434,136701,5733,4
Jefferson,4/1/2000,232356,224043,8313,3.6,142751,137270,5481,3.8
Jefferson,5/1/2000,233797,223702,10095,4.3,142388,136630,5758,4
Jefferson,6/1/2000,235773,223723,12050,5.1,142591,136940,5651,4
Jefferson,7/1/2000,233274,221550,11724,5,142278,136531,5747,4
Jefferson,8/1/2000,227728,216702,11026,4.8,142514,136662,5853,4.1
Jefferson,9/1/2000,227499,217397,10102,4.4,142518,136893,5625,3.9
Jefferson,10/1/2000,228822,218369,10453,4.6,142622,137088,5534,3.9
Jefferson,11/1/2000,230729,220063,10666,4.6,142962,137322,5639,3.9
Jefferson,12/1/2000,229474,219987,9487,4.1,143248,137614,5634,3.9
Jefferson,1/1/2001,228000,216801,11199,4.9,143800,137778,6023,4.2
Jefferson,2/1/2001,227994,218018,9976,4.4,143701,137612,6089,4.2
Jefferson,3/1/2001,229906,220317,9589,4.2,143924,137783,6141,4.3
Jefferson,4/1/2001,228982,219777,9205,4,143569,137299,6271,4.4
Jefferson,5/1/2001,229996,220168,9828,4.3,143318,137092,6226,4.3
Jefferson,6/1/2001,232255,220143,12112,5.2,143357,136873,6484,4.5
Jefferson,7/1/2001,230409,219153,11256,4.9,143654,137071,6583,4.6
Jefferson,8/1/2001,223440,212933,10507,4.7,143284,136241,7042,4.9
Jefferson,9/1/2001,225361,215001,10360,4.6,143989,136846,7142,5
Jefferson,10/1/2001,225859,214692,11167,4.9,144086,136392,7694,5.3
Jefferson,11/1/2001,228048,216209,11839,5.2,144240,136238,8003,5.5
Jefferson,12/1/2001,225910,214653,11257,5,144305,136047,8258,5.7
Jefferson,1/1/2002,222486,210241,12245,5.5,143883,135701,8182,5.7
Jefferson,2/1/2002,224251,212875,11376,5.1,144653,136438,8215,5.7
Jefferson,3/1/2002,225254,214559,10695,4.7,144481,136177,8304,5.7
Jefferson,4/1/2002,225342,215034,10308,4.6,144725,136126,8599,5.9
Jefferson,5/1/2002,226933,215709,11224,4.9,144938,136539,8399,5.8
Jefferson,6/1/2002,229405,216020,13385,5.8,144808,136415,8393,5.8
Jefferson,7/1/2002,227370,215040,12330,5.4,144803,136413,8390,5.8
Jefferson,8/1/2002,221619,210431,11188,5,145009,136705,8304,5.7
Jefferson,9/1/2002,223067,212822,10245,4.6,145552,137302,8251,5.7
Jefferson,10/1/2002,222822,212281,10541,4.7,145314,137008,8307,5.7
Jefferson,11/1/2002,225002,213760,11242,5,145041,136521,8520,5.9
Jefferson,12/1/2002,222729,212231,10498,4.7,145066,136426,8640,6
Jefferson,1/1/2003,221930,210312,11618,5.2,145937,137417,8520,5.8
Jefferson,2/1/2003,223621,212467,11154,5,146100,137482,8618,5.9
Jefferson,3/1/2003,224752,214355,10397,4.6,146022,137434,8588,5.9
Jefferson,4/1/2003,224941,214963,9978,4.4,146474,137633,8842,6
Jefferson,5/1/2003,226430,215201,11229,5,146500,137544,8957,6.1
Jefferson,6/1/2003,229468,215597,13871,6,147056,137790,9266,6.3
Jefferson,7/1/2003,226859,213984,12875,5.7,146485,137474,9011,6.2
Jefferson,8/1/2003,220656,208971,11685,5.3,146445,137549,8896,6.1
Jefferson,9/1/2003,221463,210694,10769,4.9,146530,137609,8921,6.1
Jefferson,10/1/2003,222193,211483,10710,4.8,146716,137984,8732,6
Jefferson,11/1/2003,225106,214106,11000,4.9,147000,138424,8576,5.8
Jefferson,12/1/2003,222791,212771,10020,4.5,146729,138411,8317,5.7
Jefferson,1/1/2004,221347,209937,11410,5.2,146842,138472,8370,5.7
Jefferson,2/1/2004,222377,212145,10232,4.6,146709,138542,8167,5.6
Jefferson,3/1/2004,223850,214212,9638,4.3,146944,138453,8491,5.8
Jefferson,4/1/2004,224099,215127,8972,4,146850,138680,8170,5.6
Jefferson,5/1/2004,225846,215684,10162,4.5,147065,138852,8212,5.6
Jefferson,6/1/2004,228924,216523,12401,5.4,147460,139174,8286,5.6
Jefferson,7/1/2004,227893,216403,11490,5,147692,139556,8136,5.5
Jefferson,8/1/2004,221972,211815,10157,4.6,147564,139573,7990,5.4
Jefferson,9/1/2004,222629,212847,9782,4.4,147415,139487,7927,5.4
Jefferson,10/1/2004,223934,213517,10417,4.7,147793,139732,8061,5.5
Jefferson,11/1/2004,227364,216622,10742,4.7,148162,140231,7932,5.4
Jefferson,12/1/2004,225422,215296,10126,4.5,148059,140125,7934,5.4
Jefferson,1/1/2005,223132,211763,11369,5.1,148029,140245,7784,5.3
Jefferson,2/1/2005,224182,213482,10700,4.8,148364,140385,7980,5.4
Jefferson,3/1/2005,225410,215996,9414,4.2,148391,140654,7737,5.2
Jefferson,4/1/2005,226820,217872,8948,3.9,148926,141254,7672,5.2
Jefferson,5/1/2005,229028,218709,10319,4.5,149261,141609,7651,5.1
Jefferson,6/1/2005,231694,219393,12301,5.3,149238,141714,7524,5
Jefferson,7/1/2005,230722,218871,11851,5.1,149432,142026,7406,5
Jefferson,8/1/2005,224654,214002,10652,4.7,149779,142434,7345,4.9
Jefferson,7/1/2006,221811,212950,8861,4,151377,144202,7175,4.7
Jefferson,8/1/2006,220094,211563,8531,3.9,151716,144625,7091,4.7
Jefferson,9/1/2006,219371,211015,8356,3.8,151662,144815,6847,4.5
Jefferson,10/1/2006,224005,215915,8090,3.6,152041,145314,6727,4.4
Jefferson,11/1/2006,225998,217898,8100,3.6,152406,145534,6872,4.5
Jefferson,12/1/2006,225848,218561,7287,3.2,152732,145970,6762,4.4
Jefferson,1/1/2007,220007,211563,8444,3.8,153144,146028,7116,4.6
Jefferson,2/1/2007,220223,212855,7368,3.3,152983,146057,6927,4.5
Jefferson,3/1/2007,223066,215687,7379,3.3,153051,146320,6731,4.4
Jefferson,4/1/2007,220274,212996,7278,3.3,152435,145586,6850,4.5
Jefferson,5/1/2007,220454,212488,7966,3.6,152670,145903,6766,4.4
Jefferson,6/1/2007,223873,214668,9205,4.1,153041,146063,6979,4.6
Jefferson,7/1/2007,223315,215003,8312,3.7,153054,145905,7149,4.7
Jefferson,8/1/2007,220016,212482,7534,3.4,152749,145682,7067,4.6
Jefferson,9/1/2007,219625,211878,7747,3.5,153414,146244,7170,4.7
Jefferson,10/1/2007,224142,217331,6811,3,153183,145946,7237,4.7
Jefferson,11/1/2007,226115,219190,6925,3.1,153835,146595,7240,4.7
Jefferson,12/1/2007,225844,218753,7091,3.1,153918,146273,7645,5
Jefferson,1/1/2008,211589,203362,8227,3.9,154063,146378,7685,5
Jefferson,2/1/2008,210771,204000,6771,3.2,153653,146156,7497,4.9
Jefferson,3/1/2008,213393,205968,7425,3.5,153908,146086,7822,5.1
Jefferson,4/1/2008,215458,208739,6719,3.1,153769,146132,7637,5
Jefferson,5/1/2008,215037,207191,7846,3.6,154303,145908,8395,5.4
Jefferson,6/1/2008,219013,209097,9916,4.5,154313,145737,8575,5.6
Jefferson,7/1/2008,218612,209068,9544,4.4,154469,145532,8937,5.8
Jefferson,8/1/2008,217840,208006,9834,4.5,154641,145203,9438,6.1
Jefferson,9/1/2008,218764,207567,11197,5.1,154570,145076,9494,6.1
Jefferson,10/1/2008,219721,209037,10684,4.9,154876,144802,10074,6.5
Jefferson,11/1/2008,218519,208068,10451,4.8,154639,144100,10538,6.8
Jefferson,12/1/2008,218536,207717,10819,5,154655,143369,11286,7.3
Jefferson,1/1/2009,210524,197945,12579,6,154210,142152,12058,7.8
Jefferson,2/1/2009,210767,198733,12034,5.7,154538,141640,12898,8.3
Jefferson,3/1/2009,211205,198874,12331,5.8,154133,140707,13426,8.7
Jefferson,4/1/2009,212725,200671,12054,5.7,154509,140656,13853,9
Jefferson,5/1/2009,212430,199555,12875,6.1,154747,140248,14499,9.4
Jefferson,6/1/2009,214976,199820,15156,7.1,154716,140009,14707,9.5
Jefferson,7/1/2009,215630,201278,14352,6.7,154502,139901,14601,9.5
Jefferson,8/1/2009,214413,200570,13843,6.5,154307,139492,14814,9.6
Jefferson,9/1/2009,212435,198754,13681,6.4,153827,138818,15009,9.8
Jefferson,10/1/2009,213097,199912,13185,6.2,153784,138432,15352,10
Jefferson,11/1/2009,213394,200723,12671,5.9,153878,138659,15219,9.9
Jefferson,12/1/2009,211860,198733,13127,6.2,153111,138013,15098,9.9
Jefferson,1/1/2010,214656,199730,14926,7,153484,138438,15046,9.8
Jefferson,2/1/2010,214143,200611,13532,6.3,153694,138581,15113,9.8
Jefferson,3/1/2010,216381,202501,13880,6.4,153954,138751,15202,9.9
Jefferson,4/1/2010,217875,204141,13734,6.3,154622,139297,15325,9.9
Jefferson,5/1/2010,216339,201776,14563,6.7,154091,139241,14849,9.6
Jefferson,6/1/2010,218703,202436,16267,7.4,153616,139141,14474,9.4
Jefferson,7/1/2010,217924,201926,15998,7.3,153691,139179,14512,9.4
Jefferson,8/1/2010,216676,200885,15791,7.3,154086,139438,14648,9.5
Jefferson,9/1/2010,216912,201398,15514,7.2,153975,139396,14579,9.5
Jefferson,10/1/2010,216856,201642,15214,7,153635,139119,14516,9.4
Jefferson,11/1/2010,217544,202478,15066,6.9,154125,139044,15081,9.8
Jefferson,12/1/2010,216853,202486,14367,6.6,153650,139301,14348,9.3
Jefferson,1/1/2011,213738,197901,15837,7.4,153263,139250,14013,9.1
Jefferson,2/1/2011,213573,199074,14499,6.8,153214,139394,13820,9
Jefferson,3/1/2011,214789,200589,14200,6.6,153376,139639,13737,9
Jefferson,4/1/2011,214072,200565,13507,6.3,153543,139586,13957,9.1
Jefferson,5/1/2011,213594,199414,14180,6.6,153479,139624,13855,9
Jefferson,6/1/2011,214527,198725,15802,7.4,153346,139384,13962,9.1
Jefferson,7/1/2011,214116,198769,15347,7.2,153288,139524,13763,9
Jefferson,8/1/2011,213142,198362,14780,6.9,153760,139942,13818,9
Jefferson,9/1/2011,213588,198877,14711,6.9,154131,140183,13948,9
Jefferson,10/1/2011,215090,200765,14325,6.7,153961,140368,13594,8.8
Jefferson,11/1/2011,215701,202275,13426,6.2,154128,140826,13302,8.6
Jefferson,12/1/2011,214518,201384,13134,6.1,153995,140902,13093,8.5
Jefferson,1/1/2012,210956,196381,14575,6.9,154381,141584,12797,8.3
Jefferson,2/1/2012,211109,197535,13574,6.4,154671,141858,12813,8.3
Jefferson,3/1/2012,212727,199319,13408,6.3,154749,142036,12713,8.2
Jefferson,4/1/2012,214170,201523,12647,5.9,154545,141899,12646,8.2
Jefferson,5/1/2012,214479,200823,13656,6.4,154866,142206,12660,8.2
Jefferson,6/1/2012,215724,200209,15515,7.2,155083,142391,12692,8.2
Jefferson,7/1/2012,215872,200821,15051,7,154948,142292,12656,8.2
Jefferson,8/1/2012,213019,199125,13894,6.5,154763,142291,12471,8.1
Jefferson,9/1/2012,212128,198721,13407,6.3,155160,143044,12115,7.8
Jefferson,10/1/2012,214250,201556,12694,5.9,155554,143431,12124,7.8
Jefferson,11/1/2012,213710,202075,11635,5.4,155338,143333,12005,7.7
Jefferson,12/1/2012,213675,201338,12337,5.8,155628,143330,12298,7.9
Jefferson,1/1/2013,213240,198708,14532,6.8,155763,143292,12471,8
Jefferson,2/1/2013,212680,199738,12942,6.1,155312,143362,11950,7.7
Jefferson,3/1/2013,212626,200014,12612,5.9,155005,143316,11689,7.5
Jefferson,4/1/2013,213550,201241,12309,5.8,155394,143635,11760,7.6
Jefferson,5/1/2013,213590,200454,13136,6.2,155536,143882,11654,7.5
Jefferson,6/1/2013,216037,201186,14851,6.9,155749,143999,11751,7.5
Jefferson,7/1/2013,214557,200509,14048,6.5,155599,144264,11335,7.3
Jefferson,8/1/2013,213678,200524,13154,6.2,155605,144326,11279,7.2
Jefferson,9/1/2013,213040,200095,12945,6.1,155687,144418,11270,7.2
Jefferson,10/1/2013,213699,201574,12125,5.7,154673,143537,11136,7.2
Jefferson,11/1/2013,214973,203883,11090,5.2,155265,144479,10787,6.9
Jefferson,12/1/2013,213328,203242,10086,4.7,155182,144778,10404,6.7
Jefferson,1/1/2014,211170,199777,11393,5.4,155352,145150,10202,6.6
Jefferson,2/1/2014,212375,201665,10710,5,155483,145134,10349,6.7
Jefferson,3/1/2014,214813,203720,11093,5.2,156028,145648,10380,6.7
Jefferson,4/1/2014,214351,204022,10329,4.8,155369,145667,9702,6.2
Jefferson,5/1/2014,215310,203440,11870,5.5,155684,145825,9859,6.3
Jefferson,6/1/2014,218762,205187,13575,6.2,155707,146247,9460,6.1
Jefferson,7/1/2014,219721,205069,14652,6.7,156007,146399,9608,6.2
Jefferson,8/1/2014,218635,204139,14496,6.6,156130,146530,9599,6.1
Jefferson,9/1/2014,217580,203436,14144,6.5,156040,146778,9262,5.9
Jefferson,10/1/2014,219876,206216,13660,6.2,156417,147427,8990,5.7
Jefferson,11/1/2014,221629,207746,13883,6.3,156494,147404,9090,5.8
Jefferson,12/1/2014,219196,206301,12895,5.9,156332,147615,8717,5.6
Jefferson,1/1/2015,217337,203022,14315,6.6,157030,148145,8885,5.7
Jefferson,2/1/2015,217215,204202,13013,6,156644,148045,8599,5.5
Jefferson,3/1/2015,218525,205836,12689,5.8,156643,148128,8515,5.4
Jefferson,4/1/2015,221110,208934,12176,5.5,157060,148511,8550,5.4
Jefferson,5/1/2015,220628,207850,12778,5.8,157651,148817,8834,5.6
Jefferson,6/1/2015,220671,207185,13486,6.1,157062,148816,8247,5.3
Jefferson,7/1/2015,220005,206687,13318,6.1,156997,148830,8167,5.2
Jefferson,8/1/2015,217093,204902,12191,5.6,157172,149181,7992,5.1
Jefferson,9/1/2015,215497,203412,12085,5.6,156733,148826,7907,5
Jefferson,10/1/2015,217970,206234,11736,5.4,157167,149246,7922,5
Jefferson,11/1/2015,217616,206597,11019,5.1,157463,149463,8000,5.1
Jefferson,12/1/2015,216695,206466,10229,4.7,158035,150128,7907,5
Jefferson,1/1/2016,215049,203214,11835,5.5,158280,150653,7627,4.8
Jefferson,2/1/2016,215056,204217,10839,5,158640,150939,7702,4.9
Jefferson,3/1/2016,216692,205324,11368,5.2,159179,151218,7961,5
Jefferson,4/1/2016,217416,206615,10801,5,159141,151074,8067,5.1
Jefferson,5/1/2016,216806,205888,10918,5,158784,151132,7652,4.8
Jefferson,6/1/2016,218469,205590,12879,5.9,158967,151223,7744,4.9
Jefferson,7/1/2016,218640,205877,12763,5.8,159194,151554,7641,4.8
Jefferson,8/1/2016,216285,204284,12001,5.5,159562,151779,7784,4.9
Jefferson,9/1/2016,216507,204511,11996,5.5,159714,151761,7953,5
Jefferson,10/1/2016,216407,205395,11012,5.1,159605,151793,7811,4.9
Jefferson,11/1/2016,216079,205908,10171,4.7,159506,151954,7553,4.7
Jefferson,12/1/2016,213772,203919,9853,4.6,159678,152157,7521,4.7
Jefferson,1/1/2017,212678,201565,11113,5.2,159620,152152,7468,4.7
Jefferson,2/1/2017,214432,204388,10044,4.7,159859,152480,7379,4.6
Jefferson,3/1/2017,214368,204679,9689,4.5,160137,153065,7073,4.4
Jefferson,4/1/2017,215815,206216,9599,4.4,160345,153255,7089,4.4
Jefferson,5/1/2017,214514,204989,9525,4.4,160068,153069,7000,4.4
Jefferson,6/1/2017,215721,204812,10909,5.1,160192,153318,6873,4.3
Jefferson,7/1/2017,215766,205004,10762,5,160462,153569,6892,4.3
Jefferson,8/1/2017,214307,203818,10489,4.9,160586,153503,7082,4.4
Jefferson,9/1/2017,215212,205455,9757,4.5,161140,154286,6854,4.3
Jefferson,10/1/2017,214792,206274,8518,4,160309,153609,6700,4.2
Jefferson,11/1/2017,215308,206994,8314,3.9,160579,153805,6774,4.2
Jefferson,12/1/2017,214133,206171,7962,3.7,160535,153904,6632,4.1
Jefferson,1/1/2018,211741,202800,8941,4.2,160914,154425,6489,4
Jefferson,2/1/2018,212855,204286,8569,4,161778,155197,6581,4.1
Jefferson,3/1/2018,213357,204533,8824,4.1,161686,155214,6472,4
Jefferson,4/1/2018,215169,206404,8765,4.1,161771,155312,6459,4
Jefferson,5/1/2018,213540,204454,9086,4.3,161848,155652,6196,3.8
Jefferson,6/1/2018,215688,204073,11615,5.4,162210,155762,6447,4
Jefferson,7/1/2018,215078,204223,10855,5,162341,156146,6195,3.8
Jefferson,8/1/2018,211811,201831,9980,4.7,161660,155504,6156,3.8
Jefferson,9/1/2018,211595,202356,9239,4.4,162087,156015,6073,3.7
Jefferson,10/1/2018,213176,204392,8784,4.1,162602,156391,6211,3.8
Jefferson,11/1/2018,213239,205045,8194,3.8,162836,156721,6115,3.8
Jefferson,12/1/2018,211652,203587,8065,3.8,163206,156817,6389,3.9
Jefferson,1/1/2019,211337,201841,9496,4.5,162963,156487,6475,4
Jefferson,2/1/2019,212131,204075,8056,3.8,162999,156863,6136,3.8
Jefferson,3/1/2019,211436,203826,7610,3.6,162904,156701,6202,3.8
Jefferson,4/1/2019,213286,206161,7125,3.3,162586,156625,5961,3.7
Jefferson,5/1/2019,212567,204488,8079,3.8,162751,156821,5930,3.6
Jefferson,6/1/2019,215408,205413,9995,4.6,163168,157232,5935,3.6
Jefferson,7/1/2019,214793,204943,9850,4.6,163590,157529,6061,3.7
Jefferson,8/1/2019,212835,203616,9219,4.3,163774,157829,5945,3.6
Jefferson,9/1/2019,213037,204318,8719,4.1,164092,158339,5753,3.5
Jefferson,10/1/2019,215054,206264,8790,4.1,164416,158545,5871,3.6
Jefferson,11/1/2019,215769,207448,8321,3.9,164496,158629,5868,3.6
Jefferson,12/1/2019,213664,205827,7837,3.7,164699,158845,5853,3.6
Jefferson,1/1/2020,213135,204497,8638,4.1,164377,158508,5869,3.6
Jefferson,2/1/2020,212428,205325,7103,3.3,164467,158714,5753,3.5
Jefferson,3/1/2020,212498,200040,12458,5.9,162559,155353,7206,4.4
Jefferson,4/1/2020,201755,167475,34280,17,156269,133185,23084,14.8
Jefferson,5/1/2020,203665,172047,31618,15.5,158101,137173,20929,13.2
Jefferson,6/1/2020,209577,180314,29263,14,159994,142342,17652,11
Jefferson,7/1/2020,208868,182581,26287,12.6,160132,143779,16352,10.2
Jefferson,8/1/2020,206762,185870,20892,10.1,160706,147245,13461,8.4
Jefferson,9/1/2020,207098,186075,21023,10.2,160174,147620,12554,7.8
Jefferson,10/1/2020,209092,191046,18046,8.6,161003,149931,11072,6.9
Jefferson,11/1/2020,206932,191853,15079,7.3,160629,149934,10694,6.7
Jefferson,12/1/2020,205469,190945,14524,7.1,160745,149975,10770,6.7
Jefferson,1/1/2021,203642,188208,15434,7.6,160088,149852,10236,6.4
Jefferson,2/1/2021,205481,191000,14481,7,160184,150189,9995,6.2
Jefferson,3/1/2021,206041,192377,13664,6.6,160400,150644,9756,6.1
Jefferson,4/1/2021,208971,194422,14549,7,160843,151081,9762,6.1
Jefferson,5/1/2021,208529,194535,13994,6.7,160800,151535,9266,5.8
Jefferson,6/1/2021,210780,195154,15626,7.4,161197,151734,9462,5.9
Jefferson,7/1/2021,211529,198062,13467,6.4,161504,152773,8731,5.4
Jefferson,8/1/2021,208864,197269,11595,5.6,161527,153250,8276,5.1
Jefferson,9/1/2021,202555,190588,11967,5.9,161495,153843,7652,4.7
Jefferson,10/1/2021,205062,195624,9438,4.6,161754,154475,7279,4.5
Jefferson,11/1/2021,206908,198560,8348,4,162281,155530,6751,4.2
Jefferson,12/1/2021,205848,198484,7364,3.6,162497,156099,6398,3.9
Jefferson,1/1/2022,205520,196570,8950,4.4,163627,157115,6512,4
Jefferson,2/1/2022,207261,199267,7994,3.9,163899,157598,6301,3.8
Jefferson,3/1/2022,208466,200970,7496,3.6,164220,158206,6014,3.7
Jefferson,4/1/2022,208620,201724,6896,3.3,163893,157891,6002,3.7
Jefferson,5/1/2022,208884,201704,7180,3.4,164362,158378,5983,3.6
Jefferson,6/1/2022,210975,202144,8831,4.2,164046,158094,5951,3.6
Jefferson,7/1/2022,210308,202095,8213,3.9,164026,158258,5768,3.5
Jefferson,8/1/2022,208405,200708,7697,3.7,164654,158735,5919,3.6
Jefferson,9/1/2022,207861,200746,7115,3.4,164602,158810,5792,3.5
Jefferson,10/1/2022,208319,201801,6518,3.1,164648,158684,5964,3.6
Jefferson,11/1/2022,208520,202324,6196,3,164450,158507,5943,3.6
Jefferson,12/1/2022,208235,201937,6298,3,165025,159259,5766,3.5
Jefferson,1/1/2023,207197,199749,7448,3.6,165964,160217,5747,3.5
Jefferson,2/1/2023,208473,201524,6949,3.3,166358,160395,5962,3.6
Jefferson,3/1/2023,209424,202799,6625,3.2,166651,160812,5839,3.5
Jefferson,4/1/2023,209723,203645,6078,2.9,166725,160974,5751,3.4
Jefferson,5/1/2023,209485,202366,7119,3.4,166886,160796,6089,3.6
Jefferson,6/1/2023,210764,202603,8161,3.9,166937,160979,5958,3.6
Jefferson,7/1/2023,208884,201714,7170,3.4,167103,161183,5920,3.5
Jefferson,8/1/2023,208316,200652,7664,3.7,167759,161475,6284,3.7
Jefferson,9/1/2023,208389,200532,7857,3.8,167767,161442,6326,3.8
Jefferson,10/1/2023,208690,200820,7870,3.8,167690,161211,6479,3.9
Jefferson,11/1/2023,208807,201456,7351,3.5,168140,161886,6254,3.7
Jefferson,12/1/2023,206637,199154,7483,3.6,167439,161124,6315,3.8
Jefferson,1/1/2024,205391,196930,8461,4.1,167339,161190,6149,3.7
Jefferson,2/1/2024,206786,198685,8101,3.9,167475,161013,6462,3.9
Jefferson,3/1/2024,208331,200552,7779,3.7,167922,161425,6497,3.9
Jefferson,4/1/2024,208877,201953,6924,3.3,167988,161495,6492,3.9
Jefferson,5/1/2024,206941,199713,7228,3.5,167799,161164,6635,4
Jefferson,6/1/2024,209232,199961,9271,4.4,168005,161155,6849,4.1
Jefferson,7/1/2024,210881,201606,9275,4.4,168315,161219,7097,4.2
Jefferson,8/1/2024,208471,199339,9132,4.4,168496,161425,7071,4.2
Jefferson,9/1/2024,208271,199412,8859,4.3,168703,161802,6901,4.1
Jefferson,10/1/2024,209231,200351,8880,4.2,168428,161456,6972,4.1
Jefferson,11/1/2024,209558,201126,8432,4,168304,161183,7121,4.2
Jefferson,12/1/2024,207551,199603,7948,3.8,168547,161661,6886,4.1
Jefferson,1/1/2025,205097,196780,8317,4.1,170744,163895,6849,4
Jefferson,2/1/2025,207041,199152,7889,3.8,170359,163307,7052,4.1
La Salle,1/1/1990,5651,5354,297,5.3,125833,119081,6752,5.4
La Salle,2/1/1990,5505,5257,248,4.5,125710,119059,6651,5.3
La Salle,3/1/1990,5438,5229,209,3.8,125801,119203,6598,5.2
La Salle,4/1/1990,5545,5327,218,3.9,125649,118852,6797,5.4
La Salle,5/1/1990,5642,5423,219,3.9,125893,119151,6742,5.4
La Salle,6/1/1990,5819,5521,298,5.1,125573,118983,6590,5.2
La Salle,7/1/1990,5938,5649,289,4.9,125732,118810,6922,5.5
La Salle,8/1/1990,5898,5635,263,4.5,125990,118802,7188,5.7
La Salle,9/1/1990,5795,5509,286,4.9,125892,118524,7368,5.9
La Salle,10/1/1990,5741,5503,238,4.1,125995,118536,7459,5.9
La Salle,11/1/1990,5754,5484,270,4.7,126070,118306,7764,6.2
La Salle,12/1/1990,5707,5400,307,5.4,126142,118241,7901,6.3
La Salle,1/1/1991,5748,5325,423,7.4,125955,117940,8015,6.4
La Salle,2/1/1991,5859,5377,482,8.2,126020,117755,8265,6.6
La Salle,3/1/1991,5907,5439,468,7.9,126238,117652,8586,6.8
La Salle,4/1/1991,5852,5362,490,8.4,126548,118109,8439,6.7
La Salle,5/1/1991,5775,5210,565,9.8,126176,117440,8736,6.9
La Salle,6/1/1991,5886,5394,492,8.4,126331,117639,8692,6.9
La Salle,7/1/1991,5953,5454,499,8.4,126154,117568,8586,6.8
La Salle,8/1/1991,5883,5459,424,7.2,126150,117484,8666,6.9
La Salle,9/1/1991,5865,5448,417,7.1,126650,117928,8722,6.9
La Salle,10/1/1991,5897,5537,360,6.1,126642,117800,8842,7
La Salle,11/1/1991,5914,5456,458,7.7,126701,117770,8931,7
La Salle,12/1/1991,5834,5339,495,8.5,126664,117466,9198,7.3
La Salle,1/1/1992,5921,5331,590,10,127261,117978,9283,7.3
La Salle,2/1/1992,6031,5465,566,9.4,127207,117753,9454,7.4
La Salle,3/1/1992,6197,5673,524,8.5,127604,118144,9460,7.4
La Salle,4/1/1992,6241,5735,506,8.1,127841,118426,9415,7.4
La Salle,5/1/1992,6121,5657,464,7.6,128119,118375,9744,7.6
La Salle,6/1/1992,6504,5868,636,9.8,128459,118419,10040,7.8
La Salle,7/1/1992,6521,6014,507,7.8,128563,118713,9850,7.7
La Salle,8/1/1992,6366,5909,457,7.2,128613,118826,9787,7.6
La Salle,9/1/1992,6404,5959,445,6.9,128501,118720,9781,7.6
La Salle,10/1/1992,6321,5975,346,5.5,128026,118628,9398,7.3
La Salle,11/1/1992,6279,5970,309,4.9,128441,118876,9565,7.4
La Salle,12/1/1992,6166,5811,355,5.8,128554,118997,9557,7.4
La Salle,1/1/1993,6041,5605,436,7.2,128400,119075,9325,7.3
La Salle,2/1/1993,5957,5612,345,5.8,128458,119275,9183,7.1
La Salle,3/1/1993,5979,5616,363,6.1,128598,119542,9056,7
La Salle,4/1/1993,5908,5548,360,6.1,128584,119474,9110,7.1
La Salle,5/1/1993,5888,5520,368,6.3,129264,120115,9149,7.1
La Salle,6/1/1993,6206,5727,479,7.7,129411,120290,9121,7
La Salle,7/1/1993,6139,5697,442,7.2,129397,120467,8930,6.9
La Salle,8/1/1993,6102,5563,539,8.8,129619,120856,8763,6.8
La Salle,9/1/1993,6096,5554,542,8.9,129268,120554,8714,6.7
La Salle,10/1/1993,6231,5696,535,8.6,129573,120823,8750,6.8
La Salle,11/1/1993,6150,5651,499,8.1,129711,121169,8542,6.6
La Salle,12/1/1993,6145,5660,485,7.9,129941,121464,8477,6.5
La Salle,1/1/1994,5940,5369,571,9.6,130596,121966,8630,6.6
La Salle,2/1/1994,5884,5388,496,8.4,130669,122086,8583,6.6
La Salle,3/1/1994,5881,5331,550,9.4,130400,121930,8470,6.5
La Salle,4/1/1994,5965,5452,513,8.6,130621,122290,8331,6.4
La Salle,5/1/1994,5925,5436,489,8.3,130779,122864,7915,6.1
La Salle,6/1/1994,6024,5470,554,9.2,130561,122634,7927,6.1
La Salle,7/1/1994,6027,5521,506,8.4,130652,122706,7946,6.1
La Salle,8/1/1994,6029,5530,499,8.3,131275,123342,7933,6
La Salle,9/1/1994,5851,5437,414,7.1,131421,123687,7734,5.9
La Salle,10/1/1994,5887,5488,399,6.8,131744,124112,7632,5.8
La Salle,11/1/1994,5847,5493,354,6.1,131891,124516,7375,5.6
La Salle,12/1/1994,5690,5370,320,5.6,131951,124721,7230,5.5
La Salle,1/1/1995,5774,5349,425,7.4,132038,124663,7375,5.6
La Salle,2/1/1995,5710,5324,386,6.8,132115,124928,7187,5.4
La Salle,3/1/1995,5788,5352,436,7.5,132108,124955,7153,5.4
La Salle,4/1/1995,5687,5320,367,6.5,132590,124945,7645,5.8
La Salle,5/1/1995,5642,5270,372,6.6,131851,124421,7430,5.6
La Salle,6/1/1995,5745,5310,435,7.6,131949,124522,7427,5.6
La Salle,7/1/1995,5796,5387,409,7.1,132343,124816,7527,5.7
La Salle,8/1/1995,5737,5342,395,6.9,132336,124852,7484,5.7
La Salle,9/1/1995,5571,5215,356,6.4,132611,125133,7478,5.6
La Salle,10/1/1995,5658,5340,318,5.6,132716,125388,7328,5.5
La Salle,11/1/1995,5572,5310,262,4.7,132614,125188,7426,5.6
La Salle,12/1/1995,5569,5305,264,4.7,132511,125088,7423,5.6
La Salle,1/1/1996,5507,5206,301,5.5,132616,125125,7491,5.6
La Salle,2/1/1996,5483,5196,287,5.2,132952,125639,7313,5.5
La Salle,3/1/1996,5471,5179,292,5.3,133180,125862,7318,5.5
La Salle,4/1/1996,5567,5246,321,5.8,133409,125994,7415,5.6
La Salle,5/1/1996,5560,5265,295,5.3,133667,126244,7423,5.6
La Salle,6/1/1996,5708,5364,344,6,133697,126602,7095,5.3
La Salle,7/1/1996,5858,5481,377,6.4,134284,126947,7337,5.5
La Salle,8/1/1996,5796,5461,335,5.8,134054,127172,6882,5.1
La Salle,9/1/1996,5647,5351,296,5.2,134515,127536,6979,5.2
La Salle,10/1/1996,5565,5274,291,5.2,134921,127890,7031,5.2
La Salle,11/1/1996,5534,5257,277,5,135007,127771,7236,5.4
La Salle,12/1/1996,5461,5223,238,4.4,135113,127860,7253,5.4
La Salle,1/1/1997,5879,5256,623,10.6,135456,128298,7158,5.3
La Salle,2/1/1997,5615,5094,521,9.3,135400,128298,7102,5.2
La Salle,3/1/1997,5653,5122,531,9.4,135891,128891,7000,5.2
La Salle,4/1/1997,5389,5137,252,4.7,136016,129143,6873,5.1
La Salle,5/1/1997,5407,5185,222,4.1,136119,129464,6655,4.9
La Salle,6/1/1997,5481,5186,295,5.4,136211,129412,6799,5
La Salle,7/1/1997,5202,4962,240,4.6,136477,129822,6655,4.9
La Salle,8/1/1997,5323,5047,276,5.2,136618,130010,6608,4.8
La Salle,9/1/1997,5308,5042,266,5,136675,130019,6656,4.9
La Salle,10/1/1997,5291,5023,268,5.1,136633,130179,6454,4.7
La Salle,11/1/1997,5267,5029,238,4.5,136961,130653,6308,4.6
La Salle,12/1/1997,5176,4953,223,4.3,137155,130679,6476,4.7
La Salle,1/1/1998,5263,4989,274,5.2,137095,130726,6368,4.6
La Salle,2/1/1998,5239,4992,247,4.7,137112,130807,6306,4.6
La Salle,3/1/1998,5232,4944,288,5.5,137236,130814,6422,4.7
La Salle,4/1/1998,5366,5041,325,6.1,137150,131209,5941,4.3
La Salle,5/1/1998,5370,5023,347,6.5,137372,131325,6047,4.4
La Salle,6/1/1998,5437,5062,375,6.9,137455,131244,6212,4.5
La Salle,7/1/1998,5504,5182,322,5.9,137588,131329,6259,4.5
La Salle,8/1/1998,5504,5163,341,6.2,137570,131390,6179,4.5
La Salle,9/1/1998,5462,5132,330,6,138286,131986,6300,4.6
La Salle,10/1/1998,5296,5016,280,5.3,138279,131999,6280,4.5
La Salle,11/1/1998,5218,4959,259,5,138381,132280,6100,4.4
La Salle,12/1/1998,5153,4583,570,11.1,138634,132602,6032,4.4
La Salle,1/1/1999,5448,4767,681,12.5,139003,133027,5976,4.3
La Salle,2/1/1999,5305,4895,410,7.7,138967,132856,6111,4.4
La Salle,3/1/1999,5424,4991,433,8,138730,132947,5783,4.2
La Salle,4/1/1999,5225,4763,462,8.8,138959,132955,6004,4.3
La Salle,5/1/1999,5171,4785,386,7.5,139107,133311,5796,4.2
La Salle,6/1/1999,5323,4918,405,7.6,139329,133378,5951,4.3
La Salle,7/1/1999,5244,4891,353,6.7,139439,133414,6025,4.3
La Salle,8/1/1999,5287,4948,339,6.4,139430,133591,5838,4.2
La Salle,9/1/1999,5157,4860,297,5.8,139622,133707,5915,4.2
La Salle,10/1/1999,5111,4817,294,5.8,139771,133993,5778,4.1
La Salle,11/1/1999,5106,4867,239,4.7,140025,134309,5716,4.1
La Salle,12/1/1999,5042,4818,224,4.4,140177,134523,5653,4
La Salle,1/1/2000,5888,5580,308,5.2,142267,136559,5708,4
La Salle,2/1/2000,5779,5513,266,4.6,142456,136598,5858,4.1
La Salle,3/1/2000,5797,5516,281,4.8,142434,136701,5733,4
La Salle,4/1/2000,5896,5633,263,4.5,142751,137270,5481,3.8
La Salle,5/1/2000,5856,5563,293,5,142388,136630,5758,4
La Salle,6/1/2000,6032,5630,402,6.7,142591,136940,5651,4
La Salle,7/1/2000,5957,5581,376,6.3,142278,136531,5747,4
La Salle,8/1/2000,5932,5547,385,6.5,142514,136662,5853,4.1
La Salle,9/1/2000,5849,5505,344,5.9,142518,136893,5625,3.9
La Salle,10/1/2000,5892,5563,329,5.6,142622,137088,5534,3.9
La Salle,11/1/2000,5762,5421,341,5.9,142962,137322,5639,3.9
La Salle,12/1/2000,5782,5396,386,6.7,143248,137614,5634,3.9
La Salle,1/1/2001,6085,5640,445,7.3,143800,137778,6023,4.2
La Salle,2/1/2001,6061,5691,370,6.1,143701,137612,6089,4.2
La Salle,3/1/2001,5950,5535,415,7,143924,137783,6141,4.3
La Salle,4/1/2001,5943,5597,346,5.8,143569,137299,6271,4.4
La Salle,5/1/2001,5905,5570,335,5.7,143318,137092,6226,4.3
La Salle,6/1/2001,6022,5613,409,6.8,143357,136873,6484,4.5
La Salle,7/1/2001,6027,5660,367,6.1,143654,137071,6583,4.6
La Salle,8/1/2001,5999,5650,349,5.8,143284,136241,7042,4.9
La Salle,9/1/2001,5917,5557,360,6.1,143989,136846,7142,5
La Salle,10/1/2001,5892,5521,371,6.3,144086,136392,7694,5.3
La Salle,11/1/2001,5859,5470,389,6.6,144240,136238,8003,5.5
La Salle,12/1/2001,5810,5415,395,6.8,144305,136047,8258,5.7
La Salle,1/1/2002,6044,5574,470,7.8,143883,135701,8182,5.7
La Salle,2/1/2002,6027,5621,406,6.7,144653,136438,8215,5.7
La Salle,3/1/2002,6108,5650,458,7.5,144481,136177,8304,5.7
La Salle,4/1/2002,6097,5656,441,7.2,144725,136126,8599,5.9
La Salle,5/1/2002,6126,5711,415,6.8,144938,136539,8399,5.8
La Salle,6/1/2002,6234,5732,502,8.1,144808,136415,8393,5.8
La Salle,7/1/2002,6175,5709,466,7.5,144803,136413,8390,5.8
La Salle,8/1/2002,6204,5743,461,7.4,145009,136705,8304,5.7
La Salle,9/1/2002,6129,5689,440,7.2,145552,137302,8251,5.7
La Salle,10/1/2002,5916,5483,433,7.3,145314,137008,8307,5.7
La Salle,11/1/2002,5920,5404,516,8.7,145041,136521,8520,5.9
La Salle,12/1/2002,5920,5400,520,8.8,145066,136426,8640,6
La Salle,1/1/2003,6113,5517,596,9.7,145937,137417,8520,5.8
La Salle,2/1/2003,5971,5421,550,9.2,146100,137482,8618,5.9
La Salle,3/1/2003,5952,5366,586,9.8,146022,137434,8588,5.9
La Salle,4/1/2003,5813,5279,534,9.2,146474,137633,8842,6
La Salle,5/1/2003,5935,5407,528,8.9,146500,137544,8957,6.1
La Salle,6/1/2003,6085,5451,634,10.4,147056,137790,9266,6.3
La Salle,7/1/2003,5907,5356,551,9.3,146485,137474,9011,6.2
La Salle,8/1/2003,5783,5282,501,8.7,146445,137549,8896,6.1
La Salle,9/1/2003,5628,5188,440,7.8,146530,137609,8921,6.1
La Salle,10/1/2003,5888,5492,396,6.7,146716,137984,8732,6
La Salle,11/1/2003,5815,5424,391,6.7,147000,138424,8576,5.8
La Salle,12/1/2003,5828,5447,381,6.5,146729,138411,8317,5.7
La Salle,1/1/2004,5708,5277,431,7.6,146842,138472,8370,5.7
La Salle,2/1/2004,5558,5185,373,6.7,146709,138542,8167,5.6
La Salle,3/1/2004,5555,5182,373,6.7,146944,138453,8491,5.8
La Salle,4/1/2004,5642,5316,326,5.8,146850,138680,8170,5.6
La Salle,5/1/2004,5672,5336,336,5.9,147065,138852,8212,5.6
La Salle,6/1/2004,5854,5431,423,7.2,147460,139174,8286,5.6
La Salle,7/1/2004,5884,5521,363,6.2,147692,139556,8136,5.5
La Salle,8/1/2004,5727,5425,302,5.3,147564,139573,7990,5.4
La Salle,9/1/2004,5661,5357,304,5.4,147415,139487,7927,5.4
La Salle,10/1/2004,5701,5412,289,5.1,147793,139732,8061,5.5
La Salle,11/1/2004,5674,5369,305,5.4,148162,140231,7932,5.4
La Salle,12/1/2004,5610,5312,298,5.3,148059,140125,7934,5.4
La Salle,1/1/2005,5708,5387,321,5.6,148029,140245,7784,5.3
La Salle,2/1/2005,5607,5316,291,5.2,148364,140385,7980,5.4
La Salle,3/1/2005,5630,5346,284,5,148391,140654,7737,5.2
La Salle,4/1/2005,5724,5457,267,4.7,148926,141254,7672,5.2
La Salle,5/1/2005,5680,5389,291,5.1,149261,141609,7651,5.1
La Salle,6/1/2005,5839,5479,360,6.2,149238,141714,7524,5
La Salle,7/1/2005,5794,5470,324,5.6,149432,142026,7406,5
La Salle,8/1/2005,5755,5477,278,4.8,149779,142434,7345,4.9
La Salle,9/1/2005,6083,5723,360,5.9,149954,142401,7553,5
La Salle,10/1/2005,6177,5838,339,5.5,150001,142548,7453,5
La Salle,11/1/2005,6123,5760,363,5.9,150065,142499,7566,5
La Salle,12/1/2005,5917,5695,222,3.8,150030,142752,7279,4.9
La Salle,1/1/2006,6007,5798,209,3.5,150214,143150,7064,4.7
La Salle,2/1/2006,5974,5804,170,2.8,150641,143457,7184,4.8
La Salle,3/1/2006,6026,5849,177,2.9,150813,143741,7072,4.7
La Salle,4/1/2006,6152,5989,163,2.6,150881,143761,7120,4.7
La Salle,5/1/2006,6273,6072,201,3.2,151069,144089,6980,4.6
La Salle,6/1/2006,6448,6189,259,4,151354,144353,7001,4.6
La Salle,7/1/2006,6369,6144,225,3.5,151377,144202,7175,4.7
La Salle,8/1/2006,6301,6080,221,3.5,151716,144625,7091,4.7
La Salle,9/1/2006,6222,6007,215,3.5,151662,144815,6847,4.5
La Salle,10/1/2006,6258,6044,214,3.4,152041,145314,6727,4.4
La Salle,11/1/2006,6252,6039,213,3.4,152406,145534,6872,4.5
La Salle,12/1/2006,6219,6022,197,3.2,152732,145970,6762,4.4
La Salle,1/1/2007,6169,5932,237,3.8,153144,146028,7116,4.6
La Salle,2/1/2007,6185,5971,214,3.5,152983,146057,6927,4.5
La Salle,3/1/2007,6140,5917,223,3.6,153051,146320,6731,4.4
La Salle,4/1/2007,6226,6017,209,3.4,152435,145586,6850,4.5
La Salle,5/1/2007,6181,5934,247,4,152670,145903,6766,4.4
La Salle,6/1/2007,6333,6046,287,4.5,153041,146063,6979,4.6
La Salle,7/1/2007,6357,6096,261,4.1,153054,145905,7149,4.7
La Salle,8/1/2007,6296,6059,237,3.8,152749,145682,7067,4.6
La Salle,9/1/2007,6311,6076,235,3.7,153414,146244,7170,4.7
La Salle,10/1/2007,6343,6142,201,3.2,153183,145946,7237,4.7
La Salle,11/1/2007,6392,6188,204,3.2,153835,146595,7240,4.7
La Salle,12/1/2007,6335,6135,200,3.2,153918,146273,7645,5
La Salle,1/1/2008,6308,6076,232,3.7,154063,146378,7685,5
La Salle,2/1/2008,6318,6124,194,3.1,153653,146156,7497,4.9
La Salle,3/1/2008,6364,6147,217,3.4,153908,146086,7822,5.1
La Salle,4/1/2008,6382,6203,179,2.8,153769,146132,7637,5
La Salle,5/1/2008,6431,6207,224,3.5,154303,145908,8395,5.4
La Salle,6/1/2008,6456,6166,290,4.5,154313,145737,8575,5.6
La Salle,7/1/2008,6428,6175,253,3.9,154469,145532,8937,5.8
La Salle,8/1/2008,6331,6056,275,4.3,154641,145203,9438,6.1
La Salle,9/1/2008,6331,6090,241,3.8,154570,145076,9494,6.1
La Salle,10/1/2008,6484,6211,273,4.2,154876,144802,10074,6.5
La Salle,11/1/2008,6475,6205,270,4.2,154639,144100,10538,6.8
La Salle,12/1/2008,6375,6087,288,4.5,154655,143369,11286,7.3
La Salle,1/1/2009,6301,5947,354,5.6,154210,142152,12058,7.8
La Salle,2/1/2009,6255,5898,357,5.7,154538,141640,12898,8.3
La Salle,3/1/2009,6326,5915,411,6.5,154133,140707,13426,8.7
La Salle,4/1/2009,6440,5988,452,7,154509,140656,13853,9
La Salle,5/1/2009,6475,6000,475,7.3,154747,140248,14499,9.4
La Salle,6/1/2009,6599,6043,556,8.4,154716,140009,14707,9.5
La Salle,7/1/2009,6705,6216,489,7.3,154502,139901,14601,9.5
La Salle,8/1/2009,6583,6106,477,7.2,154307,139492,14814,9.6
La Salle,9/1/2009,6551,6113,438,6.7,153827,138818,15009,9.8
La Salle,10/1/2009,6519,6094,425,6.5,153784,138432,15352,10
La Salle,11/1/2009,6447,6052,395,6.1,153878,138659,15219,9.9
La Salle,12/1/2009,6413,6033,380,5.9,153111,138013,15098,9.9
La Salle,1/1/2010,6095,5669,426,7,153484,138438,15046,9.8
La Salle,2/1/2010,6158,5786,372,6,153694,138581,15113,9.8
La Salle,3/1/2010,6243,5880,363,5.8,153954,138751,15202,9.9
La Salle,4/1/2010,6405,6048,357,5.6,154622,139297,15325,9.9
La Salle,5/1/2010,6437,6058,379,5.9,154091,139241,14849,9.6
La Salle,6/1/2010,6580,6156,424,6.4,153616,139141,14474,9.4
La Salle,7/1/2010,6594,6179,415,6.3,153691,139179,14512,9.4
La Salle,8/1/2010,6590,6178,412,6.3,154086,139438,14648,9.5
La Salle,9/1/2010,6627,6231,396,6,153975,139396,14579,9.5
La Salle,10/1/2010,6631,6220,411,6.2,153635,139119,14516,9.4
La Salle,11/1/2010,6595,6201,394,6,154125,139044,15081,9.8
La Salle,12/1/2010,6588,6229,359,5.4,153650,139301,14348,9.3
La Salle,1/1/2011,6544,6141,403,6.2,153263,139250,14013,9.1
La Salle,2/1/2011,6555,6194,361,5.5,153214,139394,13820,9
La Salle,3/1/2011,6508,6158,350,5.4,153376,139639,13737,9
La Salle,4/1/2011,6648,6312,336,5.1,153543,139586,13957,9.1
La Salle,5/1/2011,6775,6416,359,5.3,153479,139624,13855,9
La Salle,6/1/2011,6817,6410,407,6,153346,139384,13962,9.1
La Salle,7/1/2011,6841,6454,387,5.7,153288,139524,13763,9
La Salle,8/1/2011,6729,6365,364,5.4,153760,139942,13818,9
La Salle,9/1/2011,6825,6457,368,5.4,154131,140183,13948,9
La Salle,10/1/2011,6888,6525,363,5.3,153961,140368,13594,8.8
La Salle,11/1/2011,6890,6550,340,4.9,154128,140826,13302,8.6
La Salle,12/1/2011,6775,6469,306,4.5,153995,140902,13093,8.5
La Salle,1/1/2012,6681,6336,345,5.2,154381,141584,12797,8.3
La Salle,2/1/2012,6641,6299,342,5.1,154671,141858,12813,8.3
La Salle,3/1/2012,6638,6315,323,4.9,154749,142036,12713,8.2
La Salle,4/1/2012,6883,6578,305,4.4,154545,141899,12646,8.2
La Salle,5/1/2012,6800,6470,330,4.9,154866,142206,12660,8.2
La Salle,6/1/2012,6940,6542,398,5.7,155083,142391,12692,8.2
La Salle,7/1/2012,6828,6465,363,5.3,154948,142292,12656,8.2
La Salle,8/1/2012,6664,6331,333,5,154763,142291,12471,8.1
La Salle,9/1/2012,6654,6354,300,4.5,155160,143044,12115,7.8
La Salle,10/1/2012,6775,6480,295,4.4,155554,143431,12124,7.8
La Salle,11/1/2012,6938,6663,275,4,155338,143333,12005,7.7
La Salle,12/1/2012,6964,6660,304,4.4,155628,143330,12298,7.9
La Salle,1/1/2013,7166,6786,380,5.3,155763,143292,12471,8
La Salle,2/1/2013,7021,6709,312,4.4,155312,143362,11950,7.7
La Salle,3/1/2013,6955,6648,307,4.4,155005,143316,11689,7.5
La Salle,4/1/2013,7002,6694,308,4.4,155394,143635,11760,7.6
La Salle,5/1/2013,7095,6742,353,5,155536,143882,11654,7.5
La Salle,6/1/2013,7102,6708,394,5.5,155749,143999,11751,7.5
La Salle,7/1/2013,7026,6651,375,5.3,155599,144264,11335,7.3
La Salle,8/1/2013,6820,6474,346,5.1,155605,144326,11279,7.2
La Salle,9/1/2013,6912,6584,328,4.7,155687,144418,11270,7.2
La Salle,10/1/2013,6942,6619,323,4.7,154673,143537,11136,7.2
La Salle,11/1/2013,6922,6630,292,4.2,155265,144479,10787,6.9
La Salle,12/1/2013,6827,6552,275,4,155182,144778,10404,6.7
La Salle,1/1/2014,6520,6227,293,4.5,155352,145150,10202,6.6
La Salle,2/1/2014,6294,6031,263,4.2,155483,145134,10349,6.7
La Salle,3/1/2014,6369,6085,284,4.5,156028,145648,10380,6.7
La Salle,4/1/2014,6486,6221,265,4.1,155369,145667,9702,6.2
La Salle,5/1/2014,6586,6267,319,4.8,155684,145825,9859,6.3
La Salle,6/1/2014,6740,6369,371,5.5,155707,146247,9460,6.1
La Salle,7/1/2014,6697,6299,398,5.9,156007,146399,9608,6.2
La Salle,8/1/2014,6588,6198,390,5.9,156130,146530,9599,6.1
La Salle,9/1/2014,6678,6288,390,5.8,156040,146778,9262,5.9
La Salle,10/1/2014,6786,6418,368,5.4,156417,147427,8990,5.7
La Salle,11/1/2014,6756,6386,370,5.5,156494,147404,9090,5.8
La Salle,12/1/2014,6639,6311,328,4.9,156332,147615,8717,5.6
La Salle,1/1/2015,6625,6209,416,6.3,157030,148145,8885,5.7
La Salle,2/1/2015,6573,6155,418,6.4,156644,148045,8599,5.5
La Salle,3/1/2015,6656,6187,469,7,156643,148128,8515,5.4
La Salle,4/1/2015,6715,6223,492,7.3,157060,148511,8550,5.4
La Salle,5/1/2015,6677,6160,517,7.7,157651,148817,8834,5.6
La Salle,6/1/2015,6795,6254,541,8,157062,148816,8247,5.3
La Salle,7/1/2015,6669,6157,512,7.7,156997,148830,8167,5.2
La Salle,8/1/2015,6473,6024,449,6.9,157172,149181,7992,5.1
La Salle,9/1/2015,6540,6103,437,6.7,156733,148826,7907,5
La Salle,10/1/2015,6405,6005,400,6.2,157167,149246,7922,5
La Salle,11/1/2015,6376,5995,381,6,157463,149463,8000,5.1
La Salle,12/1/2015,6367,6006,361,5.7,158035,150128,7907,5
La Salle,1/1/2016,6356,5911,445,7,158280,150653,7627,4.8
La Salle,2/1/2016,6363,5922,441,6.9,158640,150939,7702,4.9
La Salle,3/1/2016,6391,5924,467,7.3,159179,151218,7961,5
La Salle,4/1/2016,6298,5858,440,7,159141,151074,8067,5.1
La Salle,5/1/2016,6330,5875,455,7.2,158784,151132,7652,4.8
La Salle,6/1/2016,6373,5891,482,7.6,158967,151223,7744,4.9
La Salle,7/1/2016,6262,5821,441,7,159194,151554,7641,4.8
La Salle,8/1/2016,6144,5737,407,6.6,159562,151779,7784,4.9
La Salle,9/1/2016,6185,5793,392,6.3,159714,151761,7953,5
La Salle,10/1/2016,6182,5837,345,5.6,159605,151793,7811,4.9
La Salle,11/1/2016,6198,5874,324,5.2,159506,151954,7553,4.7
La Salle,12/1/2016,6136,5820,316,5.1,159678,152157,7521,4.7
La Salle,1/1/2017,6072,5724,348,5.7,159620,152152,7468,4.7
La Salle,2/1/2017,6082,5760,322,5.3,159859,152480,7379,4.6
La Salle,3/1/2017,6098,5793,305,5,160137,153065,7073,4.4
La Salle,4/1/2017,6175,5878,297,4.8,160345,153255,7089,4.4
La Salle,5/1/2017,6059,5784,275,4.5,160068,153069,7000,4.4
La Salle,6/1/2017,6237,5921,316,5.1,160192,153318,6873,4.3
La Salle,7/1/2017,6215,5910,305,4.9,160462,153569,6892,4.3
La Salle,8/1/2017,6112,5820,292,4.8,160586,153503,7082,4.4
La Salle,9/1/2017,6276,6002,274,4.4,161140,154286,6854,4.3
La Salle,10/1/2017,6089,5852,237,3.9,160309,153609,6700,4.2
La Salle,11/1/2017,6153,5903,250,4.1,160579,153805,6774,4.2
La Salle,12/1/2017,6058,5826,232,3.8,160535,153904,6632,4.1
La Salle,1/1/2018,6198,5930,268,4.3,160914,154425,6489,4
La Salle,2/1/2018,6167,5912,255,4.1,161778,155197,6581,4.1
La Salle,3/1/2018,6212,5942,270,4.3,161686,155214,6472,4
La Salle,4/1/2018,6295,6032,263,4.2,161771,155312,6459,4
La Salle,5/1/2018,6318,6057,261,4.1,161848,155652,6196,3.8
La Salle,6/1/2018,6468,6118,350,5.4,162210,155762,6447,4
La Salle,7/1/2018,6366,6045,321,5,162341,156146,6195,3.8
La Salle,8/1/2018,6257,5975,282,4.5,161660,155504,6156,3.8
La Salle,9/1/2018,6462,6196,266,4.1,162087,156015,6073,3.7
La Salle,10/1/2018,6468,6207,261,4,162602,156391,6211,3.8
La Salle,11/1/2018,6492,6248,244,3.8,162836,156721,6115,3.8
La Salle,12/1/2018,6464,6236,228,3.5,163206,156817,6389,3.9
La Salle,1/1/2019,6562,6281,281,4.3,162963,156487,6475,4
La Salle,2/1/2019,6554,6304,250,3.8,162999,156863,6136,3.8
La Salle,3/1/2019,6591,6357,234,3.6,162904,156701,6202,3.8
La Salle,4/1/2019,6608,6399,209,3.2,162586,156625,5961,3.7
La Salle,5/1/2019,6629,6379,250,3.8,162751,156821,5930,3.6
La Salle,6/1/2019,6863,6513,350,5.1,163168,157232,5935,3.6
La Salle,7/1/2019,6855,6507,348,5.1,163590,157529,6061,3.7
La Salle,8/1/2019,6754,6453,301,4.5,163774,157829,5945,3.6
La Salle,9/1/2019,6820,6539,281,4.1,164092,158339,5753,3.5
La Salle,10/1/2019,6798,6520,278,4.1,164416,158545,5871,3.6
La Salle,11/1/2019,6812,6538,274,4,164496,158629,5868,3.6
La Salle,12/1/2019,6757,6498,259,3.8,164699,158845,5853,3.6
La Salle,1/1/2020,6782,6494,288,4.2,164377,158508,5869,3.6
La Salle,2/1/2020,6741,6510,231,3.4,164467,158714,5753,3.5
La Salle,3/1/2020,6802,6396,406,6,162559,155353,7206,4.4
La Salle,4/1/2020,6563,6173,390,5.9,156269,133185,23084,14.8
La Salle,5/1/2020,6677,6283,394,5.9,158101,137173,20929,13.2
La Salle,6/1/2020,6855,6426,429,6.3,159994,142342,17652,11
La Salle,7/1/2020,6864,6435,429,6.3,160132,143779,16352,10.2
La Salle,8/1/2020,6872,6528,344,5,160706,147245,13461,8.4
La Salle,9/1/2020,6877,6523,354,5.1,160174,147620,12554,7.8
La Salle,10/1/2020,6814,6503,311,4.6,161003,149931,11072,6.9
La Salle,11/1/2020,6750,6466,284,4.2,160629,149934,10694,6.7
La Salle,12/1/2020,6820,6528,292,4.3,160745,149975,10770,6.7
La Salle,1/1/2021,6634,6342,292,4.4,160088,149852,10236,6.4
La Salle,2/1/2021,6679,6400,279,4.2,160184,150189,9995,6.2
La Salle,3/1/2021,6764,6502,262,3.9,160400,150644,9756,6.1
La Salle,4/1/2021,6663,6435,228,3.4,160843,151081,9762,6.1
La Salle,5/1/2021,6634,6396,238,3.6,160800,151535,9266,5.8
La Salle,6/1/2021,6747,6465,282,4.2,161197,151734,9462,5.9
La Salle,7/1/2021,6654,6401,253,3.8,161504,152773,8731,5.4
La Salle,8/1/2021,6603,6388,215,3.3,161527,153250,8276,5.1
La Salle,9/1/2021,6731,6533,198,2.9,161495,153843,7652,4.7
La Salle,10/1/2021,6629,6447,182,2.7,161754,154475,7279,4.5
La Salle,11/1/2021,6674,6515,159,2.4,162281,155530,6751,4.2
La Salle,12/1/2021,6561,6412,149,2.3,162497,156099,6398,3.9
La Salle,1/1/2022,6638,6454,184,2.8,163627,157115,6512,4
La Salle,2/1/2022,6656,6493,163,2.4,163899,157598,6301,3.8
La Salle,3/1/2022,6728,6566,162,2.4,164220,158206,6014,3.7
La Salle,4/1/2022,6673,6522,151,2.3,163893,157891,6002,3.7
La Salle,5/1/2022,6697,6529,168,2.5,164362,158378,5983,3.6
La Salle,6/1/2022,6745,6514,231,3.4,164046,158094,5951,3.6
La Salle,7/1/2022,6713,6510,203,3,164026,158258,5768,3.5
La Salle,8/1/2022,6652,6469,183,2.8,164654,158735,5919,3.6
La Salle,9/1/2022,6643,6463,180,2.7,164602,158810,5792,3.5
La Salle,10/1/2022,6706,6536,170,2.5,164648,158684,5964,3.6
La Salle,11/1/2022,6646,6483,163,2.5,164450,158507,5943,3.6
La Salle,12/1/2022,6698,6532,166,2.5,165025,159259,5766,3.5
La Salle,1/1/2023,6469,6275,194,3,165964,160217,5747,3.5
La Salle,2/1/2023,6468,6279,189,2.9,166358,160395,5962,3.6
La Salle,3/1/2023,6521,6340,181,2.8,166651,160812,5839,3.5
La Salle,4/1/2023,6491,6327,164,2.5,166725,160974,5751,3.4
La Salle,5/1/2023,6507,6307,200,3.1,166886,160796,6089,3.6
La Salle,6/1/2023,6643,6407,236,3.6,166937,160979,5958,3.6
La Salle,7/1/2023,6599,6391,208,3.2,167103,161183,5920,3.5
La Salle,8/1/2023,6576,6374,202,3.1,167759,161475,6284,3.7
La Salle,9/1/2023,6590,6366,224,3.4,167767,161442,6326,3.8
La Salle,10/1/2023,6582,6380,202,3.1,167690,161211,6479,3.9
La Salle,11/1/2023,6614,6415,199,3,168140,161886,6254,3.7
La Salle,12/1/2023,6566,6357,209,3.2,167439,161124,6315,3.8
La Salle,1/1/2024,6529,6303,226,3.5,167339,161190,6149,3.7
La Salle,2/1/2024,6542,6311,231,3.5,167475,161013,6462,3.9
La Salle,3/1/2024,6483,6264,219,3.4,167922,161425,6497,3.9
La Salle,4/1/2024,6435,6239,196,3,167988,161495,6492,3.9
La Salle,5/1/2024,6411,6216,195,3,167799,161164,6635,4
La Salle,6/1/2024,6652,6387,265,4,168005,161155,6849,4.1
La Salle,7/1/2024,6654,6395,259,3.9,168315,161219,7097,4.2
La Salle,8/1/2024,6598,6343,255,3.9,168496,161425,7071,4.2
La Salle,9/1/2024,6611,6360,251,3.8,168703,161802,6901,4.1
La Salle,10/1/2024,6555,6315,240,3.7,168428,161456,6972,4.1
La Salle,11/1/2024,6534,6305,229,3.5,168304,161183,7121,4.2
La Salle,12/1/2024,6506,6287,219,3.4,168547,161661,6886,4.1
La Salle,1/1/2025,5854,5651,203,3.5,170744,163895,6849,4
La Salle,2/1/2025,5801,5608,193,3.3,170359,163307,7052,4.1
Lafayette,1/1/1990,77858,74393,3465,4.5,125833,119081,6752,5.4
Lafayette,2/1/1990,78696,75509,3187,4,125710,119059,6651,5.3
Lafayette,3/1/1990,79913,76806,3107,3.9,125801,119203,6598,5.2
Lafayette,4/1/1990,80405,77557,2848,3.5,125649,118852,6797,5.4
Lafayette,5/1/1990,81179,78048,3131,3.9,125893,119151,6742,5.4
Lafayette,6/1/1990,82730,78926,3804,4.6,125573,118983,6590,5.2
Lafayette,7/1/1990,84055,80663,3392,4,125732,118810,6922,5.5
Lafayette,8/1/1990,85230,81501,3729,4.4,125990,118802,7188,5.7
Lafayette,9/1/1990,83391,79428,3963,4.8,125892,118524,7368,5.9
Lafayette,10/1/1990,83682,79928,3754,4.5,125995,118536,7459,5.9
Lafayette,11/1/1990,83420,79897,3523,4.2,126070,118306,7764,6.2
Lafayette,12/1/1990,83171,79763,3408,4.1,126142,118241,7901,6.3
Lafayette,1/1/1991,82407,78572,3835,4.7,125955,117940,8015,6.4
Lafayette,2/1/1991,82654,79149,3505,4.2,126020,117755,8265,6.6
Lafayette,3/1/1991,83924,80352,3572,4.3,126238,117652,8586,6.8
Lafayette,4/1/1991,85355,81670,3685,4.3,126548,118109,8439,6.7
Lafayette,5/1/1991,85253,81235,4018,4.7,126176,117440,8736,6.9
Lafayette,6/1/1991,86472,81925,4547,5.3,126331,117639,8692,6.9
Lafayette,7/1/1991,87001,82938,4063,4.7,126154,117568,8586,6.8
Lafayette,8/1/1991,86190,81940,4250,4.9,126150,117484,8666,6.9
Lafayette,9/1/1991,85916,81508,4408,5.1,126650,117928,8722,6.9
Lafayette,10/1/1991,85696,81365,4331,5.1,126642,117800,8842,7
Lafayette,11/1/1991,85530,81316,4214,4.9,126701,117770,8931,7
Lafayette,12/1/1991,84892,80746,4146,4.9,126664,117466,9198,7.3
Lafayette,1/1/1992,83863,78738,5125,6.1,127261,117978,9283,7.3
Lafayette,2/1/1992,83326,78721,4605,5.5,127207,117753,9454,7.4
Lafayette,3/1/1992,84455,79530,4925,5.8,127604,118144,9460,7.4
Lafayette,4/1/1992,85206,80203,5003,5.9,127841,118426,9415,7.4
Lafayette,5/1/1992,85099,79632,5467,6.4,128119,118375,9744,7.6
Lafayette,6/1/1992,86317,80103,6214,7.2,128459,118419,10040,7.8
Lafayette,7/1/1992,88918,83416,5502,6.2,128563,118713,9850,7.7
Lafayette,8/1/1992,88564,82942,5622,6.3,128613,118826,9787,7.6
Lafayette,9/1/1992,86891,81611,5280,6.1,128501,118720,9781,7.6
Lafayette,10/1/1992,86433,81633,4800,5.6,128026,118628,9398,7.3
Lafayette,11/1/1992,86350,82117,4233,4.9,128441,118876,9565,7.4
Lafayette,12/1/1992,84268,80259,4009,4.8,128554,118997,9557,7.4
Lafayette,1/1/1993,82865,78316,4549,5.5,128400,119075,9325,7.3
Lafayette,2/1/1993,83194,79092,4102,4.9,128458,119275,9183,7.1
Lafayette,3/1/1993,83982,80017,3965,4.7,128598,119542,9056,7
Lafayette,4/1/1993,84314,80621,3693,4.4,128584,119474,9110,7.1
Lafayette,5/1/1993,84854,80871,3983,4.7,129264,120115,9149,7.1
Lafayette,6/1/1993,85344,80758,4586,5.4,129411,120290,9121,7
Lafayette,7/1/1993,86136,82091,4045,4.7,129397,120467,8930,6.9
Lafayette,8/1/1993,86397,82392,4005,4.6,129619,120856,8763,6.8
Lafayette,9/1/1993,85471,81388,4083,4.8,129268,120554,8714,6.7
Lafayette,10/1/1993,85959,81897,4062,4.7,129573,120823,8750,6.8
Lafayette,11/1/1993,85918,82205,3713,4.3,129711,121169,8542,6.6
Lafayette,12/1/1993,85518,82014,3504,4.1,129941,121464,8477,6.5
Lafayette,1/1/1994,84897,80359,4538,5.3,130596,121966,8630,6.6
Lafayette,2/1/1994,85370,81214,4156,4.9,130669,122086,8583,6.6
Lafayette,3/1/1994,86233,81996,4237,4.9,130400,121930,8470,6.5
Lafayette,4/1/1994,87120,82931,4189,4.8,130621,122290,8331,6.4
Lafayette,5/1/1994,87438,83411,4027,4.6,130779,122864,7915,6.1
Lafayette,6/1/1994,87801,83213,4588,5.2,130561,122634,7927,6.1
Lafayette,7/1/1994,89257,85009,4248,4.8,130652,122706,7946,6.1
Lafayette,8/1/1994,89444,85083,4361,4.9,131275,123342,7933,6
Lafayette,9/1/1994,88590,84168,4422,5,131421,123687,7734,5.9
Lafayette,10/1/1994,88035,83802,4233,4.8,131744,124112,7632,5.8
Lafayette,11/1/1994,88237,84370,3867,4.4,131891,124516,7375,5.6
Lafayette,12/1/1994,87055,83658,3397,3.9,131951,124721,7230,5.5
Lafayette,1/1/1995,86381,82290,4091,4.7,132038,124663,7375,5.6
Lafayette,2/1/1995,87011,83233,3778,4.3,132115,124928,7187,5.4
Lafayette,3/1/1995,88357,84441,3916,4.4,132108,124955,7153,5.4
Lafayette,4/1/1995,89149,85224,3925,4.4,132590,124945,7645,5.8
Lafayette,5/1/1995,88663,84643,4020,4.5,131851,124421,7430,5.6
Lafayette,6/1/1995,89690,85087,4603,5.1,131949,124522,7427,5.6
Lafayette,7/1/1995,90636,86273,4363,4.8,132343,124816,7527,5.7
Lafayette,8/1/1995,90637,86265,4372,4.8,132336,124852,7484,5.7
Lafayette,9/1/1995,90108,85725,4383,4.9,132611,125133,7478,5.6
Lafayette,10/1/1995,90150,85826,4324,4.8,132716,125388,7328,5.5
Lafayette,11/1/1995,90064,86395,3669,4.1,132614,125188,7426,5.6
Lafayette,12/1/1995,89420,85995,3425,3.8,132511,125088,7423,5.6
Lafayette,1/1/1996,88305,84014,4291,4.9,132616,125125,7491,5.6
Lafayette,2/1/1996,88869,85248,3621,4.1,132952,125639,7313,5.5
Lafayette,3/1/1996,89632,86072,3560,4,133180,125862,7318,5.5
Lafayette,4/1/1996,90289,86820,3469,3.8,133409,125994,7415,5.6
Lafayette,5/1/1996,90816,86920,3896,4.3,133667,126244,7423,5.6
Lafayette,6/1/1996,91703,87580,4123,4.5,133697,126602,7095,5.3
Lafayette,7/1/1996,93108,89224,3884,4.2,134284,126947,7337,5.5
Lafayette,8/1/1996,93699,89804,3895,4.2,134054,127172,6882,5.1
Lafayette,9/1/1996,93023,89162,3861,4.2,134515,127536,6979,5.2
Lafayette,10/1/1996,93516,89728,3788,4.1,134921,127890,7031,5.2
Lafayette,11/1/1996,93083,89794,3289,3.5,135007,127771,7236,5.4
Lafayette,12/1/1996,92646,89742,2904,3.1,135113,127860,7253,5.4
Lafayette,1/1/1997,92043,88372,3671,4,135456,128298,7158,5.3
Lafayette,2/1/1997,91995,88821,3174,3.5,135400,128298,7102,5.2
Lafayette,3/1/1997,93443,90095,3348,3.6,135891,128891,7000,5.2
Lafayette,4/1/1997,94230,91096,3134,3.3,136016,129143,6873,5.1
Lafayette,5/1/1997,94694,91333,3361,3.5,136119,129464,6655,4.9
Lafayette,6/1/1997,95650,91460,4190,4.4,136211,129412,6799,5
Lafayette,7/1/1997,96819,93049,3770,3.9,136477,129822,6655,4.9
Lafayette,8/1/1997,96524,92990,3534,3.7,136618,130010,6608,4.8
Lafayette,9/1/1997,95293,91793,3500,3.7,136675,130019,6656,4.9
Lafayette,10/1/1997,96349,92610,3739,3.9,136633,130179,6454,4.7
Lafayette,11/1/1997,95739,92437,3302,3.4,136961,130653,6308,4.6
Lafayette,12/1/1997,95615,92582,3033,3.2,137155,130679,6476,4.7
Lafayette,1/1/1998,94481,90828,3653,3.9,137095,130726,6368,4.6
Lafayette,2/1/1998,94763,91573,3190,3.4,137112,130807,6306,4.6
Lafayette,3/1/1998,96149,92431,3718,3.9,137236,130814,6422,4.7
Lafayette,4/1/1998,97346,93695,3651,3.8,137150,131209,5941,4.3
Lafayette,5/1/1998,97705,93773,3932,4,137372,131325,6047,4.4
Lafayette,6/1/1998,98717,94225,4492,4.6,137455,131244,6212,4.5
Lafayette,7/1/1998,99284,95245,4039,4.1,137588,131329,6259,4.5
Lafayette,8/1/1998,99305,95082,4223,4.3,137570,131390,6179,4.5
Lafayette,9/1/1998,97924,93872,4052,4.1,138286,131986,6300,4.6
Lafayette,10/1/1998,96915,93104,3811,3.9,138279,131999,6280,4.5
Lafayette,11/1/1998,96531,93119,3412,3.5,138381,132280,6100,4.4
Lafayette,12/1/1998,95886,92580,3306,3.4,138634,132602,6032,4.4
Lafayette,1/1/1999,94129,90074,4055,4.3,139003,133027,5976,4.3
Lafayette,2/1/1999,94295,90494,3801,4,138967,132856,6111,4.4
Lafayette,3/1/1999,94791,90896,3895,4.1,138730,132947,5783,4.2
Lafayette,4/1/1999,95263,91448,3815,4,138959,132955,6004,4.3
Lafayette,5/1/1999,94956,91176,3780,4,139107,133311,5796,4.2
Lafayette,6/1/1999,96153,91513,4640,4.8,139329,133378,5951,4.3
Lafayette,7/1/1999,96071,91764,4307,4.5,139439,133414,6025,4.3
Lafayette,8/1/1999,95678,91597,4081,4.3,139430,133591,5838,4.2
Lafayette,9/1/1999,94959,90958,4001,4.2,139622,133707,5915,4.2
Lafayette,10/1/1999,95021,91412,3609,3.8,139771,133993,5778,4.1
Lafayette,11/1/1999,94836,91572,3264,3.4,140025,134309,5716,4.1
Lafayette,12/1/1999,94145,91251,2894,3.1,140177,134523,5653,4
Lafayette,1/1/2000,94089,90300,3789,4,142267,136559,5708,4
Lafayette,2/1/2000,94848,91470,3378,3.6,142456,136598,5858,4.1
Lafayette,3/1/2000,95246,91582,3664,3.8,142434,136701,5733,4
Lafayette,4/1/2000,96469,93123,3346,3.5,142751,137270,5481,3.8
Lafayette,5/1/2000,96194,92403,3791,3.9,142388,136630,5758,4
Lafayette,6/1/2000,97166,92536,4630,4.8,142591,136940,5651,4
Lafayette,7/1/2000,97836,93516,4320,4.4,142278,136531,5747,4
Lafayette,8/1/2000,98604,94396,4208,4.3,142514,136662,5853,4.1
Lafayette,9/1/2000,97428,93375,4053,4.2,142518,136893,5625,3.9
Lafayette,10/1/2000,98549,94651,3898,4,142622,137088,5534,3.9
Lafayette,11/1/2000,98313,94623,3690,3.8,142962,137322,5639,3.9
Lafayette,12/1/2000,99005,95615,3390,3.4,143248,137614,5634,3.9
Lafayette,1/1/2001,98246,93996,4250,4.3,143800,137778,6023,4.2
Lafayette,2/1/2001,98486,94797,3689,3.7,143701,137612,6089,4.2
Lafayette,3/1/2001,99310,95498,3812,3.8,143924,137783,6141,4.3
Lafayette,4/1/2001,99113,95304,3809,3.8,143569,137299,6271,4.4
Lafayette,5/1/2001,98783,95003,3780,3.8,143318,137092,6226,4.3
Lafayette,6/1/2001,99976,95267,4709,4.7,143357,136873,6484,4.5
Lafayette,7/1/2001,100714,96549,4165,4.1,143654,137071,6583,4.6
Lafayette,8/1/2001,100808,96739,4069,4,143284,136241,7042,4.9
Lafayette,9/1/2001,100151,95840,4311,4.3,143989,136846,7142,5
Lafayette,10/1/2001,100397,96092,4305,4.3,144086,136392,7694,5.3
Lafayette,11/1/2001,99723,95506,4217,4.2,144240,136238,8003,5.5
Lafayette,12/1/2001,99744,95633,4111,4.1,144305,136047,8258,5.7
Lafayette,1/1/2002,96942,92403,4539,4.7,143883,135701,8182,5.7
Lafayette,2/1/2002,97636,93647,3989,4.1,144653,136438,8215,5.7
Lafayette,3/1/2002,97637,93476,4161,4.3,144481,136177,8304,5.7
Lafayette,4/1/2002,99231,95014,4217,4.2,144725,136126,8599,5.9
Lafayette,5/1/2002,98674,94305,4369,4.4,144938,136539,8399,5.8
Lafayette,6/1/2002,99549,94424,5125,5.1,144808,136415,8393,5.8
Lafayette,7/1/2002,99761,95062,4699,4.7,144803,136413,8390,5.8
Lafayette,8/1/2002,100171,95596,4575,4.6,145009,136705,8304,5.7
Lafayette,9/1/2002,99381,94723,4658,4.7,145552,137302,8251,5.7
Lafayette,10/1/2002,98855,94549,4306,4.4,145314,137008,8307,5.7
Lafayette,11/1/2002,98504,94113,4391,4.5,145041,136521,8520,5.9
Lafayette,12/1/2002,98145,93819,4326,4.4,145066,136426,8640,6
Lafayette,1/1/2003,97206,92448,4758,4.9,145937,137417,8520,5.8
Lafayette,2/1/2003,97820,93561,4259,4.4,146100,137482,8618,5.9
Lafayette,3/1/2003,98163,93706,4457,4.5,146022,137434,8588,5.9
Lafayette,4/1/2003,98446,94134,4312,4.4,146474,137633,8842,6
Lafayette,5/1/2003,97193,92612,4581,4.7,146500,137544,8957,6.1
Lafayette,6/1/2003,99472,93498,5974,6,147056,137790,9266,6.3
Lafayette,7/1/2003,99379,94016,5363,5.4,146485,137474,9011,6.2
Lafayette,8/1/2003,98851,93840,5011,5.1,146445,137549,8896,6.1
Lafayette,9/1/2003,98025,93243,4782,4.9,146530,137609,8921,6.1
Lafayette,10/1/2003,98156,93826,4330,4.4,146716,137984,8732,6
Lafayette,11/1/2003,97925,93788,4137,4.2,147000,138424,8576,5.8
Lafayette,12/1/2003,98631,94616,4015,4.1,146729,138411,8317,5.7
Lafayette,1/1/2004,96360,91658,4702,4.9,146842,138472,8370,5.7
Lafayette,2/1/2004,96682,92582,4100,4.2,146709,138542,8167,5.6
Lafayette,3/1/2004,97174,92911,4263,4.4,146944,138453,8491,5.8
Lafayette,4/1/2004,97585,93669,3916,4,146850,138680,8170,5.6
Lafayette,5/1/2004,97613,93476,4137,4.2,147065,138852,8212,5.6
Lafayette,6/1/2004,99375,94346,5029,5.1,147460,139174,8286,5.6
Lafayette,7/1/2004,99379,94806,4573,4.6,147692,139556,8136,5.5
Lafayette,8/1/2004,98835,94871,3964,4,147564,139573,7990,5.4
Lafayette,9/1/2004,98246,94146,4100,4.2,147415,139487,7927,5.4
Lafayette,10/1/2004,99976,96040,3936,3.9,147793,139732,8061,5.5
Lafayette,11/1/2004,100054,96079,3975,4,148162,140231,7932,5.4
Lafayette,12/1/2004,100229,96312,3917,3.9,148059,140125,7934,5.4
Lafayette,1/1/2005,99466,95134,4332,4.4,148029,140245,7784,5.3
Lafayette,2/1/2005,99977,96004,3973,4,148364,140385,7980,5.4
Lafayette,3/1/2005,99888,96054,3834,3.8,148391,140654,7737,5.2
Lafayette,4/1/2005,100141,96422,3719,3.7,148926,141254,7672,5.2
Lafayette,5/1/2005,99856,95676,4180,4.2,149261,141609,7651,5.1
Lafayette,6/1/2005,100846,95952,4894,4.9,149238,141714,7524,5
Lafayette,7/1/2005,102015,97671,4344,4.3,149432,142026,7406,5
Lafayette,8/1/2005,101772,97714,4058,4,149779,142434,7345,4.9
Lafayette,9/1/2005,114106,104273,9833,8.6,149954,142401,7553,5
Lafayette,10/1/2005,116002,106919,9083,7.8,150001,142548,7453,5
Lafayette,11/1/2005,115617,106463,9154,7.9,150065,142499,7566,5
Lafayette,12/1/2005,110422,105954,4468,4,150030,142752,7279,4.9
Lafayette,1/1/2006,108297,104563,3734,3.4,150214,143150,7064,4.7
Lafayette,2/1/2006,107724,104797,2927,2.7,150641,143457,7184,4.8
Lafayette,3/1/2006,108076,105078,2998,2.8,150813,143741,7072,4.7
Lafayette,4/1/2006,108171,105284,2887,2.7,150881,143761,7120,4.7
Lafayette,5/1/2006,108853,105635,3218,3,151069,144089,6980,4.6
Lafayette,6/1/2006,110229,106361,3868,3.5,151354,144353,7001,4.6
Lafayette,7/1/2006,110811,107603,3208,2.9,151377,144202,7175,4.7
Lafayette,8/1/2006,109536,106326,3210,2.9,151716,144625,7091,4.7
Lafayette,9/1/2006,109257,106075,3182,2.9,151662,144815,6847,4.5
Lafayette,10/1/2006,109328,106224,3104,2.8,152041,145314,6727,4.4
Lafayette,11/1/2006,109644,106507,3137,2.9,152406,145534,6872,4.5
Lafayette,12/1/2006,109137,106347,2790,2.6,152732,145970,6762,4.4
Lafayette,1/1/2007,108453,105075,3378,3.1,153144,146028,7116,4.6
Lafayette,2/1/2007,108218,105330,2888,2.7,152983,146057,6927,4.5
Lafayette,3/1/2007,109373,106368,3005,2.7,153051,146320,6731,4.4
Lafayette,4/1/2007,109647,106788,2859,2.6,152435,145586,6850,4.5
Lafayette,5/1/2007,110062,106705,3357,3.1,152670,145903,6766,4.4
Lafayette,6/1/2007,111679,107740,3939,3.5,153041,146063,6979,4.6
Lafayette,7/1/2007,112820,109352,3468,3.1,153054,145905,7149,4.7
Lafayette,8/1/2007,111840,108690,3150,2.8,152749,145682,7067,4.6
Lafayette,9/1/2007,111133,107910,3223,2.9,153414,146244,7170,4.7
Lafayette,10/1/2007,110833,107992,2841,2.6,153183,145946,7237,4.7
Lafayette,11/1/2007,111708,108778,2930,2.6,153835,146595,7240,4.7
Lafayette,12/1/2007,111463,108498,2965,2.7,153918,146273,7645,5
Lafayette,1/1/2008,110341,106845,3496,3.2,154063,146378,7685,5
Lafayette,2/1/2008,110352,107466,2886,2.6,153653,146156,7497,4.9
Lafayette,3/1/2008,111231,108004,3227,2.9,153908,146086,7822,5.1
Lafayette,4/1/2008,112396,109573,2823,2.5,153769,146132,7637,5
Lafayette,5/1/2008,112637,109229,3408,3,154303,145908,8395,5.4
Lafayette,6/1/2008,114420,110140,4280,3.7,154313,145737,8575,5.6
Lafayette,7/1/2008,114472,110681,3791,3.3,154469,145532,8937,5.8
Lafayette,8/1/2008,113487,109495,3992,3.5,154641,145203,9438,6.1
Lafayette,9/1/2008,113184,109475,3709,3.3,154570,145076,9494,6.1
Lafayette,10/1/2008,114053,110036,4017,3.5,154876,144802,10074,6.5
Lafayette,11/1/2008,113955,110014,3941,3.5,154639,144100,10538,6.8
Lafayette,12/1/2008,113380,109352,4028,3.6,154655,143369,11286,7.3
Lafayette,1/1/2009,112041,107473,4568,4.1,154210,142152,12058,7.8
Lafayette,2/1/2009,112441,107845,4596,4.1,154538,141640,12898,8.3
Lafayette,3/1/2009,112654,107802,4852,4.3,154133,140707,13426,8.7
Lafayette,4/1/2009,112438,107426,5012,4.5,154509,140656,13853,9
Lafayette,5/1/2009,111884,106274,5610,5,154747,140248,14499,9.4
Lafayette,6/1/2009,113757,107021,6736,5.9,154716,140009,14707,9.5
Lafayette,7/1/2009,113387,107033,6354,5.6,154502,139901,14601,9.5
Lafayette,8/1/2009,111970,105666,6304,5.6,154307,139492,14814,9.6
Lafayette,9/1/2009,111403,105260,6143,5.5,153827,138818,15009,9.8
Lafayette,10/1/2009,114237,108256,5981,5.2,153784,138432,15352,10
Lafayette,11/1/2009,114745,109092,5653,4.9,153878,138659,15219,9.9
Lafayette,12/1/2009,113724,108016,5708,5,153111,138013,15098,9.9
Lafayette,1/1/2010,112165,105331,6834,6.1,153484,138438,15046,9.8
Lafayette,2/1/2010,112156,106065,6091,5.4,153694,138581,15113,9.8
Lafayette,3/1/2010,112912,106827,6085,5.4,153954,138751,15202,9.9
Lafayette,4/1/2010,113969,107926,6043,5.3,154622,139297,15325,9.9
Lafayette,5/1/2010,114062,107711,6351,5.6,154091,139241,14849,9.6
Lafayette,6/1/2010,115260,108038,7222,6.3,153616,139141,14474,9.4
Lafayette,7/1/2010,115284,108362,6922,6,153691,139179,14512,9.4
Lafayette,8/1/2010,114679,107513,7166,6.2,154086,139438,14648,9.5
Lafayette,9/1/2010,114328,107544,6784,5.9,153975,139396,14579,9.5
Lafayette,10/1/2010,114460,107610,6850,6,153635,139119,14516,9.4
Lafayette,11/1/2010,114425,107670,6755,5.9,154125,139044,15081,9.8
Lafayette,12/1/2010,113286,106980,6306,5.6,153650,139301,14348,9.3
Lafayette,1/1/2011,112854,105694,7160,6.3,153263,139250,14013,9.1
Lafayette,2/1/2011,113126,106687,6439,5.7,153214,139394,13820,9
Lafayette,3/1/2011,113934,107628,6306,5.5,153376,139639,13737,9
Lafayette,4/1/2011,114022,108029,5993,5.3,153543,139586,13957,9.1
Lafayette,5/1/2011,113995,107596,6399,5.6,153479,139624,13855,9
Lafayette,6/1/2011,115088,108016,7072,6.1,153346,139384,13962,9.1
Lafayette,7/1/2011,115588,108831,6757,5.8,153288,139524,13763,9
Lafayette,8/1/2011,114921,108465,6456,5.6,153760,139942,13818,9
Lafayette,9/1/2011,115216,108902,6314,5.5,154131,140183,13948,9
Lafayette,10/1/2011,115872,109672,6200,5.4,153961,140368,13594,8.8
Lafayette,11/1/2011,115881,110054,5827,5,154128,140826,13302,8.6
Lafayette,12/1/2011,114706,109193,5513,4.8,153995,140902,13093,8.5
Lafayette,1/1/2012,115057,108863,6194,5.4,154381,141584,12797,8.3
Lafayette,2/1/2012,116024,110257,5767,5,154671,141858,12813,8.3
Lafayette,3/1/2012,117206,111592,5614,4.8,154749,142036,12713,8.2
Lafayette,4/1/2012,118001,112749,5252,4.5,154545,141899,12646,8.2
Lafayette,5/1/2012,118475,112623,5852,4.9,154866,142206,12660,8.2
Lafayette,6/1/2012,120079,113380,6699,5.6,155083,142391,12692,8.2
Lafayette,7/1/2012,118411,112209,6202,5.2,154948,142292,12656,8.2
Lafayette,8/1/2012,116833,111225,5608,4.8,154763,142291,12471,8.1
Lafayette,9/1/2012,116849,111818,5031,4.3,155160,143044,12115,7.8
Lafayette,10/1/2012,117757,112669,5088,4.3,155554,143431,12124,7.8
Lafayette,11/1/2012,117299,112609,4690,4,155338,143333,12005,7.7
Lafayette,12/1/2012,116827,111766,5061,4.3,155628,143330,12298,7.9
Lafayette,1/1/2013,117136,110749,6387,5.5,155763,143292,12471,8
Lafayette,2/1/2013,117249,111857,5392,4.6,155312,143362,11950,7.7
Lafayette,3/1/2013,118211,112923,5288,4.5,155005,143316,11689,7.5
Lafayette,4/1/2013,119311,113984,5327,4.5,155394,143635,11760,7.6
Lafayette,5/1/2013,119609,113629,5980,5,155536,143882,11654,7.5
Lafayette,6/1/2013,121338,114518,6820,5.6,155749,143999,11751,7.5
Lafayette,7/1/2013,120732,114471,6261,5.2,155599,144264,11335,7.3
Lafayette,8/1/2013,119307,113443,5864,4.9,155605,144326,11279,7.2
Lafayette,9/1/2013,119163,113719,5444,4.6,155687,144418,11270,7.2
Lafayette,10/1/2013,118835,113513,5322,4.5,154673,143537,11136,7.2
Lafayette,11/1/2013,119101,114192,4909,4.1,155265,144479,10787,6.9
Lafayette,12/1/2013,118139,113797,4342,3.7,155182,144778,10404,6.7
Lafayette,1/1/2014,118882,113766,5116,4.3,155352,145150,10202,6.6
Lafayette,2/1/2014,119181,114453,4728,4,155483,145134,10349,6.7
Lafayette,3/1/2014,120664,115567,5097,4.2,156028,145648,10380,6.7
Lafayette,4/1/2014,121416,116655,4761,3.9,155369,145667,9702,6.2
Lafayette,5/1/2014,121841,116158,5683,4.7,155684,145825,9859,6.3
Lafayette,6/1/2014,122554,116187,6367,5.2,155707,146247,9460,6.1
Lafayette,7/1/2014,123496,116643,6853,5.5,156007,146399,9608,6.2
Lafayette,8/1/2014,122869,116112,6757,5.5,156130,146530,9599,6.1
Lafayette,9/1/2014,122444,116054,6390,5.2,156040,146778,9262,5.9
Lafayette,10/1/2014,123626,117260,6366,5.1,156417,147427,8990,5.7
Lafayette,11/1/2014,123106,116654,6452,5.2,156494,147404,9090,5.8
Lafayette,12/1/2014,121876,116073,5803,4.8,156332,147615,8717,5.6
Lafayette,1/1/2015,121731,115009,6722,5.5,157030,148145,8885,5.7
Lafayette,2/1/2015,120719,114303,6416,5.3,156644,148045,8599,5.5
Lafayette,3/1/2015,121437,114864,6573,5.4,156643,148128,8515,5.4
Lafayette,4/1/2015,121021,114502,6519,5.4,157060,148511,8550,5.4
Lafayette,5/1/2015,121031,113938,7093,5.9,157651,148817,8834,5.6
Lafayette,6/1/2015,120691,113249,7442,6.2,157062,148816,8247,5.3
Lafayette,7/1/2015,119803,112595,7208,6,156997,148830,8167,5.2
Lafayette,8/1/2015,118508,111760,6748,5.7,157172,149181,7992,5.1
Lafayette,9/1/2015,117537,110835,6702,5.7,156733,148826,7907,5
Lafayette,10/1/2015,118113,111412,6701,5.7,157167,149246,7922,5
Lafayette,11/1/2015,117198,110778,6420,5.5,157463,149463,8000,5.1
Lafayette,12/1/2015,116074,110082,5992,5.2,158035,150128,7907,5
Lafayette,1/1/2016,115300,108266,7034,6.1,158280,150653,7627,4.8
Lafayette,2/1/2016,115209,108525,6684,5.8,158640,150939,7702,4.9
Lafayette,3/1/2016,116080,109062,7018,6,159179,151218,7961,5
Lafayette,4/1/2016,115169,108336,6833,5.9,159141,151074,8067,5.1
Lafayette,5/1/2016,114671,107698,6973,6.1,158784,151132,7652,4.8
Lafayette,6/1/2016,115345,107303,8042,7,158967,151223,7744,4.9
Lafayette,7/1/2016,115296,107548,7748,6.7,159194,151554,7641,4.8
Lafayette,8/1/2016,113382,106042,7340,6.5,159562,151779,7784,4.9
Lafayette,9/1/2016,113329,105979,7350,6.5,159714,151761,7953,5
Lafayette,10/1/2016,113188,106516,6672,5.9,159605,151793,7811,4.9
Lafayette,11/1/2016,112750,106577,6173,5.5,159506,151954,7553,4.7
Lafayette,12/1/2016,112075,106188,5887,5.3,159678,152157,7521,4.7
Lafayette,1/1/2017,111568,104943,6625,5.9,159620,152152,7468,4.7
Lafayette,2/1/2017,112462,106355,6107,5.4,159859,152480,7379,4.6
Lafayette,3/1/2017,113369,107509,5860,5.2,160137,153065,7073,4.4
Lafayette,4/1/2017,113536,107931,5605,4.9,160345,153255,7089,4.4
Lafayette,5/1/2017,112714,107188,5526,4.9,160068,153069,7000,4.4
Lafayette,6/1/2017,113696,107598,6098,5.4,160192,153318,6873,4.3
Lafayette,7/1/2017,114554,108633,5921,5.2,160462,153569,6892,4.3
Lafayette,8/1/2017,113410,107724,5686,5,160586,153503,7082,4.4
Lafayette,9/1/2017,113552,108296,5256,4.6,161140,154286,6854,4.3
Lafayette,10/1/2017,112581,107978,4603,4.1,160309,153609,6700,4.2
Lafayette,11/1/2017,112557,107981,4576,4.1,160579,153805,6774,4.2
Lafayette,12/1/2017,111745,107423,4322,3.9,160535,153904,6632,4.1
Lafayette,1/1/2018,111875,106927,4948,4.4,160914,154425,6489,4
Lafayette,2/1/2018,112911,108173,4738,4.2,161778,155197,6581,4.1
Lafayette,3/1/2018,113934,108996,4938,4.3,161686,155214,6472,4
Lafayette,4/1/2018,114500,109714,4786,4.2,161771,155312,6459,4
Lafayette,5/1/2018,114055,109051,5004,4.4,161848,155652,6196,3.8
Lafayette,6/1/2018,115397,109113,6284,5.4,162210,155762,6447,4
Lafayette,7/1/2018,115977,110156,5821,5,162341,156146,6195,3.8
Lafayette,8/1/2018,113654,108353,5301,4.7,161660,155504,6156,3.8
Lafayette,9/1/2018,113331,108397,4934,4.4,162087,156015,6073,3.7
Lafayette,10/1/2018,114152,109408,4744,4.2,162602,156391,6211,3.8
Lafayette,11/1/2018,113827,109403,4424,3.9,162836,156721,6115,3.8
Lafayette,12/1/2018,113269,108901,4368,3.9,163206,156817,6389,3.9
Lafayette,1/1/2019,112979,107792,5187,4.6,162963,156487,6475,4
Lafayette,2/1/2019,113255,108832,4423,3.9,162999,156863,6136,3.8
Lafayette,3/1/2019,113889,109757,4132,3.6,162904,156701,6202,3.8
Lafayette,4/1/2019,114299,110415,3884,3.4,162586,156625,5961,3.7
Lafayette,5/1/2019,114318,109803,4515,3.9,162751,156821,5930,3.6
Lafayette,6/1/2019,116132,110559,5573,4.8,163168,157232,5935,3.6
Lafayette,7/1/2019,116438,111009,5429,4.7,163590,157529,6061,3.7
Lafayette,8/1/2019,114870,109803,5067,4.4,163774,157829,5945,3.6
Lafayette,9/1/2019,114924,110055,4869,4.2,164092,158339,5753,3.5
Lafayette,10/1/2019,115667,110759,4908,4.2,164416,158545,5871,3.6
Lafayette,11/1/2019,115442,110689,4753,4.1,164496,158629,5868,3.6
Lafayette,12/1/2019,114132,109689,4443,3.9,164699,158845,5853,3.6
Lafayette,1/1/2020,114324,109305,5019,4.4,164377,158508,5869,3.6
Lafayette,2/1/2020,113748,109712,4036,3.5,164467,158714,5753,3.5
Lafayette,3/1/2020,115461,108367,7094,6.1,162559,155353,7206,4.4
Lafayette,4/1/2020,109401,96848,12553,11.5,156269,133185,23084,14.8
Lafayette,5/1/2020,111608,99407,12201,10.9,158101,137173,20929,13.2
Lafayette,6/1/2020,113977,102692,11285,9.9,159994,142342,17652,11
Lafayette,7/1/2020,115120,104203,10917,9.5,160132,143779,16352,10.2
Lafayette,8/1/2020,113305,104707,8598,7.6,160706,147245,13461,8.4
Lafayette,9/1/2020,113364,104652,8712,7.7,160174,147620,12554,7.8
Lafayette,10/1/2020,113958,106401,7557,6.6,161003,149931,11072,6.9
Lafayette,11/1/2020,113523,106930,6593,5.8,160629,149934,10694,6.7
Lafayette,12/1/2020,113182,106582,6600,5.8,160745,149975,10770,6.7
Lafayette,1/1/2021,111950,105110,6840,6.1,160088,149852,10236,6.4
Lafayette,2/1/2021,112610,106230,6380,5.7,160184,150189,9995,6.2
Lafayette,3/1/2021,113722,107713,6009,5.3,160400,150644,9756,6.1
Lafayette,4/1/2021,114084,108256,5828,5.1,160843,151081,9762,6.1
Lafayette,5/1/2021,114199,108381,5818,5.1,160800,151535,9266,5.8
Lafayette,6/1/2021,115876,109194,6682,5.8,161197,151734,9462,5.9
Lafayette,7/1/2021,116571,110744,5827,5,161504,152773,8731,5.4
Lafayette,8/1/2021,114693,109578,5115,4.5,161527,153250,8276,5.1
Lafayette,9/1/2021,115584,111029,4555,3.9,161495,153843,7652,4.7
Lafayette,10/1/2021,114509,110497,4012,3.5,161754,154475,7279,4.5
Lafayette,11/1/2021,114846,111257,3589,3.1,162281,155530,6751,4.2
Lafayette,12/1/2021,114134,110910,3224,2.8,162497,156099,6398,3.9
Lafayette,1/1/2022,113599,109585,4014,3.5,163627,157115,6512,4
Lafayette,2/1/2022,113988,110404,3584,3.1,163899,157598,6301,3.8
Lafayette,3/1/2022,115622,112126,3496,3,164220,158206,6014,3.7
Lafayette,4/1/2022,115179,111939,3240,2.8,163893,157891,6002,3.7
Lafayette,5/1/2022,115345,111865,3480,3,164362,158378,5983,3.6
Lafayette,6/1/2022,116513,111938,4575,3.9,164046,158094,5951,3.6
Lafayette,7/1/2022,116731,112613,4118,3.5,164026,158258,5768,3.5
Lafayette,8/1/2022,115677,111791,3886,3.4,164654,158735,5919,3.6
Lafayette,9/1/2022,115369,111777,3592,3.1,164602,158810,5792,3.5
Lafayette,10/1/2022,115719,112351,3368,2.9,164648,158684,5964,3.6
Lafayette,11/1/2022,115740,112532,3208,2.8,164450,158507,5943,3.6
Lafayette,12/1/2022,115349,112132,3217,2.8,165025,159259,5766,3.5
Lafayette,1/1/2023,114388,110675,3713,3.2,165964,160217,5747,3.5
Lafayette,2/1/2023,114905,111379,3526,3.1,166358,160395,5962,3.6
Lafayette,3/1/2023,115795,112490,3305,2.9,166651,160812,5839,3.5
Lafayette,4/1/2023,115893,112841,3052,2.6,166725,160974,5751,3.4
Lafayette,5/1/2023,115798,112157,3641,3.1,166886,160796,6089,3.6
Lafayette,6/1/2023,116801,112563,4238,3.6,166937,160979,5958,3.6
Lafayette,7/1/2023,116579,113000,3579,3.1,167103,161183,5920,3.5
Lafayette,8/1/2023,116095,112250,3845,3.3,167759,161475,6284,3.7
Lafayette,9/1/2023,116333,112237,4096,3.5,167767,161442,6326,3.8
Lafayette,10/1/2023,116528,112420,4108,3.5,167690,161211,6479,3.9
Lafayette,11/1/2023,116586,112758,3828,3.3,168140,161886,6254,3.7
Lafayette,12/1/2023,115434,111490,3944,3.4,167439,161124,6315,3.8
Lafayette,1/1/2024,115501,111036,4465,3.9,167339,161190,6149,3.7
Lafayette,2/1/2024,115988,111642,4346,3.7,167475,161013,6462,3.9
Lafayette,3/1/2024,117069,112801,4268,3.6,167922,161425,6497,3.9
Lafayette,4/1/2024,116970,113229,3741,3.2,167988,161495,6492,3.9
Lafayette,5/1/2024,116317,112362,3955,3.4,167799,161164,6635,4
Lafayette,6/1/2024,117441,112425,5016,4.3,168005,161155,6849,4.1
Lafayette,7/1/2024,118268,113367,4901,4.1,168315,161219,7097,4.2
Lafayette,8/1/2024,116985,112133,4852,4.1,168496,161425,7071,4.2
Lafayette,9/1/2024,116401,111613,4788,4.1,168703,161802,6901,4.1
Lafayette,10/1/2024,116538,111733,4805,4.1,168428,161456,6972,4.1
Lafayette,11/1/2024,116726,112092,4634,4,168304,161183,7121,4.2
Lafayette,12/1/2024,115953,111637,4316,3.7,168547,161661,6886,4.1
Lafayette,1/1/2025,123866,119391,4475,3.6,170744,163895,6849,4
Lafayette,2/1/2025,124920,120611,4309,3.4,170359,163307,7052,4.1
Lafourche,1/1/1990,34995,33235,1760,5,125833,119081,6752,5.4
Lafourche,2/1/1990,35002,33442,1560,4.5,125710,119059,6651,5.3
Lafourche,3/1/1990,35330,33926,1404,4,125801,119203,6598,5.2
Lafourche,4/1/1990,35844,34473,1371,3.8,125649,118852,6797,5.4
Lafourche,5/1/1990,36117,34693,1424,3.9,125893,119151,6742,5.4
Lafourche,6/1/1990,37262,35556,1706,4.6,125573,118983,6590,5.2
Lafourche,7/1/1990,37569,36099,1470,3.9,125732,118810,6922,5.5
Lafourche,8/1/1990,37038,35515,1523,4.1,125990,118802,7188,5.7
Lafourche,9/1/1990,36417,34792,1625,4.5,125892,118524,7368,5.9
Lafourche,10/1/1990,37072,35549,1523,4.1,125995,118536,7459,5.9
Lafourche,11/1/1990,36897,35507,1390,3.8,126070,118306,7764,6.2
Lafourche,12/1/1990,36789,35410,1379,3.7,126142,118241,7901,6.3
Lafourche,1/1/1991,35975,34220,1755,4.9,125955,117940,8015,6.4
Lafourche,2/1/1991,36331,34619,1712,4.7,126020,117755,8265,6.6
Lafourche,3/1/1991,36513,34995,1518,4.2,126238,117652,8586,6.8
Lafourche,4/1/1991,36849,35235,1614,4.4,126548,118109,8439,6.7
Lafourche,5/1/1991,36763,35135,1628,4.4,126176,117440,8736,6.9
Lafourche,6/1/1991,37926,35875,2051,5.4,126331,117639,8692,6.9
Lafourche,7/1/1991,37971,36081,1890,5,126154,117568,8586,6.8
Lafourche,8/1/1991,37669,35622,2047,5.4,126150,117484,8666,6.9
Lafourche,9/1/1991,37144,35333,1811,4.9,126650,117928,8722,6.9
Lafourche,10/1/1991,37175,35469,1706,4.6,126642,117800,8842,7
Lafourche,11/1/1991,36875,35409,1466,4,126701,117770,8931,7
Lafourche,12/1/1991,36433,34841,1592,4.4,126664,117466,9198,7.3
Lafourche,1/1/1992,35882,33628,2254,6.3,127261,117978,9283,7.3
Lafourche,2/1/1992,35663,33620,2043,5.7,127207,117753,9454,7.4
Lafourche,3/1/1992,35987,33872,2115,5.9,127604,118144,9460,7.4
Lafourche,4/1/1992,36041,33916,2125,5.9,127841,118426,9415,7.4
Lafourche,5/1/1992,35817,33694,2123,5.9,128119,118375,9744,7.6
Lafourche,6/1/1992,36251,33808,2443,6.7,128459,118419,10040,7.8
Lafourche,7/1/1992,37822,35365,2457,6.5,128563,118713,9850,7.7
Lafourche,8/1/1992,36996,34498,2498,6.8,128613,118826,9787,7.6
Lafourche,9/1/1992,36674,34227,2447,6.7,128501,118720,9781,7.6
Lafourche,10/1/1992,36726,34659,2067,5.6,128026,118628,9398,7.3
Lafourche,11/1/1992,36847,34799,2048,5.6,128441,118876,9565,7.4
Lafourche,12/1/1992,36090,34060,2030,5.6,128554,118997,9557,7.4
Lafourche,1/1/1993,35939,33320,2619,7.3,128400,119075,9325,7.3
Lafourche,2/1/1993,35741,33427,2314,6.5,128458,119275,9183,7.1
Lafourche,3/1/1993,35820,33645,2175,6.1,128598,119542,9056,7
Lafourche,4/1/1993,35716,33584,2132,6,128584,119474,9110,7.1
Lafourche,5/1/1993,36106,33888,2218,6.1,129264,120115,9149,7.1
Lafourche,6/1/1993,37001,34522,2479,6.7,129411,120290,9121,7
Lafourche,7/1/1993,37344,35028,2316,6.2,129397,120467,8930,6.9
Lafourche,8/1/1993,36935,34733,2202,6,129619,120856,8763,6.8
Lafourche,9/1/1993,36463,34394,2069,5.7,129268,120554,8714,6.7
Lafourche,10/1/1993,36810,34947,1863,5.1,129573,120823,8750,6.8
Lafourche,11/1/1993,36932,35227,1705,4.6,129711,121169,8542,6.6
Lafourche,12/1/1993,37059,35331,1728,4.7,129941,121464,8477,6.5
Lafourche,1/1/1994,36772,34306,2466,6.7,130596,121966,8630,6.6
Lafourche,2/1/1994,36533,34356,2177,6,130669,122086,8583,6.6
Lafourche,3/1/1994,36778,34719,2059,5.6,130400,121930,8470,6.5
Lafourche,4/1/1994,37078,34905,2173,5.9,130621,122290,8331,6.4
Lafourche,5/1/1994,37216,35169,2047,5.5,130779,122864,7915,6.1
Lafourche,6/1/1994,38023,35459,2564,6.7,130561,122634,7927,6.1
Lafourche,7/1/1994,38431,36065,2366,6.2,130652,122706,7946,6.1
Lafourche,8/1/1994,38308,36080,2228,5.8,131275,123342,7933,6
Lafourche,9/1/1994,37795,35711,2084,5.5,131421,123687,7734,5.9
Lafourche,10/1/1994,38007,36087,1920,5.1,131744,124112,7632,5.8
Lafourche,11/1/1994,37910,36241,1669,4.4,131891,124516,7375,5.6
Lafourche,12/1/1994,37472,35971,1501,4,131951,124721,7230,5.5
Lafourche,1/1/1995,37269,35097,2172,5.8,132038,124663,7375,5.6
Lafourche,2/1/1995,36890,35174,1716,4.7,132115,124928,7187,5.4
Lafourche,3/1/1995,37128,35365,1763,4.7,132108,124955,7153,5.4
Lafourche,4/1/1995,37435,35545,1890,5,132590,124945,7645,5.8
Lafourche,5/1/1995,37745,35865,1880,5,131851,124421,7430,5.6
Lafourche,6/1/1995,38255,36236,2019,5.3,131949,124522,7427,5.6
Lafourche,7/1/1995,38409,36613,1796,4.7,132343,124816,7527,5.7
Lafourche,8/1/1995,38033,36402,1631,4.3,132336,124852,7484,5.7
Lafourche,9/1/1995,37878,36181,1697,4.5,132611,125133,7478,5.6
Lafourche,10/1/1995,37770,36229,1541,4.1,132716,125388,7328,5.5
Lafourche,11/1/1995,37630,36253,1377,3.7,132614,125188,7426,5.6
Lafourche,12/1/1995,37603,36193,1410,3.7,132511,125088,7423,5.6
Lafourche,1/1/1996,37396,35417,1979,5.3,132616,125125,7491,5.6
Lafourche,2/1/1996,37345,35764,1581,4.2,132952,125639,7313,5.5
Lafourche,3/1/1996,37777,36318,1459,3.9,133180,125862,7318,5.5
Lafourche,4/1/1996,37848,36423,1425,3.8,133409,125994,7415,5.6
Lafourche,5/1/1996,38446,36807,1639,4.3,133667,126244,7423,5.6
Lafourche,6/1/1996,39117,37315,1802,4.6,133697,126602,7095,5.3
Lafourche,7/1/1996,39965,38297,1668,4.2,134284,126947,7337,5.5
Lafourche,8/1/1996,39764,38355,1409,3.5,134054,127172,6882,5.1
Lafourche,9/1/1996,39731,38302,1429,3.6,134515,127536,6979,5.2
Lafourche,10/1/1996,39628,38315,1313,3.3,134921,127890,7031,5.2
Lafourche,11/1/1996,39640,38449,1191,3,135007,127771,7236,5.4
Lafourche,12/1/1996,39722,38548,1174,3,135113,127860,7253,5.4
Lafourche,1/1/1997,39043,37491,1552,4,135456,128298,7158,5.3
Lafourche,2/1/1997,39021,37832,1189,3,135400,128298,7102,5.2
Lafourche,3/1/1997,39385,38271,1114,2.8,135891,128891,7000,5.2
Lafourche,4/1/1997,40040,39000,1040,2.6,136016,129143,6873,5.1
Lafourche,5/1/1997,40305,39122,1183,2.9,136119,129464,6655,4.9
Lafourche,6/1/1997,40993,39460,1533,3.7,136211,129412,6799,5
Lafourche,7/1/1997,42395,40935,1460,3.4,136477,129822,6655,4.9
Lafourche,8/1/1997,42073,40762,1311,3.1,136618,130010,6608,4.8
Lafourche,9/1/1997,41967,40611,1356,3.2,136675,130019,6656,4.9
Lafourche,10/1/1997,42229,41061,1168,2.8,136633,130179,6454,4.7
Lafourche,11/1/1997,42460,41488,972,2.3,136961,130653,6308,4.6
Lafourche,12/1/1997,42374,41433,941,2.2,137155,130679,6476,4.7
Lafourche,1/1/1998,41747,40557,1190,2.9,137095,130726,6368,4.6
Lafourche,2/1/1998,41668,40729,939,2.3,137112,130807,6306,4.6
Lafourche,3/1/1998,41947,40884,1063,2.5,137236,130814,6422,4.7
Lafourche,4/1/1998,42378,41336,1042,2.5,137150,131209,5941,4.3
Lafourche,5/1/1998,42695,41497,1198,2.8,137372,131325,6047,4.4
Lafourche,6/1/1998,43613,42081,1532,3.5,137455,131244,6212,4.5
Lafourche,7/1/1998,43873,42513,1360,3.1,137588,131329,6259,4.5
Lafourche,8/1/1998,43230,41823,1407,3.3,137570,131390,6179,4.5
Lafourche,9/1/1998,42807,41285,1522,3.6,138286,131986,6300,4.6
Lafourche,10/1/1998,42403,41020,1383,3.3,138279,131999,6280,4.5
Lafourche,11/1/1998,42299,41035,1264,3,138381,132280,6100,4.4
Lafourche,12/1/1998,42279,41024,1255,3,138634,132602,6032,4.4
Lafourche,1/1/1999,41601,39982,1619,3.9,139003,133027,5976,4.3
Lafourche,2/1/1999,41332,39880,1452,3.5,138967,132856,6111,4.4
Lafourche,3/1/1999,41308,39889,1419,3.4,138730,132947,5783,4.2
Lafourche,4/1/1999,40815,39476,1339,3.3,138959,132955,6004,4.3
Lafourche,5/1/1999,40736,39342,1394,3.4,139107,133311,5796,4.2
Lafourche,6/1/1999,41836,39965,1871,4.5,139329,133378,5951,4.3
Lafourche,7/1/1999,41825,40083,1742,4.2,139439,133414,6025,4.3
Lafourche,8/1/1999,41408,39841,1567,3.8,139430,133591,5838,4.2
Lafourche,9/1/1999,41153,39600,1553,3.8,139622,133707,5915,4.2
Lafourche,10/1/1999,41347,39931,1416,3.4,139771,133993,5778,4.1
Lafourche,11/1/1999,41229,40004,1225,3,140025,134309,5716,4.1
Lafourche,12/1/1999,40870,39717,1153,2.8,140177,134523,5653,4
Lafourche,1/1/2000,39729,38007,1722,4.3,142267,136559,5708,4
Lafourche,2/1/2000,39864,38306,1558,3.9,142456,136598,5858,4.1
Lafourche,3/1/2000,39976,38340,1636,4.1,142434,136701,5733,4
Lafourche,4/1/2000,40647,39141,1506,3.7,142751,137270,5481,3.8
Lafourche,5/1/2000,41022,39261,1761,4.3,142388,136630,5758,4
Lafourche,6/1/2000,41684,39547,2137,5.1,142591,136940,5651,4
Lafourche,7/1/2000,41682,39703,1979,4.7,142278,136531,5747,4
Lafourche,8/1/2000,41289,39316,1973,4.8,142514,136662,5853,4.1
Lafourche,9/1/2000,40942,39058,1884,4.6,142518,136893,5625,3.9
Lafourche,10/1/2000,41285,39469,1816,4.4,142622,137088,5534,3.9
Lafourche,11/1/2000,41305,39581,1724,4.2,142962,137322,5639,3.9
Lafourche,12/1/2000,41604,39956,1648,4,143248,137614,5634,3.9
Lafourche,1/1/2001,41391,39356,2035,4.9,143800,137778,6023,4.2
Lafourche,2/1/2001,41436,39746,1690,4.1,143701,137612,6089,4.2
Lafourche,3/1/2001,41772,40084,1688,4,143924,137783,6141,4.3
Lafourche,4/1/2001,41986,40293,1693,4,143569,137299,6271,4.4
Lafourche,5/1/2001,41787,40070,1717,4.1,143318,137092,6226,4.3
Lafourche,6/1/2001,42525,40368,2157,5.1,143357,136873,6484,4.5
Lafourche,7/1/2001,43246,41334,1912,4.4,143654,137071,6583,4.6
Lafourche,8/1/2001,42899,41064,1835,4.3,143284,136241,7042,4.9
Lafourche,9/1/2001,42550,40567,1983,4.7,143989,136846,7142,5
Lafourche,10/1/2001,42750,40831,1919,4.5,144086,136392,7694,5.3
Lafourche,11/1/2001,42123,40224,1899,4.5,144240,136238,8003,5.5
Lafourche,12/1/2001,41844,40019,1825,4.4,144305,136047,8258,5.7
Lafourche,1/1/2002,41694,39591,2103,5,143883,135701,8182,5.7
Lafourche,2/1/2002,41834,40007,1827,4.4,144653,136438,8215,5.7
Lafourche,3/1/2002,41873,40073,1800,4.3,144481,136177,8304,5.7
Lafourche,4/1/2002,42583,40790,1793,4.2,144725,136126,8599,5.9
Lafourche,5/1/2002,42655,40685,1970,4.6,144938,136539,8399,5.8
Lafourche,6/1/2002,43603,41229,2374,5.4,144808,136415,8393,5.8
Lafourche,7/1/2002,44292,42162,2130,4.8,144803,136413,8390,5.8
Lafourche,8/1/2002,44202,42180,2022,4.6,145009,136705,8304,5.7
Lafourche,9/1/2002,43737,41712,2025,4.6,145552,137302,8251,5.7
Lafourche,10/1/2002,43822,41934,1888,4.3,145314,137008,8307,5.7
Lafourche,11/1/2002,43609,41706,1903,4.4,145041,136521,8520,5.9
Lafourche,12/1/2002,43566,41723,1843,4.2,145066,136426,8640,6
Lafourche,1/1/2003,43522,41433,2089,4.8,145937,137417,8520,5.8
Lafourche,2/1/2003,43474,41610,1864,4.3,146100,137482,8618,5.9
Lafourche,3/1/2003,43761,41749,2012,4.6,146022,137434,8588,5.9
Lafourche,4/1/2003,43627,41732,1895,4.3,146474,137633,8842,6
Lafourche,5/1/2003,43621,41533,2088,4.8,146500,137544,8957,6.1
Lafourche,6/1/2003,44552,41832,2720,6.1,147056,137790,9266,6.3
Lafourche,7/1/2003,45010,42479,2531,5.6,146485,137474,9011,6.2
Lafourche,8/1/2003,44250,42033,2217,5,146445,137549,8896,6.1
Lafourche,9/1/2003,43651,41579,2072,4.7,146530,137609,8921,6.1
Lafourche,10/1/2003,43818,41986,1832,4.2,146716,137984,8732,6
Lafourche,11/1/2003,43411,41625,1786,4.1,147000,138424,8576,5.8
Lafourche,12/1/2003,43178,41389,1789,4.1,146729,138411,8317,5.7
Lafourche,1/1/2004,43182,41028,2154,5,146842,138472,8370,5.7
Lafourche,2/1/2004,43100,41234,1866,4.3,146709,138542,8167,5.6
Lafourche,3/1/2004,43214,41290,1924,4.5,146944,138453,8491,5.8
Lafourche,4/1/2004,43385,41539,1846,4.3,146850,138680,8170,5.6
Lafourche,5/1/2004,43270,41213,2057,4.8,147065,138852,8212,5.6
Lafourche,6/1/2004,44302,41754,2548,5.8,147460,139174,8286,5.6
Lafourche,7/1/2004,44967,42604,2363,5.3,147692,139556,8136,5.5
Lafourche,8/1/2004,44339,42251,2088,4.7,147564,139573,7990,5.4
Lafourche,9/1/2004,43840,41736,2104,4.8,147415,139487,7927,5.4
Lafourche,10/1/2004,43735,41722,2013,4.6,147793,139732,8061,5.5
Lafourche,11/1/2004,43678,41698,1980,4.5,148162,140231,7932,5.4
Lafourche,12/1/2004,43759,41851,1908,4.4,148059,140125,7934,5.4
Lafourche,1/1/2005,43372,41243,2129,4.9,148029,140245,7784,5.3
Lafourche,2/1/2005,43013,41136,1877,4.4,148364,140385,7980,5.4
Lafourche,3/1/2005,43333,41495,1838,4.2,148391,140654,7737,5.2
Lafourche,4/1/2005,44168,42382,1786,4,148926,141254,7672,5.2
Lafourche,5/1/2005,44015,42077,1938,4.4,149261,141609,7651,5.1
Lafourche,6/1/2005,45369,43045,2324,5.1,149238,141714,7524,5
Lafourche,7/1/2005,44956,42877,2079,4.6,149432,142026,7406,5
Lafourche,8/1/2005,44475,42612,1863,4.2,149779,142434,7345,4.9
Lafourche,9/1/2005,49795,44395,5400,10.8,149954,142401,7553,5
Lafourche,10/1/2005,50133,45313,4820,9.6,150001,142548,7453,5
Lafourche,11/1/2005,49752,44900,4852,9.8,150065,142499,7566,5
Lafourche,12/1/2005,46804,44809,1995,4.3,150030,142752,7279,4.9
Lafourche,1/1/2006,45761,44096,1665,3.6,150214,143150,7064,4.7
Lafourche,2/1/2006,45444,44179,1265,2.8,150641,143457,7184,4.8
Lafourche,3/1/2006,45680,44420,1260,2.8,150813,143741,7072,4.7
Lafourche,4/1/2006,46463,45231,1232,2.7,150881,143761,7120,4.7
Lafourche,5/1/2006,46995,45542,1453,3.1,151069,144089,6980,4.6
Lafourche,6/1/2006,48065,46271,1794,3.7,151354,144353,7001,4.6
Lafourche,7/1/2006,48731,47232,1499,3.1,151377,144202,7175,4.7
Lafourche,8/1/2006,48200,46761,1439,3,151716,144625,7091,4.7
Lafourche,9/1/2006,48494,47042,1452,3,151662,144815,6847,4.5
Lafourche,10/1/2006,48679,47307,1372,2.8,152041,145314,6727,4.4
Lafourche,11/1/2006,48810,47405,1405,2.9,152406,145534,6872,4.5
Lafourche,12/1/2006,48971,47720,1251,2.6,152732,145970,6762,4.4
Lafourche,1/1/2007,48246,46755,1491,3.1,153144,146028,7116,4.6
Lafourche,2/1/2007,48064,46842,1222,2.5,152983,146057,6927,4.5
Lafourche,3/1/2007,48612,47306,1306,2.7,153051,146320,6731,4.4
Lafourche,4/1/2007,48648,47384,1264,2.6,152435,145586,6850,4.5
Lafourche,5/1/2007,49180,47717,1463,3,152670,145903,6766,4.4
Lafourche,6/1/2007,49885,48176,1709,3.4,153041,146063,6979,4.6
Lafourche,7/1/2007,49341,47859,1482,3,153054,145905,7149,4.7
Lafourche,8/1/2007,48661,47301,1360,2.8,152749,145682,7067,4.6
Lafourche,9/1/2007,48949,47568,1381,2.8,153414,146244,7170,4.7
Lafourche,10/1/2007,49390,48171,1219,2.5,153183,145946,7237,4.7
Lafourche,11/1/2007,49804,48518,1286,2.6,153835,146595,7240,4.7
Lafourche,12/1/2007,49470,48157,1313,2.7,153918,146273,7645,5
Lafourche,1/1/2008,48828,47243,1585,3.2,154063,146378,7685,5
Lafourche,2/1/2008,48873,47627,1246,2.5,153653,146156,7497,4.9
Lafourche,3/1/2008,49439,48041,1398,2.8,153908,146086,7822,5.1
Lafourche,4/1/2008,49530,48344,1186,2.4,153769,146132,7637,5
Lafourche,5/1/2008,50118,48620,1498,3,154303,145908,8395,5.4
Lafourche,6/1/2008,50815,48983,1832,3.6,154313,145737,8575,5.6
Lafourche,7/1/2008,50573,49020,1553,3.1,154469,145532,8937,5.8
Lafourche,8/1/2008,50095,48432,1663,3.3,154641,145203,9438,6.1
Lafourche,9/1/2008,49879,47334,2545,5.1,154570,145076,9494,6.1
Lafourche,10/1/2008,50739,48850,1889,3.7,154876,144802,10074,6.5
Lafourche,11/1/2008,50810,49037,1773,3.5,154639,144100,10538,6.8
Lafourche,12/1/2008,50405,48636,1769,3.5,154655,143369,11286,7.3
Lafourche,1/1/2009,49047,47083,1964,4,154210,142152,12058,7.8
Lafourche,2/1/2009,49209,47289,1920,3.9,154538,141640,12898,8.3
Lafourche,3/1/2009,49314,47334,1980,4,154133,140707,13426,8.7
Lafourche,4/1/2009,48807,46882,1925,3.9,154509,140656,13853,9
Lafourche,5/1/2009,48923,46730,2193,4.5,154747,140248,14499,9.4
Lafourche,6/1/2009,49377,46755,2622,5.3,154716,140009,14707,9.5
Lafourche,7/1/2009,49589,47351,2238,4.5,154502,139901,14601,9.5
Lafourche,8/1/2009,48984,46634,2350,4.8,154307,139492,14814,9.6
Lafourche,9/1/2009,48569,46319,2250,4.6,153827,138818,15009,9.8
Lafourche,10/1/2009,48390,46108,2282,4.7,153784,138432,15352,10
Lafourche,11/1/2009,48157,45946,2211,4.6,153878,138659,15219,9.9
Lafourche,12/1/2009,47843,45586,2257,4.7,153111,138013,15098,9.9
Lafourche,1/1/2010,43998,41300,2698,6.1,153484,138438,15046,9.8
Lafourche,2/1/2010,44160,41809,2351,5.3,153694,138581,15113,9.8
Lafourche,3/1/2010,44658,42234,2424,5.4,153954,138751,15202,9.9
Lafourche,4/1/2010,45282,42854,2428,5.4,154622,139297,15325,9.9
Lafourche,5/1/2010,45341,42783,2558,5.6,154091,139241,14849,9.6
Lafourche,6/1/2010,45843,43002,2841,6.2,153616,139141,14474,9.4
Lafourche,7/1/2010,46291,43674,2617,5.7,153691,139179,14512,9.4
Lafourche,8/1/2010,45984,43208,2776,6,154086,139438,14648,9.5
Lafourche,9/1/2010,45849,43249,2600,5.7,153975,139396,14579,9.5
Lafourche,10/1/2010,45433,42796,2637,5.8,153635,139119,14516,9.4
Lafourche,11/1/2010,45053,42426,2627,5.8,154125,139044,15081,9.8
Lafourche,12/1/2010,44616,42173,2443,5.5,153650,139301,14348,9.3
Lafourche,1/1/2011,43617,40677,2940,6.7,153263,139250,14013,9.1
Lafourche,2/1/2011,43557,40919,2638,6.1,153214,139394,13820,9
Lafourche,3/1/2011,43895,41322,2573,5.9,153376,139639,13737,9
Lafourche,4/1/2011,44406,41962,2444,5.5,153543,139586,13957,9.1
Lafourche,5/1/2011,44536,41927,2609,5.9,153479,139624,13855,9
Lafourche,6/1/2011,44972,42134,2838,6.3,153346,139384,13962,9.1
Lafourche,7/1/2011,45546,42867,2679,5.9,153288,139524,13763,9
Lafourche,8/1/2011,45113,42572,2541,5.6,153760,139942,13818,9
Lafourche,9/1/2011,45083,42575,2508,5.6,154131,140183,13948,9
Lafourche,10/1/2011,45071,42607,2464,5.5,153961,140368,13594,8.8
Lafourche,11/1/2011,45188,42858,2330,5.2,154128,140826,13302,8.6
Lafourche,12/1/2011,44930,42734,2196,4.9,153995,140902,13093,8.5
Lafourche,1/1/2012,44224,41687,2537,5.7,154381,141584,12797,8.3
Lafourche,2/1/2012,44395,42055,2340,5.3,154671,141858,12813,8.3
Lafourche,3/1/2012,44860,42540,2320,5.2,154749,142036,12713,8.2
Lafourche,4/1/2012,45248,43118,2130,4.7,154545,141899,12646,8.2
Lafourche,5/1/2012,45654,43251,2403,5.3,154866,142206,12660,8.2
Lafourche,6/1/2012,46344,43582,2762,6,155083,142391,12692,8.2
Lafourche,7/1/2012,46618,44112,2506,5.4,154948,142292,12656,8.2
Lafourche,8/1/2012,45872,43573,2299,5,154763,142291,12471,8.1
Lafourche,9/1/2012,46150,44056,2094,4.5,155160,143044,12115,7.8
Lafourche,10/1/2012,46550,44464,2086,4.5,155554,143431,12124,7.8
Lafourche,11/1/2012,46433,44527,1906,4.1,155338,143333,12005,7.7
Lafourche,12/1/2012,46419,44358,2061,4.4,155628,143330,12298,7.9
Lafourche,1/1/2013,45910,43344,2566,5.6,155763,143292,12471,8
Lafourche,2/1/2013,45712,43571,2141,4.7,155312,143362,11950,7.7
Lafourche,3/1/2013,45975,43866,2109,4.6,155005,143316,11689,7.5
Lafourche,4/1/2013,46659,44553,2106,4.5,155394,143635,11760,7.6
Lafourche,5/1/2013,46900,44521,2379,5.1,155536,143882,11654,7.5
Lafourche,6/1/2013,47483,44788,2695,5.7,155749,143999,11751,7.5
Lafourche,7/1/2013,48090,45619,2471,5.1,155599,144264,11335,7.3
Lafourche,8/1/2013,47401,45116,2285,4.8,155605,144326,11279,7.2
Lafourche,9/1/2013,47343,45258,2085,4.4,155687,144418,11270,7.2
Lafourche,10/1/2013,47078,45038,2040,4.3,154673,143537,11136,7.2
Lafourche,11/1/2013,47095,45198,1897,4,155265,144479,10787,6.9
Lafourche,12/1/2013,46883,45229,1654,3.5,155182,144778,10404,6.7
Lafourche,1/1/2014,47259,45275,1984,4.2,155352,145150,10202,6.6
Lafourche,2/1/2014,47134,45344,1790,3.8,155483,145134,10349,6.7
Lafourche,3/1/2014,47424,45473,1951,4.1,156028,145648,10380,6.7
Lafourche,4/1/2014,47547,45735,1812,3.8,155369,145667,9702,6.2
Lafourche,5/1/2014,47689,45540,2149,4.5,155684,145825,9859,6.3
Lafourche,6/1/2014,48520,46082,2438,5,155707,146247,9460,6.1
Lafourche,7/1/2014,49325,46673,2652,5.4,156007,146399,9608,6.2
Lafourche,8/1/2014,48900,46287,2613,5.3,156130,146530,9599,6.1
Lafourche,9/1/2014,48666,46195,2471,5.1,156040,146778,9262,5.9
Lafourche,10/1/2014,49094,46616,2478,5,156417,147427,8990,5.7
Lafourche,11/1/2014,48876,46324,2552,5.2,156494,147404,9090,5.8
Lafourche,12/1/2014,48495,46207,2288,4.7,156332,147615,8717,5.6
Lafourche,1/1/2015,47816,45154,2662,5.6,157030,148145,8885,5.7
Lafourche,2/1/2015,47247,44843,2404,5.1,156644,148045,8599,5.5
Lafourche,3/1/2015,47258,44796,2462,5.2,156643,148128,8515,5.4
Lafourche,4/1/2015,46914,44465,2449,5.2,157060,148511,8550,5.4
Lafourche,5/1/2015,46967,44369,2598,5.5,157651,148817,8834,5.6
Lafourche,6/1/2015,47059,44366,2693,5.7,157062,148816,8247,5.3
Lafourche,7/1/2015,47210,44560,2650,5.6,156997,148830,8167,5.2
Lafourche,8/1/2015,46262,43801,2461,5.3,157172,149181,7992,5.1
Lafourche,9/1/2015,45673,43234,2439,5.3,156733,148826,7907,5
Lafourche,10/1/2015,45134,42682,2452,5.4,157167,149246,7922,5
Lafourche,11/1/2015,44885,42538,2347,5.2,157463,149463,8000,5.1
Lafourche,12/1/2015,44406,42194,2212,5,158035,150128,7907,5
Lafourche,1/1/2016,44357,41670,2687,6.1,158280,150653,7627,4.8
Lafourche,2/1/2016,44046,41498,2548,5.8,158640,150939,7702,4.9
Lafourche,3/1/2016,44069,41346,2723,6.2,159179,151218,7961,5
Lafourche,4/1/2016,43814,41239,2575,5.9,159141,151074,8067,5.1
Lafourche,5/1/2016,43715,41045,2670,6.1,158784,151132,7652,4.8
Lafourche,6/1/2016,44018,40914,3104,7.1,158967,151223,7744,4.9
Lafourche,7/1/2016,44014,40977,3037,6.9,159194,151554,7641,4.8
Lafourche,8/1/2016,42894,40059,2835,6.6,159562,151779,7784,4.9
Lafourche,9/1/2016,42617,39746,2871,6.7,159714,151761,7953,5
Lafourche,10/1/2016,42259,39634,2625,6.2,159605,151793,7811,4.9
Lafourche,11/1/2016,41940,39504,2436,5.8,159506,151954,7553,4.7
Lafourche,12/1/2016,41619,39234,2385,5.7,159678,152157,7521,4.7
Lafourche,1/1/2017,41460,38749,2711,6.5,159620,152152,7468,4.7
Lafourche,2/1/2017,41637,39186,2451,5.9,159859,152480,7379,4.6
Lafourche,3/1/2017,41861,39503,2358,5.6,160137,153065,7073,4.4
Lafourche,4/1/2017,41818,39582,2236,5.3,160345,153255,7089,4.4
Lafourche,5/1/2017,41767,39622,2145,5.1,160068,153069,7000,4.4
Lafourche,6/1/2017,42225,39863,2362,5.6,160192,153318,6873,4.3
Lafourche,7/1/2017,42544,40238,2306,5.4,160462,153569,6892,4.3
Lafourche,8/1/2017,41964,39746,2218,5.3,160586,153503,7082,4.4
Lafourche,9/1/2017,41954,39902,2052,4.9,161140,154286,6854,4.3
Lafourche,10/1/2017,41689,39922,1767,4.2,160309,153609,6700,4.2
Lafourche,11/1/2017,41903,40113,1790,4.3,160579,153805,6774,4.2
Lafourche,12/1/2017,41737,40031,1706,4.1,160535,153904,6632,4.1
Lafourche,1/1/2018,41405,39431,1974,4.8,160914,154425,6489,4
Lafourche,2/1/2018,41760,39925,1835,4.4,161778,155197,6581,4.1
Lafourche,3/1/2018,42039,40141,1898,4.5,161686,155214,6472,4
Lafourche,4/1/2018,42266,40397,1869,4.4,161771,155312,6459,4
Lafourche,5/1/2018,42321,40396,1925,4.5,161848,155652,6196,3.8
Lafourche,6/1/2018,42844,40362,2482,5.8,162210,155762,6447,4
Lafourche,7/1/2018,43057,40787,2270,5.3,162341,156146,6195,3.8
Lafourche,8/1/2018,41944,39928,2016,4.8,161660,155504,6156,3.8
Lafourche,9/1/2018,41763,39842,1921,4.6,162087,156015,6073,3.7
Lafourche,10/1/2018,41989,40117,1872,4.5,162602,156391,6211,3.8
Lafourche,11/1/2018,41935,40198,1737,4.1,162836,156721,6115,3.8
Lafourche,12/1/2018,41462,39793,1669,4,163206,156817,6389,3.9
Lafourche,1/1/2019,41169,39111,2058,5,162963,156487,6475,4
Lafourche,2/1/2019,41184,39483,1701,4.1,162999,156863,6136,3.8
Lafourche,3/1/2019,41633,40033,1600,3.8,162904,156701,6202,3.8
Lafourche,4/1/2019,41563,40068,1495,3.6,162586,156625,5961,3.7
Lafourche,5/1/2019,41825,40081,1744,4.2,162751,156821,5930,3.6
Lafourche,6/1/2019,42268,40114,2154,5.1,163168,157232,5935,3.6
Lafourche,7/1/2019,42809,40735,2074,4.8,163590,157529,6061,3.7
Lafourche,8/1/2019,42424,40513,1911,4.5,163774,157829,5945,3.6
Lafourche,9/1/2019,42449,40599,1850,4.4,164092,158339,5753,3.5
Lafourche,10/1/2019,42272,40432,1840,4.4,164416,158545,5871,3.6
Lafourche,11/1/2019,41999,40251,1748,4.2,164496,158629,5868,3.6
Lafourche,12/1/2019,41567,39939,1628,3.9,164699,158845,5853,3.6
Lafourche,1/1/2020,41320,39460,1860,4.5,164377,158508,5869,3.6
Lafourche,2/1/2020,41186,39712,1474,3.6,164467,158714,5753,3.5
Lafourche,3/1/2020,41876,39241,2635,6.3,162559,155353,7206,4.4
Lafourche,4/1/2020,39444,35475,3969,10.1,156269,133185,23084,14.8
Lafourche,5/1/2020,39990,36216,3774,9.4,158101,137173,20929,13.2
Lafourche,6/1/2020,40742,37054,3688,9.1,159994,142342,17652,11
Lafourche,7/1/2020,41197,37665,3532,8.6,160132,143779,16352,10.2
Lafourche,8/1/2020,40852,38079,2773,6.8,160706,147245,13461,8.4
Lafourche,9/1/2020,41134,38259,2875,7,160174,147620,12554,7.8
Lafourche,10/1/2020,41350,38778,2572,6.2,161003,149931,11072,6.9
Lafourche,11/1/2020,41009,38767,2242,5.5,160629,149934,10694,6.7
Lafourche,12/1/2020,40606,38299,2307,5.7,160745,149975,10770,6.7
Lafourche,1/1/2021,40391,38011,2380,5.9,160088,149852,10236,6.4
Lafourche,2/1/2021,40836,38622,2214,5.4,160184,150189,9995,6.2
Lafourche,3/1/2021,41129,39055,2074,5,160400,150644,9756,6.1
Lafourche,4/1/2021,40997,39016,1981,4.8,160843,151081,9762,6.1
Lafourche,5/1/2021,40826,38888,1938,4.7,160800,151535,9266,5.8
Lafourche,6/1/2021,41283,39033,2250,5.5,161197,151734,9462,5.9
Lafourche,7/1/2021,41554,39615,1939,4.7,161504,152773,8731,5.4
Lafourche,8/1/2021,40696,38986,1710,4.2,161527,153250,8276,5.1
Lafourche,9/1/2021,38929,36773,2156,5.5,161495,153843,7652,4.7
Lafourche,10/1/2021,39357,37614,1743,4.4,161754,154475,7279,4.5
Lafourche,11/1/2021,39221,37784,1437,3.7,162281,155530,6751,4.2
Lafourche,12/1/2021,39143,37862,1281,3.3,162497,156099,6398,3.9
Lafourche,1/1/2022,38971,37399,1572,4,163627,157115,6512,4
Lafourche,2/1/2022,39477,38065,1412,3.6,163899,157598,6301,3.8
Lafourche,3/1/2022,39973,38616,1357,3.4,164220,158206,6014,3.7
Lafourche,4/1/2022,40305,39087,1218,3,163893,157891,6002,3.7
Lafourche,5/1/2022,40521,39212,1309,3.2,164362,158378,5983,3.6
Lafourche,6/1/2022,40964,39262,1702,4.2,164046,158094,5951,3.6
Lafourche,7/1/2022,40999,39464,1535,3.7,164026,158258,5768,3.5
Lafourche,8/1/2022,40562,39168,1394,3.4,164654,158735,5919,3.6
Lafourche,9/1/2022,40592,39255,1337,3.3,164602,158810,5792,3.5
Lafourche,10/1/2022,40581,39349,1232,3,164648,158684,5964,3.6
Lafourche,11/1/2022,40461,39296,1165,2.9,164450,158507,5943,3.6
Lafourche,12/1/2022,40304,39138,1166,2.9,165025,159259,5766,3.5
Lafourche,1/1/2023,40215,38854,1361,3.4,165964,160217,5747,3.5
Lafourche,2/1/2023,40411,39156,1255,3.1,166358,160395,5962,3.6
Lafourche,3/1/2023,40844,39701,1143,2.8,166651,160812,5839,3.5
Lafourche,4/1/2023,40968,39916,1052,2.6,166725,160974,5751,3.4
Lafourche,5/1/2023,41078,39824,1254,3.1,166886,160796,6089,3.6
Lafourche,6/1/2023,41684,40146,1538,3.7,166937,160979,5958,3.6
Lafourche,7/1/2023,41548,40282,1266,3,167103,161183,5920,3.5
Lafourche,8/1/2023,41526,40206,1320,3.2,167759,161475,6284,3.7
Lafourche,9/1/2023,41447,39972,1475,3.6,167767,161442,6326,3.8
Lafourche,10/1/2023,41654,40208,1446,3.5,167690,161211,6479,3.9
Lafourche,11/1/2023,41597,40279,1318,3.2,168140,161886,6254,3.7
Lafourche,12/1/2023,41319,39916,1403,3.4,167439,161124,6315,3.8
Lafourche,1/1/2024,41035,39474,1561,3.8,167339,161190,6149,3.7
Lafourche,2/1/2024,41337,39808,1529,3.7,167475,161013,6462,3.9
Lafourche,3/1/2024,41578,40129,1449,3.5,167922,161425,6497,3.9
Lafourche,4/1/2024,41441,40248,1193,2.9,167988,161495,6492,3.9
Lafourche,5/1/2024,41568,40207,1361,3.3,167799,161164,6635,4
Lafourche,6/1/2024,42108,40296,1812,4.3,168005,161155,6849,4.1
Lafourche,7/1/2024,42404,40666,1738,4.1,168315,161219,7097,4.2
Lafourche,8/1/2024,42091,40325,1766,4.2,168496,161425,7071,4.2
Lafourche,9/1/2024,41924,40167,1757,4.2,168703,161802,6901,4.1
Lafourche,10/1/2024,42147,40461,1686,4,168428,161456,6972,4.1
Lafourche,11/1/2024,41858,40240,1618,3.9,168304,161183,7121,4.2
Lafourche,12/1/2024,41820,40291,1529,3.7,168547,161661,6886,4.1
Lafourche,1/1/2025,40800,39283,1517,3.7,170744,163895,6849,4
Lafourche,2/1/2025,41157,39623,1534,3.7,170359,163307,7052,4.1
Lincoln,1/1/1990,17248,16527,721,4.2,125833,119081,6752,5.4
Lincoln,2/1/1990,17195,16491,704,4.1,125710,119059,6651,5.3
Lincoln,3/1/1990,17386,16691,695,4,125801,119203,6598,5.2
Lincoln,4/1/1990,17538,16853,685,3.9,125649,118852,6797,5.4
Lincoln,5/1/1990,17814,17039,775,4.4,125893,119151,6742,5.4
Lincoln,6/1/1990,17278,16233,1045,6,125573,118983,6590,5.2
Lincoln,7/1/1990,17506,16564,942,5.4,125732,118810,6922,5.5
Lincoln,8/1/1990,17122,16087,1035,6,125990,118802,7188,5.7
Lincoln,9/1/1990,18000,16921,1079,6,125892,118524,7368,5.9
Lincoln,10/1/1990,18171,17103,1068,5.9,125995,118536,7459,5.9
Lincoln,11/1/1990,18138,17152,986,5.4,126070,118306,7764,6.2
Lincoln,12/1/1990,17870,16955,915,5.1,126142,118241,7901,6.3
Lincoln,1/1/1991,17760,16761,999,5.6,125955,117940,8015,6.4
Lincoln,2/1/1991,17993,17145,848,4.7,126020,117755,8265,6.6
Lincoln,3/1/1991,18103,17262,841,4.6,126238,117652,8586,6.8
Lincoln,4/1/1991,18187,17361,826,4.5,126548,118109,8439,6.7
Lincoln,5/1/1991,18411,17467,944,5.1,126176,117440,8736,6.9
Lincoln,6/1/1991,17938,16830,1108,6.2,126331,117639,8692,6.9
Lincoln,7/1/1991,18134,17208,926,5.1,126154,117568,8586,6.8
Lincoln,8/1/1991,17662,16727,935,5.3,126150,117484,8666,6.9
Lincoln,9/1/1991,18926,18071,855,4.5,126650,117928,8722,6.9
Lincoln,10/1/1991,18711,17921,790,4.2,126642,117800,8842,7
Lincoln,11/1/1991,18802,18082,720,3.8,126701,117770,8931,7
Lincoln,12/1/1991,18480,17775,705,3.8,126664,117466,9198,7.3
Lincoln,1/1/1992,18563,18048,515,2.8,127261,117978,9283,7.3
Lincoln,2/1/1992,18623,18102,521,2.8,127207,117753,9454,7.4
Lincoln,3/1/1992,18645,18163,482,2.6,127604,118144,9460,7.4
Lincoln,4/1/1992,19267,18821,446,2.3,127841,118426,9415,7.4
Lincoln,5/1/1992,19391,18924,467,2.4,128119,118375,9744,7.6
Lincoln,6/1/1992,18901,18294,607,3.2,128459,118419,10040,7.8
Lincoln,7/1/1992,19106,18532,574,3,128563,118713,9850,7.7
Lincoln,8/1/1992,18728,18185,543,2.9,128613,118826,9787,7.6
Lincoln,9/1/1992,19487,19010,477,2.4,128501,118720,9781,7.6
Lincoln,10/1/1992,19235,18789,446,2.3,128026,118628,9398,7.3
Lincoln,11/1/1992,19236,18811,425,2.2,128441,118876,9565,7.4
Lincoln,12/1/1992,18498,18102,396,2.1,128554,118997,9557,7.4
Lincoln,1/1/1993,18134,17552,582,3.2,128400,119075,9325,7.3
Lincoln,2/1/1993,18103,17678,425,2.3,128458,119275,9183,7.1
Lincoln,3/1/1993,18346,17898,448,2.4,128598,119542,9056,7
Lincoln,4/1/1993,18414,18030,384,2.1,128584,119474,9110,7.1
Lincoln,5/1/1993,18677,18282,395,2.1,129264,120115,9149,7.1
Lincoln,6/1/1993,18031,17472,559,3.1,129411,120290,9121,7
Lincoln,7/1/1993,18107,17632,475,2.6,129397,120467,8930,6.9
Lincoln,8/1/1993,17928,17388,540,3,129619,120856,8763,6.8
Lincoln,9/1/1993,18733,18228,505,2.7,129268,120554,8714,6.7
Lincoln,10/1/1993,18513,18020,493,2.7,129573,120823,8750,6.8
Lincoln,11/1/1993,18782,18305,477,2.5,129711,121169,8542,6.6
Lincoln,12/1/1993,18461,18040,421,2.3,129941,121464,8477,6.5
Lincoln,1/1/1994,17894,17330,564,3.2,130596,121966,8630,6.6
Lincoln,2/1/1994,17950,17435,515,2.9,130669,122086,8583,6.6
Lincoln,3/1/1994,17932,17422,510,2.8,130400,121930,8470,6.5
Lincoln,4/1/1994,17810,17324,486,2.7,130621,122290,8331,6.4
Lincoln,5/1/1994,18188,17737,451,2.5,130779,122864,7915,6.1
Lincoln,6/1/1994,17749,17155,594,3.3,130561,122634,7927,6.1
Lincoln,7/1/1994,18179,17632,547,3,130652,122706,7946,6.1
Lincoln,8/1/1994,17927,17368,559,3.1,131275,123342,7933,6
Lincoln,9/1/1994,18768,18223,545,2.9,131421,123687,7734,5.9
Lincoln,10/1/1994,18523,17998,525,2.8,131744,124112,7632,5.8
Lincoln,11/1/1994,18486,18016,470,2.5,131891,124516,7375,5.6
Lincoln,12/1/1994,18142,17734,408,2.2,131951,124721,7230,5.5
Lincoln,1/1/1995,17771,17309,462,2.6,132038,124663,7375,5.6
Lincoln,2/1/1995,17988,17555,433,2.4,132115,124928,7187,5.4
Lincoln,3/1/1995,18141,17671,470,2.6,132108,124955,7153,5.4
Lincoln,4/1/1995,18447,17933,514,2.8,132590,124945,7645,5.8
Lincoln,5/1/1995,18631,18156,475,2.5,131851,124421,7430,5.6
Lincoln,6/1/1995,18071,17481,590,3.3,131949,124522,7427,5.6
Lincoln,7/1/1995,18374,17808,566,3.1,132343,124816,7527,5.7
Lincoln,8/1/1995,17999,17408,591,3.3,132336,124852,7484,5.7
Lincoln,9/1/1995,18733,18069,664,3.5,132611,125133,7478,5.6
Lincoln,10/1/1995,18525,17850,675,3.6,132716,125388,7328,5.5
Lincoln,11/1/1995,18390,17890,500,2.7,132614,125188,7426,5.6
Lincoln,12/1/1995,18317,17821,496,2.7,132511,125088,7423,5.6
Lincoln,1/1/1996,18317,17748,569,3.1,132616,125125,7491,5.6
Lincoln,2/1/1996,18502,17997,505,2.7,132952,125639,7313,5.5
Lincoln,3/1/1996,18608,18140,468,2.5,133180,125862,7318,5.5
Lincoln,4/1/1996,18487,18000,487,2.6,133409,125994,7415,5.6
Lincoln,5/1/1996,18580,18049,531,2.9,133667,126244,7423,5.6
Lincoln,6/1/1996,17993,17383,610,3.4,133697,126602,7095,5.3
Lincoln,7/1/1996,18130,17547,583,3.2,134284,126947,7337,5.5
Lincoln,8/1/1996,18123,17546,577,3.2,134054,127172,6882,5.1
Lincoln,9/1/1996,18630,18074,556,3,134515,127536,6979,5.2
Lincoln,10/1/1996,18445,17910,535,2.9,134921,127890,7031,5.2
Lincoln,11/1/1996,18458,17936,522,2.8,135007,127771,7236,5.4
Lincoln,12/1/1996,18350,17800,550,3,135113,127860,7253,5.4
Lincoln,1/1/1997,18003,17342,661,3.7,135456,128298,7158,5.3
Lincoln,2/1/1997,18206,17593,613,3.4,135400,128298,7102,5.2
Lincoln,3/1/1997,18609,17768,841,4.5,135891,128891,7000,5.2
Lincoln,4/1/1997,18490,17875,615,3.3,136016,129143,6873,5.1
Lincoln,5/1/1997,18561,17981,580,3.1,136119,129464,6655,4.9
Lincoln,6/1/1997,18340,17605,735,4,136211,129412,6799,5
Lincoln,7/1/1997,18413,17770,643,3.5,136477,129822,6655,4.9
Lincoln,8/1/1997,18233,17588,645,3.5,136618,130010,6608,4.8
Lincoln,9/1/1997,18717,18113,604,3.2,136675,130019,6656,4.9
Lincoln,10/1/1997,18495,17968,527,2.8,136633,130179,6454,4.7
Lincoln,11/1/1997,18432,17964,468,2.5,136961,130653,6308,4.6
Lincoln,12/1/1997,18108,17665,443,2.4,137155,130679,6476,4.7
Lincoln,1/1/1998,17864,17303,561,3.1,137095,130726,6368,4.6
Lincoln,2/1/1998,18140,17708,432,2.4,137112,130807,6306,4.6
Lincoln,3/1/1998,18223,17737,486,2.7,137236,130814,6422,4.7
Lincoln,4/1/1998,18163,17732,431,2.4,137150,131209,5941,4.3
Lincoln,5/1/1998,18480,18014,466,2.5,137372,131325,6047,4.4
Lincoln,6/1/1998,18400,17835,565,3.1,137455,131244,6212,4.5
Lincoln,7/1/1998,18554,17993,561,3,137588,131329,6259,4.5
Lincoln,8/1/1998,18497,17856,641,3.5,137570,131390,6179,4.5
Lincoln,9/1/1998,19117,18633,484,2.5,138286,131986,6300,4.6
Lincoln,10/1/1998,19428,18949,479,2.5,138279,131999,6280,4.5
Lincoln,11/1/1998,19272,18841,431,2.2,138381,132280,6100,4.4
Lincoln,12/1/1998,19050,18682,368,1.9,138634,132602,6032,4.4
Lincoln,1/1/1999,18428,17982,446,2.4,139003,133027,5976,4.3
Lincoln,2/1/1999,18805,18404,401,2.1,138967,132856,6111,4.4
Lincoln,3/1/1999,18914,18538,376,2,138730,132947,5783,4.2
Lincoln,4/1/1999,19305,18923,382,2,138959,132955,6004,4.3
Lincoln,5/1/1999,19246,18888,358,1.9,139107,133311,5796,4.2
Lincoln,6/1/1999,19284,18795,489,2.5,139329,133378,5951,4.3
Lincoln,7/1/1999,19179,18717,462,2.4,139439,133414,6025,4.3
Lincoln,8/1/1999,19237,18737,500,2.6,139430,133591,5838,4.2
Lincoln,9/1/1999,19260,18765,495,2.6,139622,133707,5915,4.2
Lincoln,10/1/1999,19327,18829,498,2.6,139771,133993,5778,4.1
Lincoln,11/1/1999,19340,18893,447,2.3,140025,134309,5716,4.1
Lincoln,12/1/1999,19428,18992,436,2.2,140177,134523,5653,4
Lincoln,1/1/2000,18895,17886,1009,5.3,142267,136559,5708,4
Lincoln,2/1/2000,19020,18184,836,4.4,142456,136598,5858,4.1
Lincoln,3/1/2000,19181,18230,951,5,142434,136701,5733,4
Lincoln,4/1/2000,19152,18315,837,4.4,142751,137270,5481,3.8
Lincoln,5/1/2000,19268,18349,919,4.8,142388,136630,5758,4
Lincoln,6/1/2000,19257,18043,1214,6.3,142591,136940,5651,4
Lincoln,7/1/2000,19090,17937,1153,6,142278,136531,5747,4
Lincoln,8/1/2000,18854,17714,1140,6,142514,136662,5853,4.1
Lincoln,9/1/2000,18769,17739,1030,5.5,142518,136893,5625,3.9
Lincoln,10/1/2000,18829,17828,1001,5.3,142622,137088,5534,3.9
Lincoln,11/1/2000,18803,17864,939,5,142962,137322,5639,3.9
Lincoln,12/1/2000,18817,17923,894,4.8,143248,137614,5634,3.9
Lincoln,1/1/2001,18625,17579,1046,5.6,143800,137778,6023,4.2
Lincoln,2/1/2001,18576,17660,916,4.9,143701,137612,6089,4.2
Lincoln,3/1/2001,18759,17666,1093,5.8,143924,137783,6141,4.3
Lincoln,4/1/2001,18765,17742,1023,5.5,143569,137299,6271,4.4
Lincoln,5/1/2001,18724,17675,1049,5.6,143318,137092,6226,4.3
Lincoln,6/1/2001,18732,17401,1331,7.1,143357,136873,6484,4.5
Lincoln,7/1/2001,18770,17577,1193,6.4,143654,137071,6583,4.6
Lincoln,8/1/2001,18461,17300,1161,6.3,143284,136241,7042,4.9
Lincoln,9/1/2001,18724,17555,1169,6.2,143989,136846,7142,5
Lincoln,10/1/2001,18708,17539,1169,6.2,144086,136392,7694,5.3
Lincoln,11/1/2001,18809,17613,1196,6.4,144240,136238,8003,5.5
Lincoln,12/1/2001,18713,17522,1191,6.4,144305,136047,8258,5.7
Lincoln,1/1/2002,18621,17227,1394,7.5,143883,135701,8182,5.7
Lincoln,2/1/2002,18640,17527,1113,6,144653,136438,8215,5.7
Lincoln,3/1/2002,18653,17520,1133,6.1,144481,136177,8304,5.7
Lincoln,4/1/2002,18654,17569,1085,5.8,144725,136126,8599,5.9
Lincoln,5/1/2002,18775,17613,1162,6.2,144938,136539,8399,5.8
Lincoln,6/1/2002,19025,17588,1437,7.6,144808,136415,8393,5.8
Lincoln,7/1/2002,18799,17534,1265,6.7,144803,136413,8390,5.8
Lincoln,8/1/2002,18620,17398,1222,6.6,145009,136705,8304,5.7
Lincoln,9/1/2002,18622,17498,1124,6,145552,137302,8251,5.7
Lincoln,10/1/2002,18689,17564,1125,6,145314,137008,8307,5.7
Lincoln,11/1/2002,18579,17416,1163,6.3,145041,136521,8520,5.9
Lincoln,12/1/2002,18395,17278,1117,6.1,145066,136426,8640,6
Lincoln,1/1/2003,18299,17003,1296,7.1,145937,137417,8520,5.8
Lincoln,2/1/2003,18149,17064,1085,6,146100,137482,8618,5.9
Lincoln,3/1/2003,18224,17077,1147,6.3,146022,137434,8588,5.9
Lincoln,4/1/2003,18233,17198,1035,5.7,146474,137633,8842,6
Lincoln,5/1/2003,18217,17037,1180,6.5,146500,137544,8957,6.1
Lincoln,6/1/2003,18719,17107,1612,8.6,147056,137790,9266,6.3
Lincoln,7/1/2003,18510,17044,1466,7.9,146485,137474,9011,6.2
Lincoln,8/1/2003,18403,17067,1336,7.3,146445,137549,8896,6.1
Lincoln,9/1/2003,18346,17117,1229,6.7,146530,137609,8921,6.1
Lincoln,10/1/2003,18411,17243,1168,6.3,146716,137984,8732,6
Lincoln,11/1/2003,18345,17194,1151,6.3,147000,138424,8576,5.8
Lincoln,12/1/2003,18241,17092,1149,6.3,146729,138411,8317,5.7
Lincoln,1/1/2004,18204,16870,1334,7.3,146842,138472,8370,5.7
Lincoln,2/1/2004,18043,16996,1047,5.8,146709,138542,8167,5.6
Lincoln,3/1/2004,18195,17024,1171,6.4,146944,138453,8491,5.8
Lincoln,4/1/2004,18068,17093,975,5.4,146850,138680,8170,5.6
Lincoln,5/1/2004,18301,17206,1095,6,147065,138852,8212,5.6
Lincoln,6/1/2004,18390,17059,1331,7.2,147460,139174,8286,5.6
Lincoln,7/1/2004,18594,17302,1292,6.9,147692,139556,8136,5.5
Lincoln,8/1/2004,18355,17244,1111,6.1,147564,139573,7990,5.4
Lincoln,9/1/2004,18465,17370,1095,5.9,147415,139487,7927,5.4
Lincoln,10/1/2004,18384,17301,1083,5.9,147793,139732,8061,5.5
Lincoln,11/1/2004,18530,17448,1082,5.8,148162,140231,7932,5.4
Lincoln,12/1/2004,18340,17236,1104,6,148059,140125,7934,5.4
Lincoln,1/1/2005,18175,16977,1198,6.6,148029,140245,7784,5.3
Lincoln,2/1/2005,18035,17001,1034,5.7,148364,140385,7980,5.4
Lincoln,3/1/2005,18164,17126,1038,5.7,148391,140654,7737,5.2
Lincoln,4/1/2005,18198,17159,1039,5.7,148926,141254,7672,5.2
Lincoln,5/1/2005,18348,17222,1126,6.1,149261,141609,7651,5.1
Lincoln,6/1/2005,18432,17084,1348,7.3,149238,141714,7524,5
Lincoln,7/1/2005,18343,17146,1197,6.5,149432,142026,7406,5
Lincoln,8/1/2005,17995,16921,1074,6,149779,142434,7345,4.9
Lincoln,9/1/2005,20074,18271,1803,9,149954,142401,7553,5
Lincoln,10/1/2005,20143,18509,1634,8.1,150001,142548,7453,5
Lincoln,11/1/2005,19932,18282,1650,8.3,150065,142499,7566,5
Lincoln,12/1/2005,19170,18085,1085,5.7,150030,142752,7279,4.9
Lincoln,1/1/2006,18656,17762,894,4.8,150214,143150,7064,4.7
Lincoln,2/1/2006,18471,17768,703,3.8,150641,143457,7184,4.8
Lincoln,3/1/2006,18712,17954,758,4.1,150813,143741,7072,4.7
Lincoln,4/1/2006,18894,18178,716,3.8,150881,143761,7120,4.7
Lincoln,5/1/2006,18928,18085,843,4.5,151069,144089,6980,4.6
Lincoln,6/1/2006,19137,18095,1042,5.4,151354,144353,7001,4.6
Lincoln,7/1/2006,18989,18055,934,4.9,151377,144202,7175,4.7
Lincoln,8/1/2006,18558,17704,854,4.6,151716,144625,7091,4.7
Lincoln,9/1/2006,18762,17924,838,4.5,151662,144815,6847,4.5
Lincoln,10/1/2006,19051,18242,809,4.2,152041,145314,6727,4.4
Lincoln,11/1/2006,19082,18264,818,4.3,152406,145534,6872,4.5
Lincoln,12/1/2006,18735,17970,765,4.1,152732,145970,6762,4.4
Lincoln,1/1/2007,18640,17700,940,5,153144,146028,7116,4.6
Lincoln,2/1/2007,18786,17945,841,4.5,152983,146057,6927,4.5
Lincoln,3/1/2007,18903,18048,855,4.5,153051,146320,6731,4.4
Lincoln,4/1/2007,18917,18093,824,4.4,152435,145586,6850,4.5
Lincoln,5/1/2007,19057,18133,924,4.8,152670,145903,6766,4.4
Lincoln,6/1/2007,19228,18088,1140,5.9,153041,146063,6979,4.6
Lincoln,7/1/2007,19192,18134,1058,5.5,153054,145905,7149,4.7
Lincoln,8/1/2007,18779,17856,923,4.9,152749,145682,7067,4.6
Lincoln,9/1/2007,19134,18263,871,4.6,153414,146244,7170,4.7
Lincoln,10/1/2007,19149,18357,792,4.1,153183,145946,7237,4.7
Lincoln,11/1/2007,19109,18330,779,4.1,153835,146595,7240,4.7
Lincoln,12/1/2007,18857,18009,848,4.5,153918,146273,7645,5
Lincoln,1/1/2008,18923,17972,951,5,154063,146378,7685,5
Lincoln,2/1/2008,18833,18035,798,4.2,153653,146156,7497,4.9
Lincoln,3/1/2008,19186,18299,887,4.6,153908,146086,7822,5.1
Lincoln,4/1/2008,19263,18491,772,4,153769,146132,7637,5
Lincoln,5/1/2008,19470,18510,960,4.9,154303,145908,8395,5.4
Lincoln,6/1/2008,19595,18363,1232,6.3,154313,145737,8575,5.6
Lincoln,7/1/2008,19479,18374,1105,5.7,154469,145532,8937,5.8
Lincoln,8/1/2008,19451,18261,1190,6.1,154641,145203,9438,6.1
Lincoln,9/1/2008,19720,18786,934,4.7,154570,145076,9494,6.1
Lincoln,10/1/2008,19543,18480,1063,5.4,154876,144802,10074,6.5
Lincoln,11/1/2008,19461,18439,1022,5.3,154639,144100,10538,6.8
Lincoln,12/1/2008,19195,18095,1100,5.7,154655,143369,11286,7.3
Lincoln,1/1/2009,19254,18031,1223,6.4,154210,142152,12058,7.8
Lincoln,2/1/2009,19201,17996,1205,6.3,154538,141640,12898,8.3
Lincoln,3/1/2009,19370,18034,1336,6.9,154133,140707,13426,8.7
Lincoln,4/1/2009,19476,18190,1286,6.6,154509,140656,13853,9
Lincoln,5/1/2009,19716,18210,1506,7.6,154747,140248,14499,9.4
Lincoln,6/1/2009,19815,18007,1808,9.1,154716,140009,14707,9.5
Lincoln,7/1/2009,19688,18066,1622,8.2,154502,139901,14601,9.5
Lincoln,8/1/2009,19414,17781,1633,8.4,154307,139492,14814,9.6
Lincoln,9/1/2009,19215,17802,1413,7.4,153827,138818,15009,9.8
Lincoln,10/1/2009,19540,18117,1423,7.3,153784,138432,15352,10
Lincoln,11/1/2009,19457,18175,1282,6.6,153878,138659,15219,9.9
Lincoln,12/1/2009,19190,17900,1290,6.7,153111,138013,15098,9.9
Lincoln,1/1/2010,19943,18349,1594,8,153484,138438,15046,9.8
Lincoln,2/1/2010,19882,18437,1445,7.3,153694,138581,15113,9.8
Lincoln,3/1/2010,20074,18643,1431,7.1,153954,138751,15202,9.9
Lincoln,4/1/2010,20244,18798,1446,7.1,154622,139297,15325,9.9
Lincoln,5/1/2010,20305,18702,1603,7.9,154091,139241,14849,9.6
Lincoln,6/1/2010,20815,18884,1931,9.3,153616,139141,14474,9.4
Lincoln,7/1/2010,20946,19090,1856,8.9,153691,139179,14512,9.4
Lincoln,8/1/2010,20436,18563,1873,9.2,154086,139438,14648,9.5
Lincoln,9/1/2010,20223,18533,1690,8.4,153975,139396,14579,9.5
Lincoln,10/1/2010,20462,18763,1699,8.3,153635,139119,14516,9.4
Lincoln,11/1/2010,20468,18759,1709,8.3,154125,139044,15081,9.8
Lincoln,12/1/2010,20213,18571,1642,8.1,153650,139301,14348,9.3
Lincoln,1/1/2011,19876,17996,1880,9.5,153263,139250,14013,9.1
Lincoln,2/1/2011,19948,18251,1697,8.5,153214,139394,13820,9
Lincoln,3/1/2011,20138,18450,1688,8.4,153376,139639,13737,9
Lincoln,4/1/2011,20630,19022,1608,7.8,153543,139586,13957,9.1
Lincoln,5/1/2011,20618,18910,1708,8.3,153479,139624,13855,9
Lincoln,6/1/2011,20585,18531,2054,10,153346,139384,13962,9.1
Lincoln,7/1/2011,20105,18150,1955,9.7,153288,139524,13763,9
Lincoln,8/1/2011,19912,18065,1847,9.3,153760,139942,13818,9
Lincoln,9/1/2011,19926,18187,1739,8.7,154131,140183,13948,9
Lincoln,10/1/2011,20295,18588,1707,8.4,153961,140368,13594,8.8
Lincoln,11/1/2011,20133,18538,1595,7.9,154128,140826,13302,8.6
Lincoln,12/1/2011,19891,18335,1556,7.8,153995,140902,13093,8.5
Lincoln,1/1/2012,19223,17504,1719,8.9,154381,141584,12797,8.3
Lincoln,2/1/2012,19243,17639,1604,8.3,154671,141858,12813,8.3
Lincoln,3/1/2012,19430,17833,1597,8.2,154749,142036,12713,8.2
Lincoln,4/1/2012,19656,18182,1474,7.5,154545,141899,12646,8.2
Lincoln,5/1/2012,19870,18203,1667,8.4,154866,142206,12660,8.2
Lincoln,6/1/2012,20142,18063,2079,10.3,155083,142391,12692,8.2
Lincoln,7/1/2012,19684,17808,1876,9.5,154948,142292,12656,8.2
Lincoln,8/1/2012,19326,17687,1639,8.5,154763,142291,12471,8.1
Lincoln,9/1/2012,19383,17963,1420,7.3,155160,143044,12115,7.8
Lincoln,10/1/2012,19777,18366,1411,7.1,155554,143431,12124,7.8
Lincoln,11/1/2012,19635,18333,1302,6.6,155338,143333,12005,7.7
Lincoln,12/1/2012,19592,18171,1421,7.3,155628,143330,12298,7.9
Lincoln,1/1/2013,20452,18783,1669,8.2,155763,143292,12471,8
Lincoln,2/1/2013,20559,19114,1445,7,155312,143362,11950,7.7
Lincoln,3/1/2013,20647,19189,1458,7.1,155005,143316,11689,7.5
Lincoln,4/1/2013,20986,19500,1486,7.1,155394,143635,11760,7.6
Lincoln,5/1/2013,21130,19436,1694,8,155536,143882,11654,7.5
Lincoln,6/1/2013,20770,18691,2079,10,155749,143999,11751,7.5
Lincoln,7/1/2013,20061,18246,1815,9,155599,144264,11335,7.3
Lincoln,8/1/2013,19687,18028,1659,8.4,155605,144326,11279,7.2
Lincoln,9/1/2013,20210,18754,1456,7.2,155687,144418,11270,7.2
Lincoln,10/1/2013,20782,19377,1405,6.8,154673,143537,11136,7.2
Lincoln,11/1/2013,20724,19518,1206,5.8,155265,144479,10787,6.9
Lincoln,12/1/2013,20511,19399,1112,5.4,155182,144778,10404,6.7
Lincoln,1/1/2014,19847,18619,1228,6.2,155352,145150,10202,6.6
Lincoln,2/1/2014,20118,18920,1198,6,155483,145134,10349,6.7
Lincoln,3/1/2014,20407,19102,1305,6.4,156028,145648,10380,6.7
Lincoln,4/1/2014,20705,19450,1255,6.1,155369,145667,9702,6.2
Lincoln,5/1/2014,20787,19265,1522,7.3,155684,145825,9859,6.3
Lincoln,6/1/2014,20604,18714,1890,9.2,155707,146247,9460,6.1
Lincoln,7/1/2014,20166,18297,1869,9.3,156007,146399,9608,6.2
Lincoln,8/1/2014,20031,18258,1773,8.9,156130,146530,9599,6.1
Lincoln,9/1/2014,20505,18889,1616,7.9,156040,146778,9262,5.9
Lincoln,10/1/2014,21205,19609,1596,7.5,156417,147427,8990,5.7
Lincoln,11/1/2014,21258,19729,1529,7.2,156494,147404,9090,5.8
Lincoln,12/1/2014,21061,19676,1385,6.6,156332,147615,8717,5.6
Lincoln,1/1/2015,20632,19076,1556,7.5,157030,148145,8885,5.7
Lincoln,2/1/2015,20949,19526,1423,6.8,156644,148045,8599,5.5
Lincoln,3/1/2015,21044,19598,1446,6.9,156643,148128,8515,5.4
Lincoln,4/1/2015,21430,20011,1419,6.6,157060,148511,8550,5.4
Lincoln,5/1/2015,21555,19994,1561,7.2,157651,148817,8834,5.6
Lincoln,6/1/2015,21082,19269,1813,8.6,157062,148816,8247,5.3
Lincoln,7/1/2015,20391,18746,1645,8.1,156997,148830,8167,5.2
Lincoln,8/1/2015,20014,18511,1503,7.5,157172,149181,7992,5.1
Lincoln,9/1/2015,20401,19035,1366,6.7,156733,148826,7907,5
Lincoln,10/1/2015,21320,20015,1305,6.1,157167,149246,7922,5
Lincoln,11/1/2015,21376,20142,1234,5.8,157463,149463,8000,5.1
Lincoln,12/1/2015,21236,20120,1116,5.3,158035,150128,7907,5
Lincoln,1/1/2016,21146,19827,1319,6.2,158280,150653,7627,4.8
Lincoln,2/1/2016,21494,20240,1254,5.8,158640,150939,7702,4.9
Lincoln,3/1/2016,21664,20387,1277,5.9,159179,151218,7961,5
Lincoln,4/1/2016,21892,20653,1239,5.7,159141,151074,8067,5.1
Lincoln,5/1/2016,21892,20568,1324,6,158784,151132,7652,4.8
Lincoln,6/1/2016,21831,20142,1689,7.7,158967,151223,7744,4.9
Lincoln,7/1/2016,20999,19458,1541,7.3,159194,151554,7641,4.8
Lincoln,8/1/2016,20476,19038,1438,7,159562,151779,7784,4.9
Lincoln,9/1/2016,21186,19843,1343,6.3,159714,151761,7953,5
Lincoln,10/1/2016,21665,20468,1197,5.5,159605,151793,7811,4.9
Lincoln,11/1/2016,21770,20589,1181,5.4,159506,151954,7553,4.7
Lincoln,12/1/2016,21466,20357,1109,5.2,159678,152157,7521,4.7
Lincoln,1/1/2017,21229,19945,1284,6,159620,152152,7468,4.7
Lincoln,2/1/2017,21446,20296,1150,5.4,159859,152480,7379,4.6
Lincoln,3/1/2017,21614,20458,1156,5.3,160137,153065,7073,4.4
Lincoln,4/1/2017,21951,20853,1098,5,160345,153255,7089,4.4
Lincoln,5/1/2017,21818,20749,1069,4.9,160068,153069,7000,4.4
Lincoln,6/1/2017,21260,19931,1329,6.3,160192,153318,6873,4.3
Lincoln,7/1/2017,20978,19729,1249,6,160462,153569,6892,4.3
Lincoln,8/1/2017,20768,19583,1185,5.7,160586,153503,7082,4.4
Lincoln,9/1/2017,21559,20502,1057,4.9,161140,154286,6854,4.3
Lincoln,10/1/2017,21920,21008,912,4.2,160309,153609,6700,4.2
Lincoln,11/1/2017,22073,21099,974,4.4,160579,153805,6774,4.2
Lincoln,12/1/2017,21831,20937,894,4.1,160535,153904,6632,4.1
Lincoln,1/1/2018,21644,20613,1031,4.8,160914,154425,6489,4
Lincoln,2/1/2018,22035,21064,971,4.4,161778,155197,6581,4.1
Lincoln,3/1/2018,22153,21129,1024,4.6,161686,155214,6472,4
Lincoln,4/1/2018,22296,21291,1005,4.5,161771,155312,6459,4
Lincoln,5/1/2018,22310,21269,1041,4.7,161848,155652,6196,3.8
Lincoln,6/1/2018,21869,20395,1474,6.7,162210,155762,6447,4
Lincoln,7/1/2018,21498,20123,1375,6.4,162341,156146,6195,3.8
Lincoln,8/1/2018,20982,19705,1277,6.1,161660,155504,6156,3.8
Lincoln,9/1/2018,21878,20728,1150,5.3,162087,156015,6073,3.7
Lincoln,10/1/2018,22521,21428,1093,4.9,162602,156391,6211,3.8
Lincoln,11/1/2018,22382,21332,1050,4.7,162836,156721,6115,3.8
Lincoln,12/1/2018,22114,21126,988,4.5,163206,156817,6389,3.9
Lincoln,1/1/2019,21828,20575,1253,5.7,162963,156487,6475,4
Lincoln,2/1/2019,21776,20785,991,4.6,162999,156863,6136,3.8
Lincoln,3/1/2019,22032,21063,969,4.4,162904,156701,6202,3.8
Lincoln,4/1/2019,22089,21213,876,4,162586,156625,5961,3.7
Lincoln,5/1/2019,22271,21188,1083,4.9,162751,156821,5930,3.6
Lincoln,6/1/2019,21550,20161,1389,6.4,163168,157232,5935,3.6
Lincoln,7/1/2019,21258,19963,1295,6.1,163590,157529,6061,3.7
Lincoln,8/1/2019,21105,19871,1234,5.8,163774,157829,5945,3.6
Lincoln,9/1/2019,22102,20880,1222,5.5,164092,158339,5753,3.5
Lincoln,10/1/2019,22401,21247,1154,5.2,164416,158545,5871,3.6
Lincoln,11/1/2019,22446,21323,1123,5,164496,158629,5868,3.6
Lincoln,12/1/2019,21949,20931,1018,4.6,164699,158845,5853,3.6
Lincoln,1/1/2020,21744,20597,1147,5.3,164377,158508,5869,3.6
Lincoln,2/1/2020,21533,20699,834,3.9,164467,158714,5753,3.5
Lincoln,3/1/2020,21896,20360,1536,7,162559,155353,7206,4.4
Lincoln,4/1/2020,19467,17937,1530,7.9,156269,133185,23084,14.8
Lincoln,5/1/2020,20099,18346,1753,8.7,158101,137173,20929,13.2
Lincoln,6/1/2020,20409,18622,1787,8.8,159994,142342,17652,11
Lincoln,7/1/2020,20092,18384,1708,8.5,160132,143779,16352,10.2
Lincoln,8/1/2020,20341,18938,1403,6.9,160706,147245,13461,8.4
Lincoln,9/1/2020,20812,19427,1385,6.7,160174,147620,12554,7.8
Lincoln,10/1/2020,21452,20223,1229,5.7,161003,149931,11072,6.9
Lincoln,11/1/2020,21261,20168,1093,5.1,160629,149934,10694,6.7
Lincoln,12/1/2020,21117,19984,1133,5.4,160745,149975,10770,6.7
Lincoln,1/1/2021,20906,19740,1166,5.6,160088,149852,10236,6.4
Lincoln,2/1/2021,21048,19987,1061,5,160184,150189,9995,6.2
Lincoln,3/1/2021,21073,20062,1011,4.8,160400,150644,9756,6.1
Lincoln,4/1/2021,21459,20494,965,4.5,160843,151081,9762,6.1
Lincoln,5/1/2021,21147,20141,1006,4.8,160800,151535,9266,5.8
Lincoln,6/1/2021,20328,19108,1220,6,161197,151734,9462,5.9
Lincoln,7/1/2021,20308,19247,1061,5.2,161504,152773,8731,5.4
Lincoln,8/1/2021,20269,19345,924,4.6,161527,153250,8276,5.1
Lincoln,9/1/2021,21257,20442,815,3.8,161495,153843,7652,4.7
Lincoln,10/1/2021,21342,20603,739,3.5,161754,154475,7279,4.5
Lincoln,11/1/2021,21602,20928,674,3.1,162281,155530,6751,4.2
Lincoln,12/1/2021,21393,20792,601,2.8,162497,156099,6398,3.9
Lincoln,1/1/2022,20976,20245,731,3.5,163627,157115,6512,4
Lincoln,2/1/2022,21122,20467,655,3.1,163899,157598,6301,3.8
Lincoln,3/1/2022,21389,20733,656,3.1,164220,158206,6014,3.7
Lincoln,4/1/2022,21340,20738,602,2.8,163893,157891,6002,3.7
Lincoln,5/1/2022,20935,20222,713,3.4,164362,158378,5983,3.6
Lincoln,6/1/2022,20948,19938,1010,4.8,164046,158094,5951,3.6
Lincoln,7/1/2022,20497,19618,879,4.3,164026,158258,5768,3.5
Lincoln,8/1/2022,20196,19350,846,4.2,164654,158735,5919,3.6
Lincoln,9/1/2022,21277,20525,752,3.5,164602,158810,5792,3.5
Lincoln,10/1/2022,21518,20826,692,3.2,164648,158684,5964,3.6
Lincoln,11/1/2022,21691,21008,683,3.1,164450,158507,5943,3.6
Lincoln,12/1/2022,21396,20729,667,3.1,165025,159259,5766,3.5
Lincoln,1/1/2023,20908,20171,737,3.5,165964,160217,5747,3.5
Lincoln,2/1/2023,21377,20675,702,3.3,166358,160395,5962,3.6
Lincoln,3/1/2023,21904,21211,693,3.2,166651,160812,5839,3.5
Lincoln,4/1/2023,21789,21163,626,2.9,166725,160974,5751,3.4
Lincoln,5/1/2023,21020,20257,763,3.6,166886,160796,6089,3.6
Lincoln,6/1/2023,20529,19514,1015,4.9,166937,160979,5958,3.6
Lincoln,7/1/2023,20200,19392,808,4,167103,161183,5920,3.5
Lincoln,8/1/2023,20186,19317,869,4.3,167759,161475,6284,3.7
Lincoln,9/1/2023,21509,20639,870,4,167767,161442,6326,3.8
Lincoln,10/1/2023,21634,20733,901,4.2,167690,161211,6479,3.9
Lincoln,11/1/2023,21798,20933,865,4,168140,161886,6254,3.7
Lincoln,12/1/2023,21313,20471,842,4,167439,161124,6315,3.8
Lincoln,1/1/2024,20936,20043,893,4.3,167339,161190,6149,3.7
Lincoln,2/1/2024,21254,20371,883,4.2,167475,161013,6462,3.9
Lincoln,3/1/2024,21553,20657,896,4.2,167922,161425,6497,3.9
Lincoln,4/1/2024,21432,20658,774,3.6,167988,161495,6492,3.9
Lincoln,5/1/2024,20687,19829,858,4.1,167799,161164,6635,4
Lincoln,6/1/2024,20539,19351,1188,5.8,168005,161155,6849,4.1
Lincoln,7/1/2024,20329,19242,1087,5.3,168315,161219,7097,4.2
Lincoln,8/1/2024,20428,19253,1175,5.8,168496,161425,7071,4.2
Lincoln,9/1/2024,21625,20539,1086,5,168703,161802,6901,4.1
Lincoln,10/1/2024,21553,20523,1030,4.8,168428,161456,6972,4.1
Lincoln,11/1/2024,21535,20482,1053,4.9,168304,161183,7121,4.2
Lincoln,12/1/2024,21106,20181,925,4.4,168547,161661,6886,4.1
Lincoln,1/1/2025,20994,20050,944,4.5,170744,163895,6849,4
Lincoln,2/1/2025,21097,20181,916,4.3,170359,163307,7052,4.1
Livingston,1/1/1990,32196,30005,2191,6.8,125833,119081,6752,5.4
Livingston,2/1/1990,32478,30464,2014,6.2,125710,119059,6651,5.3
Livingston,3/1/1990,32722,30699,2023,6.2,125801,119203,6598,5.2
Livingston,4/1/1990,32932,30698,2234,6.8,125649,118852,6797,5.4
Livingston,5/1/1990,32733,30643,2090,6.4,125893,119151,6742,5.4
Livingston,6/1/1990,33643,30980,2663,7.9,125573,118983,6590,5.2
Livingston,7/1/1990,33810,31257,2553,7.6,125732,118810,6922,5.5
Livingston,8/1/1990,33265,30706,2559,7.7,125990,118802,7188,5.7
Livingston,9/1/1990,33354,30669,2685,8.1,125892,118524,7368,5.9
Livingston,10/1/1990,33292,31047,2245,6.7,125995,118536,7459,5.9
Livingston,11/1/1990,33614,31229,2385,7.1,126070,118306,7764,6.2
Livingston,12/1/1990,33807,31138,2669,7.9,126142,118241,7901,6.3
Livingston,1/1/1991,33358,30441,2917,8.7,125955,117940,8015,6.4
Livingston,2/1/1991,33613,30932,2681,8,126020,117755,8265,6.6
Livingston,3/1/1991,33642,31192,2450,7.3,126238,117652,8586,6.8
Livingston,4/1/1991,33973,31471,2502,7.4,126548,118109,8439,6.7
Livingston,5/1/1991,33913,31012,2901,8.6,126176,117440,8736,6.9
Livingston,6/1/1991,35357,31567,3790,10.7,126331,117639,8692,6.9
Livingston,7/1/1991,35516,32049,3467,9.8,126154,117568,8586,6.8
Livingston,8/1/1991,34789,31374,3415,9.8,126150,117484,8666,6.9
Livingston,9/1/1991,34728,31808,2920,8.4,126650,117928,8722,6.9
Livingston,10/1/1991,34288,31756,2532,7.4,126642,117800,8842,7
Livingston,11/1/1991,34271,31823,2448,7.1,126701,117770,8931,7
Livingston,12/1/1991,34174,31671,2503,7.3,126664,117466,9198,7.3
Livingston,1/1/1992,33976,31188,2788,8.2,127261,117978,9283,7.3
Livingston,2/1/1992,34041,31763,2278,6.7,127207,117753,9454,7.4
Livingston,3/1/1992,34301,32060,2241,6.5,127604,118144,9460,7.4
Livingston,4/1/1992,34412,32201,2211,6.4,127841,118426,9415,7.4
Livingston,5/1/1992,34179,31980,2199,6.4,128119,118375,9744,7.6
Livingston,6/1/1992,35365,32567,2798,7.9,128459,118419,10040,7.8
Livingston,7/1/1992,36793,33933,2860,7.8,128563,118713,9850,7.7
Livingston,8/1/1992,36254,33430,2824,7.8,128613,118826,9787,7.6
Livingston,9/1/1992,35877,33156,2721,7.6,128501,118720,9781,7.6
Livingston,10/1/1992,35267,33139,2128,6,128026,118628,9398,7.3
Livingston,11/1/1992,35325,33031,2294,6.5,128441,118876,9565,7.4
Livingston,12/1/1992,34467,32008,2459,7.1,128554,118997,9557,7.4
Livingston,1/1/1993,34671,31747,2924,8.4,128400,119075,9325,7.3
Livingston,2/1/1993,34715,32283,2432,7,128458,119275,9183,7.1
Livingston,3/1/1993,34785,32316,2469,7.1,128598,119542,9056,7
Livingston,4/1/1993,34987,32470,2517,7.2,128584,119474,9110,7.1
Livingston,5/1/1993,35082,32409,2673,7.6,129264,120115,9149,7.1
Livingston,6/1/1993,35713,32589,3124,8.7,129411,120290,9121,7
Livingston,7/1/1993,35929,32812,3117,8.7,129397,120467,8930,6.9
Livingston,8/1/1993,35450,32241,3209,9.1,129619,120856,8763,6.8
Livingston,9/1/1993,35363,32323,3040,8.6,129268,120554,8714,6.7
Livingston,10/1/1993,35576,32542,3034,8.5,129573,120823,8750,6.8
Livingston,11/1/1993,35751,32771,2980,8.3,129711,121169,8542,6.6
Livingston,12/1/1993,35548,32450,3098,8.7,129941,121464,8477,6.5
Livingston,1/1/1994,36045,32428,3617,10,130596,121966,8630,6.6
Livingston,2/1/1994,36191,33083,3108,8.6,130669,122086,8583,6.6
Livingston,3/1/1994,36251,33077,3174,8.8,130400,121930,8470,6.5
Livingston,4/1/1994,36026,32860,3166,8.8,130621,122290,8331,6.4
Livingston,5/1/1994,36375,32861,3514,9.7,130779,122864,7915,6.1
Livingston,6/1/1994,37189,33276,3913,10.5,130561,122634,7927,6.1
Livingston,7/1/1994,37154,33657,3497,9.4,130652,122706,7946,6.1
Livingston,8/1/1994,36924,33464,3460,9.4,131275,123342,7933,6
Livingston,9/1/1994,36928,33856,3072,8.3,131421,123687,7734,5.9
Livingston,10/1/1994,36641,33893,2748,7.5,131744,124112,7632,5.8
Livingston,11/1/1994,36522,34056,2466,6.8,131891,124516,7375,5.6
Livingston,12/1/1994,36230,33736,2494,6.9,131951,124721,7230,5.5
Livingston,1/1/1995,37032,33816,3216,8.7,132038,124663,7375,5.6
Livingston,2/1/1995,37081,34366,2715,7.3,132115,124928,7187,5.4
Livingston,3/1/1995,37646,34613,3033,8.1,132108,124955,7153,5.4
Livingston,4/1/1995,37653,34556,3097,8.2,132590,124945,7645,5.8
Livingston,5/1/1995,37346,34253,3093,8.3,131851,124421,7430,5.6
Livingston,6/1/1995,37773,34542,3231,8.6,131949,124522,7427,5.6
Livingston,7/1/1995,38018,35169,2849,7.5,132343,124816,7527,5.7
Livingston,8/1/1995,37358,34551,2807,7.5,132336,124852,7484,5.7
Livingston,9/1/1995,37368,34668,2700,7.2,132611,125133,7478,5.6
Livingston,10/1/1995,37422,35092,2330,6.2,132716,125388,7328,5.5
Livingston,11/1/1995,37703,35305,2398,6.4,132614,125188,7426,5.6
Livingston,12/1/1995,37240,34718,2522,6.8,132511,125088,7423,5.6
Livingston,1/1/1996,37914,34803,3111,8.2,132616,125125,7491,5.6
Livingston,2/1/1996,38314,35604,2710,7.1,132952,125639,7313,5.5
Livingston,3/1/1996,38492,36022,2470,6.4,133180,125862,7318,5.5
Livingston,4/1/1996,38486,35823,2663,6.9,133409,125994,7415,5.6
Livingston,5/1/1996,38533,35877,2656,6.9,133667,126244,7423,5.6
Livingston,6/1/1996,39327,36329,2998,7.6,133697,126602,7095,5.3
Livingston,7/1/1996,39581,36572,3009,7.6,134284,126947,7337,5.5
Livingston,8/1/1996,39110,36309,2801,7.2,134054,127172,6882,5.1
Livingston,9/1/1996,39278,36650,2628,6.7,134515,127536,6979,5.2
Livingston,10/1/1996,39451,37052,2399,6.1,134921,127890,7031,5.2
Livingston,11/1/1996,39316,37146,2170,5.5,135007,127771,7236,5.4
Livingston,12/1/1996,38790,36654,2136,5.5,135113,127860,7253,5.4
Livingston,1/1/1997,39036,36587,2449,6.3,135456,128298,7158,5.3
Livingston,2/1/1997,39061,37058,2003,5.1,135400,128298,7102,5.2
Livingston,3/1/1997,39642,37588,2054,5.2,135891,128891,7000,5.2
Livingston,4/1/1997,39541,37397,2144,5.4,136016,129143,6873,5.1
Livingston,5/1/1997,39235,36982,2253,5.7,136119,129464,6655,4.9
Livingston,6/1/1997,40058,37182,2876,7.2,136211,129412,6799,5
Livingston,7/1/1997,40276,37493,2783,6.9,136477,129822,6655,4.9
Livingston,8/1/1997,39525,37121,2404,6.1,136618,130010,6608,4.8
Livingston,9/1/1997,39663,37396,2267,5.7,136675,130019,6656,4.9
Livingston,10/1/1997,39838,37852,1986,5,136633,130179,6454,4.7
Livingston,11/1/1997,40029,38185,1844,4.6,136961,130653,6308,4.6
Livingston,12/1/1997,39896,38056,1840,4.6,137155,130679,6476,4.7
Livingston,1/1/1998,39990,37908,2082,5.2,137095,130726,6368,4.6
Livingston,2/1/1998,40328,38591,1737,4.3,137112,130807,6306,4.6
Livingston,3/1/1998,40777,38844,1933,4.7,137236,130814,6422,4.7
Livingston,4/1/1998,41316,39251,2065,5,137150,131209,5941,4.3
Livingston,5/1/1998,41234,39115,2119,5.1,137372,131325,6047,4.4
Livingston,6/1/1998,41722,39279,2443,5.9,137455,131244,6212,4.5
Livingston,7/1/1998,41822,39667,2155,5.2,137588,131329,6259,4.5
Livingston,8/1/1998,41669,39424,2245,5.4,137570,131390,6179,4.5
Livingston,9/1/1998,42012,39656,2356,5.6,138286,131986,6300,4.6
Livingston,10/1/1998,42044,40134,1910,4.5,138279,131999,6280,4.5
Livingston,11/1/1998,42031,40259,1772,4.2,138381,132280,6100,4.4
Livingston,12/1/1998,42050,40185,1865,4.4,138634,132602,6032,4.4
Livingston,1/1/1999,42399,40281,2118,5,139003,133027,5976,4.3
Livingston,2/1/1999,42787,40996,1791,4.2,138967,132856,6111,4.4
Livingston,3/1/1999,42678,41028,1650,3.9,138730,132947,5783,4.2
Livingston,4/1/1999,42997,41253,1744,4.1,138959,132955,6004,4.3
Livingston,5/1/1999,42899,41042,1857,4.3,139107,133311,5796,4.2
Livingston,6/1/1999,43841,41468,2373,5.4,139329,133378,5951,4.3
Livingston,7/1/1999,44236,41837,2399,5.4,139439,133414,6025,4.3
Livingston,8/1/1999,44046,41707,2339,5.3,139430,133591,5838,4.2
Livingston,9/1/1999,44248,41903,2345,5.3,139622,133707,5915,4.2
Livingston,10/1/1999,44384,42303,2081,4.7,139771,133993,5778,4.1
Livingston,11/1/1999,44419,42596,1823,4.1,140025,134309,5716,4.1
Livingston,12/1/1999,44307,42401,1906,4.3,140177,134523,5653,4
Livingston,1/1/2000,44612,42028,2584,5.8,142267,136559,5708,4
Livingston,2/1/2000,44817,42496,2321,5.2,142456,136598,5858,4.1
Livingston,3/1/2000,45008,42665,2343,5.2,142434,136701,5733,4
Livingston,4/1/2000,45212,43130,2082,4.6,142751,137270,5481,3.8
Livingston,5/1/2000,44729,42320,2409,5.4,142388,136630,5758,4
Livingston,6/1/2000,45460,42639,2821,6.2,142591,136940,5651,4
Livingston,7/1/2000,44302,41717,2585,5.8,142278,136531,5747,4
Livingston,8/1/2000,44243,41681,2562,5.8,142514,136662,5853,4.1
Livingston,9/1/2000,44179,41677,2502,5.7,142518,136893,5625,3.9
Livingston,10/1/2000,44174,41807,2367,5.4,142622,137088,5534,3.9
Livingston,11/1/2000,44292,41904,2388,5.4,142962,137322,5639,3.9
Livingston,12/1/2000,44183,41864,2319,5.2,143248,137614,5634,3.9
Livingston,1/1/2001,45337,42702,2635,5.8,143800,137778,6023,4.2
Livingston,2/1/2001,44947,42753,2194,4.9,143701,137612,6089,4.2
Livingston,3/1/2001,44958,42718,2240,5,143924,137783,6141,4.3
Livingston,4/1/2001,45306,42985,2321,5.1,143569,137299,6271,4.4
Livingston,5/1/2001,45114,42810,2304,5.1,143318,137092,6226,4.3
Livingston,6/1/2001,45709,42955,2754,6,143357,136873,6484,4.5
Livingston,7/1/2001,45052,42577,2475,5.5,143654,137071,6583,4.6
Livingston,8/1/2001,44692,42229,2463,5.5,143284,136241,7042,4.9
Livingston,9/1/2001,44964,42412,2552,5.7,143989,136846,7142,5
Livingston,10/1/2001,45608,43060,2548,5.6,144086,136392,7694,5.3
Livingston,11/1/2001,45707,42995,2712,5.9,144240,136238,8003,5.5
Livingston,12/1/2001,45528,42823,2705,5.9,144305,136047,8258,5.7
Livingston,1/1/2002,45983,43010,2973,6.5,143883,135701,8182,5.7
Livingston,2/1/2002,46187,43564,2623,5.7,144653,136438,8215,5.7
Livingston,3/1/2002,46148,43477,2671,5.8,144481,136177,8304,5.7
Livingston,4/1/2002,46693,43913,2780,6,144725,136126,8599,5.9
Livingston,5/1/2002,46375,43502,2873,6.2,144938,136539,8399,5.8
Livingston,6/1/2002,47095,43830,3265,6.9,144808,136415,8393,5.8
Livingston,7/1/2002,46660,43650,3010,6.5,144803,136413,8390,5.8
Livingston,8/1/2002,46535,43581,2954,6.3,145009,136705,8304,5.7
Livingston,9/1/2002,46656,43877,2779,6,145552,137302,8251,5.7
Livingston,10/1/2002,46923,44248,2675,5.7,145314,137008,8307,5.7
Livingston,11/1/2002,46692,43944,2748,5.9,145041,136521,8520,5.9
Livingston,12/1/2002,46449,43607,2842,6.1,145066,136426,8640,6
Livingston,1/1/2003,47496,44216,3280,6.9,145937,137417,8520,5.8
Livingston,2/1/2003,47959,45013,2946,6.1,146100,137482,8618,5.9
Livingston,3/1/2003,48064,44916,3148,6.5,146022,137434,8588,5.9
Livingston,4/1/2003,48564,45527,3037,6.3,146474,137633,8842,6
Livingston,5/1/2003,48229,44996,3233,6.7,146500,137544,8957,6.1
Livingston,6/1/2003,48935,44924,4011,8.2,147056,137790,9266,6.3
Livingston,7/1/2003,48922,45246,3676,7.5,146485,137474,9011,6.2
Livingston,8/1/2003,48348,44928,3420,7.1,146445,137549,8896,6.1
Livingston,9/1/2003,48180,44989,3191,6.6,146530,137609,8921,6.1
Livingston,10/1/2003,48543,45675,2868,5.9,146716,137984,8732,6
Livingston,11/1/2003,48533,45561,2972,6.1,147000,138424,8576,5.8
Livingston,12/1/2003,48094,45248,2846,5.9,146729,138411,8317,5.7
Livingston,1/1/2004,49565,46115,3450,7,146842,138472,8370,5.7
Livingston,2/1/2004,49759,46849,2910,5.8,146709,138542,8167,5.6
Livingston,3/1/2004,50163,47199,2964,5.9,146944,138453,8491,5.8
Livingston,4/1/2004,50549,47313,3236,6.4,146850,138680,8170,5.6
Livingston,5/1/2004,49935,46665,3270,6.5,147065,138852,8212,5.6
Livingston,6/1/2004,50972,47144,3828,7.5,147460,139174,8286,5.6
Livingston,7/1/2004,50811,47374,3437,6.8,147692,139556,8136,5.5
Livingston,8/1/2004,50385,47210,3175,6.3,147564,139573,7990,5.4
Livingston,9/1/2004,50280,47194,3086,6.1,147415,139487,7927,5.4
Livingston,10/1/2004,50625,47649,2976,5.9,147793,139732,8061,5.5
Livingston,11/1/2004,50833,47972,2861,5.6,148162,140231,7932,5.4
Livingston,12/1/2004,50466,47666,2800,5.5,148059,140125,7934,5.4
Livingston,1/1/2005,50992,47903,3089,6.1,148029,140245,7784,5.3
Livingston,2/1/2005,51236,48559,2677,5.2,148364,140385,7980,5.4
Livingston,3/1/2005,51477,48937,2540,4.9,148391,140654,7737,5.2
Livingston,4/1/2005,52177,49713,2464,4.7,148926,141254,7672,5.2
Livingston,5/1/2005,51577,48943,2634,5.1,149261,141609,7651,5.1
Livingston,6/1/2005,52291,49117,3174,6.1,149238,141714,7524,5
Livingston,7/1/2005,52393,49407,2986,5.7,149432,142026,7406,5
Livingston,8/1/2005,52121,49415,2706,5.2,149779,142434,7345,4.9
Livingston,9/1/2005,58037,53225,4812,8.3,149954,142401,7553,5
Livingston,10/1/2005,58343,54185,4158,7.1,150001,142548,7453,5
Livingston,11/1/2005,58450,54248,4202,7.2,150065,142499,7566,5
Livingston,12/1/2005,55969,53604,2365,4.2,150030,142752,7279,4.9
Livingston,1/1/2006,54746,52729,2017,3.7,150214,143150,7064,4.7
Livingston,2/1/2006,55170,53388,1782,3.2,150641,143457,7184,4.8
Livingston,3/1/2006,55363,53520,1843,3.3,150813,143741,7072,4.7
Livingston,4/1/2006,55184,53301,1883,3.4,150881,143761,7120,4.7
Livingston,5/1/2006,55009,52886,2123,3.9,151069,144089,6980,4.6
Livingston,6/1/2006,55220,52568,2652,4.8,151354,144353,7001,4.6
Livingston,7/1/2006,54313,52086,2227,4.1,151377,144202,7175,4.7
Livingston,8/1/2006,54437,52242,2195,4,151716,144625,7091,4.7
Livingston,9/1/2006,54438,52297,2141,3.9,151662,144815,6847,4.5
Livingston,10/1/2006,54944,52961,1983,3.6,152041,145314,6727,4.4
Livingston,11/1/2006,54997,52949,2048,3.7,152406,145534,6872,4.5
Livingston,12/1/2006,54918,53009,1909,3.5,152732,145970,6762,4.4
Livingston,1/1/2007,54675,52495,2180,4,153144,146028,7116,4.6
Livingston,2/1/2007,54940,53094,1846,3.4,152983,146057,6927,4.5
Livingston,3/1/2007,55553,53697,1856,3.3,153051,146320,6731,4.4
Livingston,4/1/2007,55711,53822,1889,3.4,152435,145586,6850,4.5
Livingston,5/1/2007,55795,53695,2100,3.8,152670,145903,6766,4.4
Livingston,6/1/2007,56598,54075,2523,4.5,153041,146063,6979,4.6
Livingston,7/1/2007,56888,54487,2401,4.2,153054,145905,7149,4.7
Livingston,8/1/2007,56088,53926,2162,3.9,152749,145682,7067,4.6
Livingston,9/1/2007,56429,54281,2148,3.8,153414,146244,7170,4.7
Livingston,10/1/2007,56681,54728,1953,3.4,153183,145946,7237,4.7
Livingston,11/1/2007,56931,54991,1940,3.4,153835,146595,7240,4.7
Livingston,12/1/2007,56740,54683,2057,3.6,153918,146273,7645,5
Livingston,1/1/2008,56978,54625,2353,4.1,154063,146378,7685,5
Livingston,2/1/2008,57058,55088,1970,3.5,153653,146156,7497,4.9
Livingston,3/1/2008,57577,55473,2104,3.7,153908,146086,7822,5.1
Livingston,4/1/2008,57907,55994,1913,3.3,153769,146132,7637,5
Livingston,5/1/2008,57803,55624,2179,3.8,154303,145908,8395,5.4
Livingston,6/1/2008,58960,56229,2731,4.6,154313,145737,8575,5.6
Livingston,7/1/2008,58898,56273,2625,4.5,154469,145532,8937,5.8
Livingston,8/1/2008,58230,55682,2548,4.4,154641,145203,9438,6.1
Livingston,9/1/2008,58434,55783,2651,4.5,154570,145076,9494,6.1
Livingston,10/1/2008,59053,56467,2586,4.4,154876,144802,10074,6.5
Livingston,11/1/2008,58997,56433,2564,4.3,154639,144100,10538,6.8
Livingston,12/1/2008,58849,56154,2695,4.6,154655,143369,11286,7.3
Livingston,1/1/2009,58414,55171,3243,5.6,154210,142152,12058,7.8
Livingston,2/1/2009,58774,55635,3139,5.3,154538,141640,12898,8.3
Livingston,3/1/2009,59138,55890,3248,5.5,154133,140707,13426,8.7
Livingston,4/1/2009,59476,56203,3273,5.5,154509,140656,13853,9
Livingston,5/1/2009,59226,55686,3540,6,154747,140248,14499,9.4
Livingston,6/1/2009,60010,55796,4214,7,154716,140009,14707,9.5
Livingston,7/1/2009,60379,56428,3951,6.5,154502,139901,14601,9.5
Livingston,8/1/2009,59724,55962,3762,6.3,154307,139492,14814,9.6
Livingston,9/1/2009,59806,56148,3658,6.1,153827,138818,15009,9.8
Livingston,10/1/2009,59484,55981,3503,5.9,153784,138432,15352,10
Livingston,11/1/2009,59597,56161,3436,5.8,153878,138659,15219,9.9
Livingston,12/1/2009,58910,55264,3646,6.2,153111,138013,15098,9.9
Livingston,1/1/2010,60609,56354,4255,7,153484,138438,15046,9.8
Livingston,2/1/2010,60616,56785,3831,6.3,153694,138581,15113,9.8
Livingston,3/1/2010,61192,57251,3941,6.4,153954,138751,15202,9.9
Livingston,4/1/2010,61435,57542,3893,6.3,154622,139297,15325,9.9
Livingston,5/1/2010,61390,57083,4307,7,154091,139241,14849,9.6
Livingston,6/1/2010,62068,57249,4819,7.8,153616,139141,14474,9.4
Livingston,7/1/2010,61870,57219,4651,7.5,153691,139179,14512,9.4
Livingston,8/1/2010,61781,57175,4606,7.5,154086,139438,14648,9.5
Livingston,9/1/2010,61642,57144,4498,7.3,153975,139396,14579,9.5
Livingston,10/1/2010,61660,57337,4323,7,153635,139119,14516,9.4
Livingston,11/1/2010,61620,57281,4339,7,154125,139044,15081,9.8
Livingston,12/1/2010,61036,56872,4164,6.8,153650,139301,14348,9.3
Livingston,1/1/2011,61479,56755,4724,7.7,153263,139250,14013,9.1
Livingston,2/1/2011,61700,57402,4298,7,153214,139394,13820,9
Livingston,3/1/2011,61987,57764,4223,6.8,153376,139639,13737,9
Livingston,4/1/2011,61931,57893,4038,6.5,153543,139586,13957,9.1
Livingston,5/1/2011,61702,57474,4228,6.9,153479,139624,13855,9
Livingston,6/1/2011,62017,57238,4779,7.7,153346,139384,13962,9.1
Livingston,7/1/2011,61904,57374,4530,7.3,153288,139524,13763,9
Livingston,8/1/2011,61250,56969,4281,7,153760,139942,13818,9
Livingston,9/1/2011,61840,57664,4176,6.8,154131,140183,13948,9
Livingston,10/1/2011,62198,58221,3977,6.4,153961,140368,13594,8.8
Livingston,11/1/2011,62046,58243,3803,6.1,154128,140826,13302,8.6
Livingston,12/1/2011,61473,57730,3743,6.1,153995,140902,13093,8.5
Livingston,1/1/2012,61702,57457,4245,6.9,154381,141584,12797,8.3
Livingston,2/1/2012,62153,58220,3933,6.3,154671,141858,12813,8.3
Livingston,3/1/2012,62578,58749,3829,6.1,154749,142036,12713,8.2
Livingston,4/1/2012,62467,58895,3572,5.7,154545,141899,12646,8.2
Livingston,5/1/2012,62423,58561,3862,6.2,154866,142206,12660,8.2
Livingston,6/1/2012,63168,58645,4523,7.2,155083,142391,12692,8.2
Livingston,7/1/2012,62653,58399,4254,6.8,154948,142292,12656,8.2
Livingston,8/1/2012,62253,58462,3791,6.1,154763,142291,12471,8.1
Livingston,9/1/2012,62699,59190,3509,5.6,155160,143044,12115,7.8
Livingston,10/1/2012,63072,59651,3421,5.4,155554,143431,12124,7.8
Livingston,11/1/2012,62734,59589,3145,5,155338,143333,12005,7.7
Livingston,12/1/2012,62415,58990,3425,5.5,155628,143330,12298,7.9
Livingston,1/1/2013,62973,58812,4161,6.6,155763,143292,12471,8
Livingston,2/1/2013,63228,59621,3607,5.7,155312,143362,11950,7.7
Livingston,3/1/2013,63719,60163,3556,5.6,155005,143316,11689,7.5
Livingston,4/1/2013,64229,60764,3465,5.4,155394,143635,11760,7.6
Livingston,5/1/2013,64374,60626,3748,5.8,155536,143882,11654,7.5
Livingston,6/1/2013,64957,60679,4278,6.6,155749,143999,11751,7.5
Livingston,7/1/2013,64722,60795,3927,6.1,155599,144264,11335,7.3
Livingston,8/1/2013,64213,60565,3648,5.7,155605,144326,11279,7.2
Livingston,9/1/2013,64510,61064,3446,5.3,155687,144418,11270,7.2
Livingston,10/1/2013,64383,61096,3287,5.1,154673,143537,11136,7.2
Livingston,11/1/2013,64478,61420,3058,4.7,155265,144479,10787,6.9
Livingston,12/1/2013,63575,60780,2795,4.4,155182,144778,10404,6.7
Livingston,1/1/2014,63819,60607,3212,5,155352,145150,10202,6.6
Livingston,2/1/2014,64319,61400,2919,4.5,155483,145134,10349,6.7
Livingston,3/1/2014,65212,62087,3125,4.8,156028,145648,10380,6.7
Livingston,4/1/2014,65384,62448,2936,4.5,155369,145667,9702,6.2
Livingston,5/1/2014,65880,62500,3380,5.1,155684,145825,9859,6.3
Livingston,6/1/2014,66435,62558,3877,5.8,155707,146247,9460,6.1
Livingston,7/1/2014,66974,62839,4135,6.2,156007,146399,9608,6.2
Livingston,8/1/2014,66921,62873,4048,6,156130,146530,9599,6.1
Livingston,9/1/2014,67354,63472,3882,5.8,156040,146778,9262,5.9
Livingston,10/1/2014,68111,64284,3827,5.6,156417,147427,8990,5.7
Livingston,11/1/2014,67673,63802,3871,5.7,156494,147404,9090,5.8
Livingston,12/1/2014,66745,63193,3552,5.3,156332,147615,8717,5.6
Livingston,1/1/2015,67261,63291,3970,5.9,157030,148145,8885,5.7
Livingston,2/1/2015,67427,63874,3553,5.3,156644,148045,8599,5.5
Livingston,3/1/2015,67887,64358,3529,5.2,156643,148128,8515,5.4
Livingston,4/1/2015,68055,64675,3380,5,157060,148511,8550,5.4
Livingston,5/1/2015,68334,64776,3558,5.2,157651,148817,8834,5.6
Livingston,6/1/2015,68436,64641,3795,5.5,157062,148816,8247,5.3
Livingston,7/1/2015,68516,64818,3698,5.4,156997,148830,8167,5.2
Livingston,8/1/2015,67965,64533,3432,5,157172,149181,7992,5.1
Livingston,9/1/2015,67828,64513,3315,4.9,156733,148826,7907,5
Livingston,10/1/2015,68253,65033,3220,4.7,157167,149246,7922,5
Livingston,11/1/2015,68115,65079,3036,4.5,157463,149463,8000,5.1
Livingston,12/1/2015,67333,64482,2851,4.2,158035,150128,7907,5
Livingston,1/1/2016,67763,64295,3468,5.1,158280,150653,7627,4.8
Livingston,2/1/2016,68315,65154,3161,4.6,158640,150939,7702,4.9
Livingston,3/1/2016,69049,65799,3250,4.7,159179,151218,7961,5
Livingston,4/1/2016,68914,65822,3092,4.5,159141,151074,8067,5.1
Livingston,5/1/2016,68614,65426,3188,4.6,158784,151132,7652,4.8
Livingston,6/1/2016,69363,65508,3855,5.6,158967,151223,7744,4.9
Livingston,7/1/2016,69368,65626,3742,5.4,159194,151554,7641,4.8
Livingston,8/1/2016,67904,64414,3490,5.1,159562,151779,7784,4.9
Livingston,9/1/2016,69303,64950,4353,6.3,159714,151761,7953,5
Livingston,10/1/2016,69154,65579,3575,5.2,159605,151793,7811,4.9
Livingston,11/1/2016,68613,65342,3271,4.8,159506,151954,7553,4.7
Livingston,12/1/2016,67556,64471,3085,4.6,159678,152157,7521,4.7
Livingston,1/1/2017,66770,63382,3388,5.1,159620,152152,7468,4.7
Livingston,2/1/2017,67570,64529,3041,4.5,159859,152480,7379,4.6
Livingston,3/1/2017,67818,64927,2891,4.3,160137,153065,7073,4.4
Livingston,4/1/2017,67825,65010,2815,4.2,160345,153255,7089,4.4
Livingston,5/1/2017,67242,64457,2785,4.1,160068,153069,7000,4.4
Livingston,6/1/2017,67727,64499,3228,4.8,160192,153318,6873,4.3
Livingston,7/1/2017,68009,64862,3147,4.6,160462,153569,6892,4.3
Livingston,8/1/2017,67728,64720,3008,4.4,160586,153503,7082,4.4
Livingston,9/1/2017,68066,65283,2783,4.1,161140,154286,6854,4.3
Livingston,10/1/2017,67846,65473,2373,3.5,160309,153609,6700,4.2
Livingston,11/1/2017,67857,65433,2424,3.6,160579,153805,6774,4.2
Livingston,12/1/2017,67203,64881,2322,3.5,160535,153904,6632,4.1
Livingston,1/1/2018,67426,64742,2684,4,160914,154425,6489,4
Livingston,2/1/2018,68283,65775,2508,3.7,161778,155197,6581,4.1
Livingston,3/1/2018,69221,66621,2600,3.8,161686,155214,6472,4
Livingston,4/1/2018,69121,66570,2551,3.7,161771,155312,6459,4
Livingston,5/1/2018,68654,65980,2674,3.9,161848,155652,6196,3.8
Livingston,6/1/2018,69647,66204,3443,4.9,162210,155762,6447,4
Livingston,7/1/2018,69637,66412,3225,4.6,162341,156146,6195,3.8
Livingston,8/1/2018,68599,65680,2919,4.3,161660,155504,6156,3.8
Livingston,9/1/2018,68892,66133,2759,4,162087,156015,6073,3.7
Livingston,10/1/2018,69400,66736,2664,3.8,162602,156391,6211,3.8
Livingston,11/1/2018,69469,66996,2473,3.6,162836,156721,6115,3.8
Livingston,12/1/2018,68825,66379,2446,3.6,163206,156817,6389,3.9
Livingston,1/1/2019,68963,65964,2999,4.3,162963,156487,6475,4
Livingston,2/1/2019,69462,66919,2543,3.7,162999,156863,6136,3.8
Livingston,3/1/2019,69694,67313,2381,3.4,162904,156701,6202,3.8
Livingston,4/1/2019,69236,67051,2185,3.2,162586,156625,5961,3.7
Livingston,5/1/2019,68967,66396,2571,3.7,162751,156821,5930,3.6
Livingston,6/1/2019,69550,66330,3220,4.6,163168,157232,5935,3.6
Livingston,7/1/2019,69270,66140,3130,4.5,163590,157529,6061,3.7
Livingston,8/1/2019,68873,65972,2901,4.2,163774,157829,5945,3.6
Livingston,9/1/2019,69281,66463,2818,4.1,164092,158339,5753,3.5
Livingston,10/1/2019,69511,66758,2753,4,164416,158545,5871,3.6
Livingston,11/1/2019,69611,66947,2664,3.8,164496,158629,5868,3.6
Livingston,12/1/2019,68495,65959,2536,3.7,164699,158845,5853,3.6
Livingston,1/1/2020,68948,66120,2828,4.1,164377,158508,5869,3.6
Livingston,2/1/2020,69190,66958,2232,3.2,164467,158714,5753,3.5
Livingston,3/1/2020,70118,66126,3992,5.7,162559,155353,7206,4.4
Livingston,4/1/2020,65065,57496,7569,11.6,156269,133185,23084,14.8
Livingston,5/1/2020,66147,59178,6969,10.5,158101,137173,20929,13.2
Livingston,6/1/2020,67565,61235,6330,9.4,159994,142342,17652,11
Livingston,7/1/2020,67961,62153,5808,8.5,160132,143779,16352,10.2
Livingston,8/1/2020,68093,63682,4411,6.5,160706,147245,13461,8.4
Livingston,9/1/2020,68967,64578,4389,6.4,160174,147620,12554,7.8
Livingston,10/1/2020,69819,65986,3833,5.5,161003,149931,11072,6.9
Livingston,11/1/2020,69031,65719,3312,4.8,160629,149934,10694,6.7
Livingston,12/1/2020,68599,65234,3365,4.9,160745,149975,10770,6.7
Livingston,1/1/2021,67942,64475,3467,5.1,160088,149852,10236,6.4
Livingston,2/1/2021,68552,65349,3203,4.7,160184,150189,9995,6.2
Livingston,3/1/2021,69108,66131,2977,4.3,160400,150644,9756,6.1
Livingston,4/1/2021,69445,66480,2965,4.3,160843,151081,9762,6.1
Livingston,5/1/2021,69114,66257,2857,4.1,160800,151535,9266,5.8
Livingston,6/1/2021,68901,65557,3344,4.9,161197,151734,9462,5.9
Livingston,7/1/2021,68973,66041,2932,4.3,161504,152773,8731,5.4
Livingston,8/1/2021,68803,66225,2578,3.7,161527,153250,8276,5.1
Livingston,9/1/2021,70513,68104,2409,3.4,161495,153843,7652,4.7
Livingston,10/1/2021,70456,68362,2094,3,161754,154475,7279,4.5
Livingston,11/1/2021,70650,68756,1894,2.7,162281,155530,6751,4.2
Livingston,12/1/2021,70117,68393,1724,2.5,162497,156099,6398,3.9
Livingston,1/1/2022,70356,68191,2165,3.1,163627,157115,6512,4
Livingston,2/1/2022,71295,69334,1961,2.8,163899,157598,6301,3.8
Livingston,3/1/2022,71838,69930,1908,2.7,164220,158206,6014,3.7
Livingston,4/1/2022,71472,69689,1783,2.5,163893,157891,6002,3.7
Livingston,5/1/2022,71250,69324,1926,2.7,164362,158378,5983,3.6
Livingston,6/1/2022,71314,68776,2538,3.6,164046,158094,5951,3.6
Livingston,7/1/2022,71373,69068,2305,3.2,164026,158258,5768,3.5
Livingston,8/1/2022,71155,68999,2156,3,164654,158735,5919,3.6
Livingston,9/1/2022,71279,69217,2062,2.9,164602,158810,5792,3.5
Livingston,10/1/2022,71335,69423,1912,2.7,164648,158684,5964,3.6
Livingston,11/1/2022,71239,69424,1815,2.5,164450,158507,5943,3.6
Livingston,12/1/2022,70863,68990,1873,2.6,165025,159259,5766,3.5
Livingston,1/1/2023,70586,68390,2196,3.1,165964,160217,5747,3.5
Livingston,2/1/2023,71377,69315,2062,2.9,166358,160395,5962,3.6
Livingston,3/1/2023,72032,70087,1945,2.7,166651,160812,5839,3.5
Livingston,4/1/2023,71657,69923,1734,2.4,166725,160974,5751,3.4
Livingston,5/1/2023,71282,69252,2030,2.8,166886,160796,6089,3.6
Livingston,6/1/2023,71281,68815,2466,3.5,166937,160979,5958,3.6
Livingston,7/1/2023,71223,69173,2050,2.9,167103,161183,5920,3.5
Livingston,8/1/2023,71404,69198,2206,3.1,167759,161475,6284,3.7
Livingston,9/1/2023,72114,69792,2322,3.2,167767,161442,6326,3.8
Livingston,10/1/2023,72421,70105,2316,3.2,167690,161211,6479,3.9
Livingston,11/1/2023,72697,70488,2209,3,168140,161886,6254,3.7
Livingston,12/1/2023,71903,69606,2297,3.2,167439,161124,6315,3.8
Livingston,1/1/2024,71641,69072,2569,3.6,167339,161190,6149,3.7
Livingston,2/1/2024,72161,69648,2513,3.5,167475,161013,6462,3.9
Livingston,3/1/2024,73075,70673,2402,3.3,167922,161425,6497,3.9
Livingston,4/1/2024,72687,70616,2071,2.8,167988,161495,6492,3.9
Livingston,5/1/2024,72304,70053,2251,3.1,167799,161164,6635,4
Livingston,6/1/2024,72340,69492,2848,3.9,168005,161155,6849,4.1
Livingston,7/1/2024,72556,69756,2800,3.9,168315,161219,7097,4.2
Livingston,8/1/2024,72324,69561,2763,3.8,168496,161425,7071,4.2
Livingston,9/1/2024,72159,69437,2722,3.8,168703,161802,6901,4.1
Livingston,10/1/2024,72480,69813,2667,3.7,168428,161456,6972,4.1
Livingston,11/1/2024,72422,69820,2602,3.6,168304,161183,7121,4.2
Livingston,12/1/2024,71925,69499,2426,3.4,168547,161661,6886,4.1
Livingston,1/1/2025,70473,67870,2603,3.7,170744,163895,6849,4
Livingston,2/1/2025,71031,68523,2508,3.5,170359,163307,7052,4.1
Madison,1/1/1990,4541,3945,596,13.1,125833,119081,6752,5.4
Madison,2/1/1990,4459,3899,560,12.6,125710,119059,6651,5.3
Madison,3/1/1990,4518,3961,557,12.3,125801,119203,6598,5.2
Madison,4/1/1990,4569,4081,488,10.7,125649,118852,6797,5.4
Madison,5/1/1990,4607,4136,471,10.2,125893,119151,6742,5.4
Madison,6/1/1990,4764,4176,588,12.3,125573,118983,6590,5.2
Madison,7/1/1990,4696,4173,523,11.1,125732,118810,6922,5.5
Madison,8/1/1990,4633,4158,475,10.3,125990,118802,7188,5.7
Madison,9/1/1990,4567,4133,434,9.5,125892,118524,7368,5.9
Madison,10/1/1990,4521,4123,398,8.8,125995,118536,7459,5.9
Madison,11/1/1990,4569,4033,536,11.7,126070,118306,7764,6.2
Madison,12/1/1990,4581,3950,631,13.8,126142,118241,7901,6.3
Madison,1/1/1991,4625,3850,775,16.8,125955,117940,8015,6.4
Madison,2/1/1991,4688,3894,794,16.9,126020,117755,8265,6.6
Madison,3/1/1991,4591,3955,636,13.9,126238,117652,8586,6.8
Madison,4/1/1991,4714,4062,652,13.8,126548,118109,8439,6.7
Madison,5/1/1991,4814,4069,745,15.5,126176,117440,8736,6.9
Madison,6/1/1991,4857,4122,735,15.1,126331,117639,8692,6.9
Madison,7/1/1991,4871,4126,745,15.3,126154,117568,8586,6.8
Madison,8/1/1991,4761,4155,606,12.7,126150,117484,8666,6.9
Madison,9/1/1991,4604,4057,547,11.9,126650,117928,8722,6.9
Madison,10/1/1991,4605,4177,428,9.3,126642,117800,8842,7
Madison,11/1/1991,4666,4155,511,11,126701,117770,8931,7
Madison,12/1/1991,4659,4064,595,12.8,126664,117466,9198,7.3
Madison,1/1/1992,4805,4073,732,15.2,127261,117978,9283,7.3
Madison,2/1/1992,4815,4137,678,14.1,127207,117753,9454,7.4
Madison,3/1/1992,4948,4273,675,13.6,127604,118144,9460,7.4
Madison,4/1/1992,5047,4427,620,12.3,127841,118426,9415,7.4
Madison,5/1/1992,4959,4341,618,12.5,128119,118375,9744,7.6
Madison,6/1/1992,5045,4355,690,13.7,128459,118419,10040,7.8
Madison,7/1/1992,5140,4527,613,11.9,128563,118713,9850,7.7
Madison,8/1/1992,4971,4437,534,10.7,128613,118826,9787,7.6
Madison,9/1/1992,4905,4426,479,9.8,128501,118720,9781,7.6
Madison,10/1/1992,4901,4502,399,8.1,128026,118628,9398,7.3
Madison,11/1/1992,4953,4473,480,9.7,128441,118876,9565,7.4
Madison,12/1/1992,4961,4336,625,12.6,128554,118997,9557,7.4
Madison,1/1/1993,4840,4106,734,15.2,128400,119075,9325,7.3
Madison,2/1/1993,4809,4168,641,13.3,128458,119275,9183,7.1
Madison,3/1/1993,5044,4417,627,12.4,128598,119542,9056,7
Madison,4/1/1993,5099,4441,658,12.9,128584,119474,9110,7.1
Madison,5/1/1993,5172,4496,676,13.1,129264,120115,9149,7.1
Madison,6/1/1993,5224,4493,731,14,129411,120290,9121,7
Madison,7/1/1993,5097,4463,634,12.4,129397,120467,8930,6.9
Madison,8/1/1993,5020,4395,625,12.5,129619,120856,8763,6.8
Madison,9/1/1993,4787,4251,536,11.2,129268,120554,8714,6.7
Madison,10/1/1993,4916,4445,471,9.6,129573,120823,8750,6.8
Madison,11/1/1993,4811,4395,416,8.6,129711,121169,8542,6.6
Madison,12/1/1993,4966,4422,544,11,129941,121464,8477,6.5
Madison,1/1/1994,5178,4519,659,12.7,130596,121966,8630,6.6
Madison,2/1/1994,5224,4583,641,12.3,130669,122086,8583,6.6
Madison,3/1/1994,5415,4722,693,12.8,130400,121930,8470,6.5
Madison,4/1/1994,5443,4871,572,10.5,130621,122290,8331,6.4
Madison,5/1/1994,5382,4816,566,10.5,130779,122864,7915,6.1
Madison,6/1/1994,5337,4776,561,10.5,130561,122634,7927,6.1
Madison,7/1/1994,5412,4654,758,14,130652,122706,7946,6.1
Madison,8/1/1994,5238,4597,641,12.2,131275,123342,7933,6
Madison,9/1/1994,5196,4657,539,10.4,131421,123687,7734,5.9
Madison,10/1/1994,5310,4763,547,10.3,131744,124112,7632,5.8
Madison,11/1/1994,5251,4767,484,9.2,131891,124516,7375,5.6
Madison,12/1/1994,5387,4671,716,13.3,131951,124721,7230,5.5
Madison,1/1/1995,5699,4766,933,16.4,132038,124663,7375,5.6
Madison,2/1/1995,5577,4834,743,13.3,132115,124928,7187,5.4
Madison,3/1/1995,5616,4875,741,13.2,132108,124955,7153,5.4
Madison,4/1/1995,5574,4902,672,12.1,132590,124945,7645,5.8
Madison,5/1/1995,5407,4852,555,10.3,131851,124421,7430,5.6
Madison,6/1/1995,5882,5015,867,14.7,131949,124522,7427,5.6
Madison,7/1/1995,5728,5036,692,12.1,132343,124816,7527,5.7
Madison,8/1/1995,5692,5036,656,11.5,132336,124852,7484,5.7
Madison,9/1/1995,5642,5041,601,10.7,132611,125133,7478,5.6
Madison,10/1/1995,5585,5016,569,10.2,132716,125388,7328,5.5
Madison,11/1/1995,5517,4868,649,11.8,132614,125188,7426,5.6
Madison,12/1/1995,5423,4791,632,11.7,132511,125088,7423,5.6
Madison,1/1/1996,5655,4852,803,14.2,132616,125125,7491,5.6
Madison,2/1/1996,5524,4846,678,12.3,132952,125639,7313,5.5
Madison,3/1/1996,5630,4936,694,12.3,133180,125862,7318,5.5
Madison,4/1/1996,5813,5083,730,12.6,133409,125994,7415,5.6
Madison,5/1/1996,5597,4930,667,11.9,133667,126244,7423,5.6
Madison,6/1/1996,5712,5015,697,12.2,133697,126602,7095,5.3
Madison,7/1/1996,5936,5063,873,14.7,134284,126947,7337,5.5
Madison,8/1/1996,5611,4991,620,11,134054,127172,6882,5.1
Madison,9/1/1996,5692,5146,546,9.6,134515,127536,6979,5.2
Madison,10/1/1996,5575,5070,505,9.1,134921,127890,7031,5.2
Madison,11/1/1996,5459,4932,527,9.7,135007,127771,7236,5.4
Madison,12/1/1996,5539,4874,665,12,135113,127860,7253,5.4
Madison,1/1/1997,5361,4683,678,12.6,135456,128298,7158,5.3
Madison,2/1/1997,5446,4769,677,12.4,135400,128298,7102,5.2
Madison,3/1/1997,5469,4822,647,11.8,135891,128891,7000,5.2
Madison,4/1/1997,5589,4822,767,13.7,136016,129143,6873,5.1
Madison,5/1/1997,5490,4926,564,10.3,136119,129464,6655,4.9
Madison,6/1/1997,5651,4981,670,11.9,136211,129412,6799,5
Madison,7/1/1997,5682,4945,737,13,136477,129822,6655,4.9
Madison,8/1/1997,5582,4927,655,11.7,136618,130010,6608,4.8
Madison,9/1/1997,5564,4935,629,11.3,136675,130019,6656,4.9
Madison,10/1/1997,5270,4757,513,9.7,136633,130179,6454,4.7
Madison,11/1/1997,5213,4676,537,10.3,136961,130653,6308,4.6
Madison,12/1/1997,5252,4644,608,11.6,137155,130679,6476,4.7
Madison,1/1/1998,5487,4680,807,14.7,137095,130726,6368,4.6
Madison,2/1/1998,5339,4685,654,12.2,137112,130807,6306,4.6
Madison,3/1/1998,5344,4660,684,12.8,137236,130814,6422,4.7
Madison,4/1/1998,5294,4674,620,11.7,137150,131209,5941,4.3
Madison,5/1/1998,5335,4681,654,12.3,137372,131325,6047,4.4
Madison,6/1/1998,5475,4759,716,13.1,137455,131244,6212,4.5
Madison,7/1/1998,5531,4856,675,12.2,137588,131329,6259,4.5
Madison,8/1/1998,5505,4828,677,12.3,137570,131390,6179,4.5
Madison,9/1/1998,5527,4948,579,10.5,138286,131986,6300,4.6
Madison,10/1/1998,5370,4886,484,9,138279,131999,6280,4.5
Madison,11/1/1998,5387,4779,608,11.3,138381,132280,6100,4.4
Madison,12/1/1998,5286,4755,531,10,138634,132602,6032,4.4
Madison,1/1/1999,5435,4879,556,10.2,139003,133027,5976,4.3
Madison,2/1/1999,5239,4753,486,9.3,138967,132856,6111,4.4
Madison,3/1/1999,5266,4845,421,8,138730,132947,5783,4.2
Madison,4/1/1999,5264,4902,362,6.9,138959,132955,6004,4.3
Madison,5/1/1999,5282,4944,338,6.4,139107,133311,5796,4.2
Madison,6/1/1999,5476,5049,427,7.8,139329,133378,5951,4.3
Madison,7/1/1999,5558,5151,407,7.3,139439,133414,6025,4.3
Madison,8/1/1999,5631,5217,414,7.4,139430,133591,5838,4.2
Madison,9/1/1999,5477,5075,402,7.3,139622,133707,5915,4.2
Madison,10/1/1999,5420,5029,391,7.2,139771,133993,5778,4.1
Madison,11/1/1999,5314,4965,349,6.6,140025,134309,5716,4.1
Madison,12/1/1999,5288,4898,390,7.4,140177,134523,5653,4
Madison,1/1/2000,4774,4371,403,8.4,142267,136559,5708,4
Madison,2/1/2000,4731,4357,374,7.9,142456,136598,5858,4.1
Madison,3/1/2000,4756,4368,388,8.2,142434,136701,5733,4
Madison,4/1/2000,4855,4506,349,7.2,142751,137270,5481,3.8
Madison,5/1/2000,4792,4422,370,7.7,142388,136630,5758,4
Madison,6/1/2000,4906,4470,436,8.9,142591,136940,5651,4
Madison,7/1/2000,5077,4669,408,8,142278,136531,5747,4
Madison,8/1/2000,5141,4752,389,7.6,142514,136662,5853,4.1
Madison,9/1/2000,5096,4717,379,7.4,142518,136893,5625,3.9
Madison,10/1/2000,5085,4726,359,7.1,142622,137088,5534,3.9
Madison,11/1/2000,5043,4660,383,7.6,142962,137322,5639,3.9
Madison,12/1/2000,5091,4694,397,7.8,143248,137614,5634,3.9
Madison,1/1/2001,5083,4585,498,9.8,143800,137778,6023,4.2
Madison,2/1/2001,5025,4578,447,8.9,143701,137612,6089,4.2
Madison,3/1/2001,5148,4633,515,10,143924,137783,6141,4.3
Madison,4/1/2001,5022,4580,442,8.8,143569,137299,6271,4.4
Madison,5/1/2001,5006,4596,410,8.2,143318,137092,6226,4.3
Madison,6/1/2001,5142,4619,523,10.2,143357,136873,6484,4.5
Madison,7/1/2001,5223,4747,476,9.1,143654,137071,6583,4.6
Madison,8/1/2001,5147,4669,478,9.3,143284,136241,7042,4.9
Madison,9/1/2001,5096,4625,471,9.2,143989,136846,7142,5
Madison,10/1/2001,5059,4616,443,8.8,144086,136392,7694,5.3
Madison,11/1/2001,5048,4532,516,10.2,144240,136238,8003,5.5
Madison,12/1/2001,5027,4490,537,10.7,144305,136047,8258,5.7
Madison,1/1/2002,5011,4396,615,12.3,143883,135701,8182,5.7
Madison,2/1/2002,4928,4424,504,10.2,144653,136438,8215,5.7
Madison,3/1/2002,5062,4528,534,10.5,144481,136177,8304,5.7
Madison,4/1/2002,4987,4491,496,9.9,144725,136126,8599,5.9
Madison,5/1/2002,5047,4543,504,10,144938,136539,8399,5.8
Madison,6/1/2002,5116,4532,584,11.4,144808,136415,8393,5.8
Madison,7/1/2002,5084,4546,538,10.6,144803,136413,8390,5.8
Madison,8/1/2002,5126,4626,500,9.8,145009,136705,8304,5.7
Madison,9/1/2002,5022,4558,464,9.2,145552,137302,8251,5.7
Madison,10/1/2002,5090,4647,443,8.7,145314,137008,8307,5.7
Madison,11/1/2002,4996,4553,443,8.9,145041,136521,8520,5.9
Madison,12/1/2002,5030,4528,502,10,145066,136426,8640,6
Madison,1/1/2003,5046,4469,577,11.4,145937,137417,8520,5.8
Madison,2/1/2003,5024,4467,557,11.1,146100,137482,8618,5.9
Madison,3/1/2003,5116,4524,592,11.6,146022,137434,8588,5.9
Madison,4/1/2003,5079,4538,541,10.7,146474,137633,8842,6
Madison,5/1/2003,5031,4510,521,10.4,146500,137544,8957,6.1
Madison,6/1/2003,5194,4549,645,12.4,147056,137790,9266,6.3
Madison,7/1/2003,4892,4298,594,12.1,146485,137474,9011,6.2
Madison,8/1/2003,4997,4423,574,11.5,146445,137549,8896,6.1
Madison,9/1/2003,4919,4402,517,10.5,146530,137609,8921,6.1
Madison,10/1/2003,4964,4512,452,9.1,146716,137984,8732,6
Madison,11/1/2003,4859,4444,415,8.5,147000,138424,8576,5.8
Madison,12/1/2003,4765,4355,410,8.6,146729,138411,8317,5.7
Madison,1/1/2004,4802,4335,467,9.7,146842,138472,8370,5.7
Madison,2/1/2004,4747,4349,398,8.4,146709,138542,8167,5.6
Madison,3/1/2004,4766,4330,436,9.1,146944,138453,8491,5.8
Madison,4/1/2004,4614,4202,412,8.9,146850,138680,8170,5.6
Madison,5/1/2004,4605,4177,428,9.3,147065,138852,8212,5.6
Madison,6/1/2004,4675,4172,503,10.8,147460,139174,8286,5.6
Madison,7/1/2004,4675,4181,494,10.6,147692,139556,8136,5.5
Madison,8/1/2004,4670,4211,459,9.8,147564,139573,7990,5.4
Madison,9/1/2004,4619,4172,447,9.7,147415,139487,7927,5.4
Madison,10/1/2004,4684,4246,438,9.4,147793,139732,8061,5.5
Madison,11/1/2004,4622,4213,409,8.8,148162,140231,7932,5.4
Madison,12/1/2004,4560,4155,405,8.9,148059,140125,7934,5.4
Madison,1/1/2005,4550,4096,454,10,148029,140245,7784,5.3
Madison,2/1/2005,4469,4062,407,9.1,148364,140385,7980,5.4
Madison,3/1/2005,4460,4064,396,8.9,148391,140654,7737,5.2
Madison,4/1/2005,4531,4146,385,8.5,148926,141254,7672,5.2
Madison,5/1/2005,4625,4254,371,8,149261,141609,7651,5.1
Madison,6/1/2005,4668,4250,418,9,149238,141714,7524,5
Madison,7/1/2005,4654,4260,394,8.5,149432,142026,7406,5
Madison,8/1/2005,4605,4249,356,7.7,149779,142434,7345,4.9
Madison,9/1/2005,4963,4351,612,12.3,149954,142401,7553,5
Madison,10/1/2005,5168,4660,508,9.8,150001,142548,7453,5
Madison,11/1/2005,5049,4566,483,9.6,150065,142499,7566,5
Madison,12/1/2005,4808,4487,321,6.7,150030,142752,7279,4.9
Madison,1/1/2006,4733,4438,295,6.2,150214,143150,7064,4.7
Madison,2/1/2006,4686,4437,249,5.3,150641,143457,7184,4.8
Madison,3/1/2006,4685,4427,258,5.5,150813,143741,7072,4.7
Madison,4/1/2006,4691,4440,251,5.4,150881,143761,7120,4.7
Madison,5/1/2006,4654,4386,268,5.8,151069,144089,6980,4.6
Madison,6/1/2006,4723,4412,311,6.6,151354,144353,7001,4.6
Madison,7/1/2006,4659,4361,298,6.4,151377,144202,7175,4.7
Madison,8/1/2006,4534,4278,256,5.6,151716,144625,7091,4.7
Madison,9/1/2006,4560,4298,262,5.7,151662,144815,6847,4.5
Madison,10/1/2006,4539,4279,260,5.7,152041,145314,6727,4.4
Madison,11/1/2006,4497,4232,265,5.9,152406,145534,6872,4.5
Madison,12/1/2006,4448,4183,265,6,152732,145970,6762,4.4
Madison,1/1/2007,4431,4116,315,7.1,153144,146028,7116,4.6
Madison,2/1/2007,4442,4143,299,6.7,152983,146057,6927,4.5
Madison,3/1/2007,4442,4156,286,6.4,153051,146320,6731,4.4
Madison,4/1/2007,4467,4187,280,6.3,152435,145586,6850,4.5
Madison,5/1/2007,4489,4207,282,6.3,152670,145903,6766,4.4
Madison,6/1/2007,4510,4178,332,7.4,153041,146063,6979,4.6
Madison,7/1/2007,4490,4177,313,7,153054,145905,7149,4.7
Madison,8/1/2007,4416,4127,289,6.5,152749,145682,7067,4.6
Madison,9/1/2007,4505,4229,276,6.1,153414,146244,7170,4.7
Madison,10/1/2007,4442,4197,245,5.5,153183,145946,7237,4.7
Madison,11/1/2007,4479,4222,257,5.7,153835,146595,7240,4.7
Madison,12/1/2007,4450,4156,294,6.6,153918,146273,7645,5
Madison,1/1/2008,4562,4211,351,7.7,154063,146378,7685,5
Madison,2/1/2008,4515,4213,302,6.7,153653,146156,7497,4.9
Madison,3/1/2008,4636,4318,318,6.9,153908,146086,7822,5.1
Madison,4/1/2008,4610,4316,294,6.4,153769,146132,7637,5
Madison,5/1/2008,4579,4269,310,6.8,154303,145908,8395,5.4
Madison,6/1/2008,4633,4252,381,8.2,154313,145737,8575,5.6
Madison,7/1/2008,4786,4356,430,9,154469,145532,8937,5.8
Madison,8/1/2008,4703,4302,401,8.5,154641,145203,9438,6.1
Madison,9/1/2008,4713,4367,346,7.3,154570,145076,9494,6.1
Madison,10/1/2008,4724,4388,336,7.1,154876,144802,10074,6.5
Madison,11/1/2008,4751,4410,341,7.2,154639,144100,10538,6.8
Madison,12/1/2008,4707,4310,397,8.4,154655,143369,11286,7.3
Madison,1/1/2009,4745,4256,489,10.3,154210,142152,12058,7.8
Madison,2/1/2009,4650,4214,436,9.4,154538,141640,12898,8.3
Madison,3/1/2009,4702,4266,436,9.3,154133,140707,13426,8.7
Madison,4/1/2009,4880,4437,443,9.1,154509,140656,13853,9
Madison,5/1/2009,4892,4452,440,9,154747,140248,14499,9.4
Madison,6/1/2009,5044,4543,501,9.9,154716,140009,14707,9.5
Madison,7/1/2009,4793,4324,469,9.8,154502,139901,14601,9.5
Madison,8/1/2009,4648,4225,423,9.1,154307,139492,14814,9.6
Madison,9/1/2009,4558,4164,394,8.6,153827,138818,15009,9.8
Madison,10/1/2009,4491,4081,410,9.1,153784,138432,15352,10
Madison,11/1/2009,4549,4160,389,8.6,153878,138659,15219,9.9
Madison,12/1/2009,4602,4183,419,9.1,153111,138013,15098,9.9
Madison,1/1/2010,3993,3516,477,11.9,153484,138438,15046,9.8
Madison,2/1/2010,4045,3611,434,10.7,153694,138581,15113,9.8
Madison,3/1/2010,4071,3628,443,10.9,153954,138751,15202,9.9
Madison,4/1/2010,4203,3767,436,10.4,154622,139297,15325,9.9
Madison,5/1/2010,4218,3766,452,10.7,154091,139241,14849,9.6
Madison,6/1/2010,4291,3774,517,12,153616,139141,14474,9.4
Madison,7/1/2010,4374,3858,516,11.8,153691,139179,14512,9.4
Madison,8/1/2010,4275,3777,498,11.6,154086,139438,14648,9.5
Madison,9/1/2010,4248,3777,471,11.1,153975,139396,14579,9.5
Madison,10/1/2010,4168,3717,451,10.8,153635,139119,14516,9.4
Madison,11/1/2010,4091,3625,466,11.4,154125,139044,15081,9.8
Madison,12/1/2010,4015,3537,478,11.9,153650,139301,14348,9.3
Madison,1/1/2011,3961,3425,536,13.5,153263,139250,14013,9.1
Madison,2/1/2011,3998,3496,502,12.6,153214,139394,13820,9
Madison,3/1/2011,3955,3476,479,12.1,153376,139639,13737,9
Madison,4/1/2011,3950,3498,452,11.4,153543,139586,13957,9.1
Madison,5/1/2011,3996,3522,474,11.9,153479,139624,13855,9
Madison,6/1/2011,4084,3534,550,13.5,153346,139384,13962,9.1
Madison,7/1/2011,4115,3599,516,12.5,153288,139524,13763,9
Madison,8/1/2011,4068,3584,484,11.9,153760,139942,13818,9
Madison,9/1/2011,3984,3518,466,11.7,154131,140183,13948,9
Madison,10/1/2011,3908,3479,429,11,153961,140368,13594,8.8
Madison,11/1/2011,3939,3525,414,10.5,154128,140826,13302,8.6
Madison,12/1/2011,3907,3490,417,10.7,153995,140902,13093,8.5
Madison,1/1/2012,3823,3354,469,12.3,154381,141584,12797,8.3
Madison,2/1/2012,3879,3433,446,11.5,154671,141858,12813,8.3
Madison,3/1/2012,3844,3406,438,11.4,154749,142036,12713,8.2
Madison,4/1/2012,3863,3447,416,10.8,154545,141899,12646,8.2
Madison,5/1/2012,3934,3489,445,11.3,154866,142206,12660,8.2
Madison,6/1/2012,4026,3505,521,12.9,155083,142391,12692,8.2
Madison,7/1/2012,4049,3542,507,12.5,154948,142292,12656,8.2
Madison,8/1/2012,3930,3447,483,12.3,154763,142291,12471,8.1
Madison,9/1/2012,3873,3431,442,11.4,155160,143044,12115,7.8
Madison,10/1/2012,3866,3465,401,10.4,155554,143431,12124,7.8
Madison,11/1/2012,3856,3472,384,10,155338,143333,12005,7.7
Madison,12/1/2012,3892,3472,420,10.8,155628,143330,12298,7.9
Madison,1/1/2013,3920,3440,480,12.2,155763,143292,12471,8
Madison,2/1/2013,3925,3472,453,11.5,155312,143362,11950,7.7
Madison,3/1/2013,3861,3410,451,11.7,155005,143316,11689,7.5
Madison,4/1/2013,3869,3463,406,10.5,155394,143635,11760,7.6
Madison,5/1/2013,3929,3528,401,10.2,155536,143882,11654,7.5
Madison,6/1/2013,4135,3678,457,11.1,155749,143999,11751,7.5
Madison,7/1/2013,4138,3712,426,10.3,155599,144264,11335,7.3
Madison,8/1/2013,4014,3624,390,9.7,155605,144326,11279,7.2
Madison,9/1/2013,3999,3594,405,10.1,155687,144418,11270,7.2
Madison,10/1/2013,3896,3497,399,10.2,154673,143537,11136,7.2
Madison,11/1/2013,3849,3480,369,9.6,155265,144479,10787,6.9
Madison,12/1/2013,3893,3511,382,9.8,155182,144778,10404,6.7
Madison,1/1/2014,3848,3428,420,10.9,155352,145150,10202,6.6
Madison,2/1/2014,3854,3446,408,10.6,155483,145134,10349,6.7
Madison,3/1/2014,3826,3415,411,10.7,156028,145648,10380,6.7
Madison,4/1/2014,3798,3401,397,10.5,155369,145667,9702,6.2
Madison,5/1/2014,3796,3376,420,11.1,155684,145825,9859,6.3
Madison,6/1/2014,3951,3467,484,12.3,155707,146247,9460,6.1
Madison,7/1/2014,4058,3596,462,11.4,156007,146399,9608,6.2
Madison,8/1/2014,3969,3543,426,10.7,156130,146530,9599,6.1
Madison,9/1/2014,3981,3549,432,10.9,156040,146778,9262,5.9
Madison,10/1/2014,3905,3511,394,10.1,156417,147427,8990,5.7
Madison,11/1/2014,3880,3473,407,10.5,156494,147404,9090,5.8
Madison,12/1/2014,3912,3501,411,10.5,156332,147615,8717,5.6
Madison,1/1/2015,3866,3448,418,10.8,157030,148145,8885,5.7
Madison,2/1/2015,3876,3479,397,10.2,156644,148045,8599,5.5
Madison,3/1/2015,3834,3458,376,9.8,156643,148128,8515,5.4
Madison,4/1/2015,3900,3543,357,9.2,157060,148511,8550,5.4
Madison,5/1/2015,3922,3554,368,9.4,157651,148817,8834,5.6
Madison,6/1/2015,4008,3622,386,9.6,157062,148816,8247,5.3
Madison,7/1/2015,4054,3690,364,9,156997,148830,8167,5.2
Madison,8/1/2015,3960,3623,337,8.5,157172,149181,7992,5.1
Madison,9/1/2015,3895,3558,337,8.7,156733,148826,7907,5
Madison,10/1/2015,3764,3431,333,8.8,157167,149246,7922,5
Madison,11/1/2015,3728,3421,307,8.2,157463,149463,8000,5.1
Madison,12/1/2015,3777,3471,306,8.1,158035,150128,7907,5
Madison,1/1/2016,3803,3451,352,9.3,158280,150653,7627,4.8
Madison,2/1/2016,3796,3457,339,8.9,158640,150939,7702,4.9
Madison,3/1/2016,3809,3474,335,8.8,159179,151218,7961,5
Madison,4/1/2016,3821,3471,350,9.2,159141,151074,8067,5.1
Madison,5/1/2016,3886,3540,346,8.9,158784,151132,7652,4.8
Madison,6/1/2016,4002,3601,401,10,158967,151223,7744,4.9
Madison,7/1/2016,3985,3598,387,9.7,159194,151554,7641,4.8
Madison,8/1/2016,3886,3539,347,8.9,159562,151779,7784,4.9
Madison,9/1/2016,3827,3479,348,9.1,159714,151761,7953,5
Madison,10/1/2016,3740,3428,312,8.3,159605,151793,7811,4.9
Madison,11/1/2016,3736,3449,287,7.7,159506,151954,7553,4.7
Madison,12/1/2016,3702,3403,299,8.1,159678,152157,7521,4.7
Madison,1/1/2017,3721,3374,347,9.3,159620,152152,7468,4.7
Madison,2/1/2017,3709,3385,324,8.7,159859,152480,7379,4.6
Madison,3/1/2017,3755,3430,325,8.7,160137,153065,7073,4.4
Madison,4/1/2017,3832,3526,306,8,160345,153255,7089,4.4
Madison,5/1/2017,3853,3557,296,7.7,160068,153069,7000,4.4
Madison,6/1/2017,4031,3668,363,9,160192,153318,6873,4.3
Madison,7/1/2017,3986,3657,329,8.3,160462,153569,6892,4.3
Madison,8/1/2017,3884,3574,310,8,160586,153503,7082,4.4
Madison,9/1/2017,3705,3422,283,7.6,161140,154286,6854,4.3
Madison,10/1/2017,3615,3346,269,7.4,160309,153609,6700,4.2
Madison,11/1/2017,3598,3335,263,7.3,160579,153805,6774,4.2
Madison,12/1/2017,3611,3361,250,6.9,160535,153904,6632,4.1
Madison,1/1/2018,3623,3341,282,7.8,160914,154425,6489,4
Madison,2/1/2018,3624,3323,301,8.3,161778,155197,6581,4.1
Madison,3/1/2018,3686,3375,311,8.4,161686,155214,6472,4
Madison,4/1/2018,3632,3342,290,8,161771,155312,6459,4
Madison,5/1/2018,3684,3388,296,8,161848,155652,6196,3.8
Madison,6/1/2018,3769,3396,373,9.9,162210,155762,6447,4
Madison,7/1/2018,3688,3336,352,9.5,162341,156146,6195,3.8
Madison,8/1/2018,3613,3291,322,8.9,161660,155504,6156,3.8
Madison,9/1/2018,3508,3239,269,7.7,162087,156015,6073,3.7
Madison,10/1/2018,3519,3269,250,7.1,162602,156391,6211,3.8
Madison,11/1/2018,3467,3226,241,7,162836,156721,6115,3.8
Madison,12/1/2018,3457,3198,259,7.5,163206,156817,6389,3.9
Madison,1/1/2019,3429,3130,299,8.7,162963,156487,6475,4
Madison,2/1/2019,3464,3209,255,7.4,162999,156863,6136,3.8
Madison,3/1/2019,3476,3234,242,7,162904,156701,6202,3.8
Madison,4/1/2019,3421,3201,220,6.4,162586,156625,5961,3.7
Madison,5/1/2019,3461,3218,243,7,162751,156821,5930,3.6
Madison,6/1/2019,3617,3289,328,9.1,163168,157232,5935,3.6
Madison,7/1/2019,3615,3291,324,9,163590,157529,6061,3.7
Madison,8/1/2019,3639,3336,303,8.3,163774,157829,5945,3.6
Madison,9/1/2019,3595,3327,268,7.5,164092,158339,5753,3.5
Madison,10/1/2019,3629,3367,262,7.2,164416,158545,5871,3.6
Madison,11/1/2019,3494,3227,267,7.6,164496,158629,5868,3.6
Madison,12/1/2019,3473,3226,247,7.1,164699,158845,5853,3.6
Madison,1/1/2020,3428,3158,270,7.9,164377,158508,5869,3.6
Madison,2/1/2020,3439,3216,223,6.5,164467,158714,5753,3.5
Madison,3/1/2020,3585,3205,380,10.6,162559,155353,7206,4.4
Madison,4/1/2020,3359,3023,336,10,156269,133185,23084,14.8
Madison,5/1/2020,3428,3046,382,11.1,158101,137173,20929,13.2
Madison,6/1/2020,3586,3200,386,10.8,159994,142342,17652,11
Madison,7/1/2020,3481,3114,367,10.5,160132,143779,16352,10.2
Madison,8/1/2020,3498,3188,310,8.9,160706,147245,13461,8.4
Madison,9/1/2020,3635,3323,312,8.6,160174,147620,12554,7.8
Madison,10/1/2020,3632,3350,282,7.8,161003,149931,11072,6.9
Madison,11/1/2020,3500,3244,256,7.3,160629,149934,10694,6.7
Madison,12/1/2020,3530,3253,277,7.8,160745,149975,10770,6.7
Madison,1/1/2021,3459,3162,297,8.6,160088,149852,10236,6.4
Madison,2/1/2021,3473,3178,295,8.5,160184,150189,9995,6.2
Madison,3/1/2021,3468,3193,275,7.9,160400,150644,9756,6.1
Madison,4/1/2021,3463,3220,243,7,160843,151081,9762,6.1
Madison,5/1/2021,3424,3173,251,7.3,160800,151535,9266,5.8
Madison,6/1/2021,3497,3192,305,8.7,161197,151734,9462,5.9
Madison,7/1/2021,3476,3192,284,8.2,161504,152773,8731,5.4
Madison,8/1/2021,3458,3219,239,6.9,161527,153250,8276,5.1
Madison,9/1/2021,3497,3304,193,5.5,161495,153843,7652,4.7
Madison,10/1/2021,3408,3235,173,5.1,161754,154475,7279,4.5
Madison,11/1/2021,3352,3194,158,4.7,162281,155530,6751,4.2
Madison,12/1/2021,3365,3217,148,4.4,162497,156099,6398,3.9
Madison,1/1/2022,3376,3187,189,5.6,163627,157115,6512,4
Madison,2/1/2022,3364,3199,165,4.9,163899,157598,6301,3.8
Madison,3/1/2022,3407,3245,162,4.8,164220,158206,6014,3.7
Madison,4/1/2022,3481,3325,156,4.5,163893,157891,6002,3.7
Madison,5/1/2022,3450,3288,162,4.7,164362,158378,5983,3.6
Madison,6/1/2022,3545,3331,214,6,164046,158094,5951,3.6
Madison,7/1/2022,3630,3405,225,6.2,164026,158258,5768,3.5
Madison,8/1/2022,3514,3314,200,5.7,164654,158735,5919,3.6
Madison,9/1/2022,3484,3317,167,4.8,164602,158810,5792,3.5
Madison,10/1/2022,3425,3273,152,4.4,164648,158684,5964,3.6
Madison,11/1/2022,3381,3239,142,4.2,164450,158507,5943,3.6
Madison,12/1/2022,3406,3256,150,4.4,165025,159259,5766,3.5
Madison,1/1/2023,3430,3242,188,5.5,165964,160217,5747,3.5
Madison,2/1/2023,3447,3265,182,5.3,166358,160395,5962,3.6
Madison,3/1/2023,3421,3250,171,5,166651,160812,5839,3.5
Madison,4/1/2023,3496,3333,163,4.7,166725,160974,5751,3.4
Madison,5/1/2023,3483,3288,195,5.6,166886,160796,6089,3.6
Madison,6/1/2023,3558,3315,243,6.8,166937,160979,5958,3.6
Madison,7/1/2023,3569,3355,214,6,167103,161183,5920,3.5
Madison,8/1/2023,3523,3321,202,5.7,167759,161475,6284,3.7
Madison,9/1/2023,3463,3280,183,5.3,167767,161442,6326,3.8
Madison,10/1/2023,3438,3250,188,5.5,167690,161211,6479,3.9
Madison,11/1/2023,3440,3253,187,5.4,168140,161886,6254,3.7
Madison,12/1/2023,3448,3256,192,5.6,167439,161124,6315,3.8
Madison,1/1/2024,3442,3216,226,6.6,167339,161190,6149,3.7
Madison,2/1/2024,3383,3163,220,6.5,167475,161013,6462,3.9
Madison,3/1/2024,3392,3173,219,6.5,167922,161425,6497,3.9
Madison,4/1/2024,3457,3245,212,6.1,167988,161495,6492,3.9
Madison,5/1/2024,3400,3199,201,5.9,167799,161164,6635,4
Madison,6/1/2024,3573,3324,249,7,168005,161155,6849,4.1
Madison,7/1/2024,3629,3362,267,7.4,168315,161219,7097,4.2
Madison,8/1/2024,3571,3318,253,7.1,168496,161425,7071,4.2
Madison,9/1/2024,3700,3448,252,6.8,168703,161802,6901,4.1
Madison,10/1/2024,3655,3404,251,6.9,168428,161456,6972,4.1
Madison,11/1/2024,3587,3331,256,7.1,168304,161183,7121,4.2
Madison,12/1/2024,3570,3334,236,6.6,168547,161661,6886,4.1
Madison,1/1/2025,3023,2781,242,8,170744,163895,6849,4
Madison,2/1/2025,2938,2699,239,8.1,170359,163307,7052,4.1
Morehouse,1/1/1990,11913,10847,1066,8.9,125833,119081,6752,5.4
Morehouse,2/1/1990,11845,10872,973,8.2,125710,119059,6651,5.3
Morehouse,3/1/1990,11875,11003,872,7.3,125801,119203,6598,5.2
Morehouse,4/1/1990,11822,10971,851,7.2,125649,118852,6797,5.4
Morehouse,5/1/1990,12102,11260,842,7,125893,119151,6742,5.4
Morehouse,6/1/1990,12342,11419,923,7.5,125573,118983,6590,5.2
Morehouse,7/1/1990,12265,11318,947,7.7,125732,118810,6922,5.5
Morehouse,8/1/1990,12581,11371,1210,9.6,125990,118802,7188,5.7
Morehouse,9/1/1990,12717,11448,1269,10,125892,118524,7368,5.9
Morehouse,10/1/1990,12579,11432,1147,9.1,125995,118536,7459,5.9
Morehouse,11/1/1990,12492,11277,1215,9.7,126070,118306,7764,6.2
Morehouse,12/1/1990,12468,11181,1287,10.3,126142,118241,7901,6.3
Morehouse,1/1/1991,12767,11076,1691,13.2,125955,117940,8015,6.4
Morehouse,2/1/1991,12616,11036,1580,12.5,126020,117755,8265,6.6
Morehouse,3/1/1991,12705,11345,1360,10.7,126238,117652,8586,6.8
Morehouse,4/1/1991,12654,11331,1323,10.5,126548,118109,8439,6.7
Morehouse,5/1/1991,12546,11291,1255,10,126176,117440,8736,6.9
Morehouse,6/1/1991,12867,11499,1368,10.6,126331,117639,8692,6.9
Morehouse,7/1/1991,12668,11504,1164,9.2,126154,117568,8586,6.8
Morehouse,8/1/1991,12920,11825,1095,8.5,126150,117484,8666,6.9
Morehouse,9/1/1991,12792,11759,1033,8.1,126650,117928,8722,6.9
Morehouse,10/1/1991,12898,11956,942,7.3,126642,117800,8842,7
Morehouse,11/1/1991,12735,11790,945,7.4,126701,117770,8931,7
Morehouse,12/1/1991,12597,11527,1070,8.5,126664,117466,9198,7.3
Morehouse,1/1/1992,12899,11369,1530,11.9,127261,117978,9283,7.3
Morehouse,2/1/1992,12796,11500,1296,10.1,127207,117753,9454,7.4
Morehouse,3/1/1992,12901,11674,1227,9.5,127604,118144,9460,7.4
Morehouse,4/1/1992,13057,11973,1084,8.3,127841,118426,9415,7.4
Morehouse,5/1/1992,13297,12236,1061,8,128119,118375,9744,7.6
Morehouse,6/1/1992,13311,11937,1374,10.3,128459,118419,10040,7.8
Morehouse,7/1/1992,13769,12569,1200,8.7,128563,118713,9850,7.7
Morehouse,8/1/1992,13577,12373,1204,8.9,128613,118826,9787,7.6
Morehouse,9/1/1992,13337,12187,1150,8.6,128501,118720,9781,7.6
Morehouse,10/1/1992,13256,12268,988,7.5,128026,118628,9398,7.3
Morehouse,11/1/1992,13239,12264,975,7.4,128441,118876,9565,7.4
Morehouse,12/1/1992,13090,11994,1096,8.4,128554,118997,9557,7.4
Morehouse,1/1/1993,13162,11805,1357,10.3,128400,119075,9325,7.3
Morehouse,2/1/1993,12990,11801,1189,9.2,128458,119275,9183,7.1
Morehouse,3/1/1993,13012,11875,1137,8.7,128598,119542,9056,7
Morehouse,4/1/1993,12812,11748,1064,8.3,128584,119474,9110,7.1
Morehouse,5/1/1993,13258,12271,987,7.4,129264,120115,9149,7.1
Morehouse,6/1/1993,13814,12568,1246,9,129411,120290,9121,7
Morehouse,7/1/1993,12857,11773,1084,8.4,129397,120467,8930,6.9
Morehouse,8/1/1993,12897,11637,1260,9.8,129619,120856,8763,6.8
Morehouse,9/1/1993,12666,11552,1114,8.8,129268,120554,8714,6.7
Morehouse,10/1/1993,12683,11530,1153,9.1,129573,120823,8750,6.8
Morehouse,11/1/1993,12484,11347,1137,9.1,129711,121169,8542,6.6
Morehouse,12/1/1993,12562,11288,1274,10.1,129941,121464,8477,6.5
Morehouse,1/1/1994,12890,11146,1744,13.5,130596,121966,8630,6.6
Morehouse,2/1/1994,12825,11133,1692,13.2,130669,122086,8583,6.6
Morehouse,3/1/1994,12860,11261,1599,12.4,130400,121930,8470,6.5
Morehouse,4/1/1994,12887,11396,1491,11.6,130621,122290,8331,6.4
Morehouse,5/1/1994,12831,11459,1372,10.7,130779,122864,7915,6.1
Morehouse,6/1/1994,13053,11403,1650,12.6,130561,122634,7927,6.1
Morehouse,7/1/1994,12679,11235,1444,11.4,130652,122706,7946,6.1
Morehouse,8/1/1994,12691,11122,1569,12.4,131275,123342,7933,6
Morehouse,9/1/1994,12656,11240,1416,11.2,131421,123687,7734,5.9
Morehouse,10/1/1994,12858,11581,1277,9.9,131744,124112,7632,5.8
Morehouse,11/1/1994,12590,11439,1151,9.1,131891,124516,7375,5.6
Morehouse,12/1/1994,12541,11242,1299,10.4,131951,124721,7230,5.5
Morehouse,1/1/1995,12851,11269,1582,12.3,132038,124663,7375,5.6
Morehouse,2/1/1995,12539,11268,1271,10.1,132115,124928,7187,5.4
Morehouse,3/1/1995,12556,11303,1253,10,132108,124955,7153,5.4
Morehouse,4/1/1995,12368,11198,1170,9.5,132590,124945,7645,5.8
Morehouse,5/1/1995,12172,11160,1012,8.3,131851,124421,7430,5.6
Morehouse,6/1/1995,12557,11370,1187,9.5,131949,124522,7427,5.6
Morehouse,7/1/1995,12606,11525,1081,8.6,132343,124816,7527,5.7
Morehouse,8/1/1995,12631,11529,1102,8.7,132336,124852,7484,5.7
Morehouse,9/1/1995,12496,11578,918,7.3,132611,125133,7478,5.6
Morehouse,10/1/1995,12400,11534,866,7,132716,125388,7328,5.5
Morehouse,11/1/1995,12338,11352,986,8,132614,125188,7426,5.6
Morehouse,12/1/1995,12192,11103,1089,8.9,132511,125088,7423,5.6
Morehouse,1/1/1996,12654,11034,1620,12.8,132616,125125,7491,5.6
Morehouse,2/1/1996,12330,11031,1299,10.5,132952,125639,7313,5.5
Morehouse,3/1/1996,12393,11264,1129,9.1,133180,125862,7318,5.5
Morehouse,4/1/1996,12710,11515,1195,9.4,133409,125994,7415,5.6
Morehouse,5/1/1996,12535,11365,1170,9.3,133667,126244,7423,5.6
Morehouse,6/1/1996,12964,11590,1374,10.6,133697,126602,7095,5.3
Morehouse,7/1/1996,13377,11977,1400,10.5,134284,126947,7337,5.5
Morehouse,8/1/1996,13037,11798,1239,9.5,134054,127172,6882,5.1
Morehouse,9/1/1996,13119,11707,1412,10.8,134515,127536,6979,5.2
Morehouse,10/1/1996,12641,11204,1437,11.4,134921,127890,7031,5.2
Morehouse,11/1/1996,12299,10821,1478,12,135007,127771,7236,5.4
Morehouse,12/1/1996,12196,10567,1629,13.4,135113,127860,7253,5.4
Morehouse,1/1/1997,12574,10504,2070,16.5,135456,128298,7158,5.3
Morehouse,2/1/1997,12461,10628,1833,14.7,135400,128298,7102,5.2
Morehouse,3/1/1997,12635,10867,1768,14,135891,128891,7000,5.2
Morehouse,4/1/1997,12583,10998,1585,12.6,136016,129143,6873,5.1
Morehouse,5/1/1997,12405,10942,1463,11.8,136119,129464,6655,4.9
Morehouse,6/1/1997,12870,11041,1829,14.2,136211,129412,6799,5
Morehouse,7/1/1997,12007,10407,1600,13.3,136477,129822,6655,4.9
Morehouse,8/1/1997,11758,10314,1444,12.3,136618,130010,6608,4.8
Morehouse,9/1/1997,12181,10867,1314,10.8,136675,130019,6656,4.9
Morehouse,10/1/1997,11932,10743,1189,10,136633,130179,6454,4.7
Morehouse,11/1/1997,11887,10780,1107,9.3,136961,130653,6308,4.6
Morehouse,12/1/1997,11943,10739,1204,10.1,137155,130679,6476,4.7
Morehouse,1/1/1998,12129,10657,1472,12.1,137095,130726,6368,4.6
Morehouse,2/1/1998,11919,10641,1278,10.7,137112,130807,6306,4.6
Morehouse,3/1/1998,12028,10634,1394,11.6,137236,130814,6422,4.7
Morehouse,4/1/1998,11866,10650,1216,10.2,137150,131209,5941,4.3
Morehouse,5/1/1998,12097,10789,1308,10.8,137372,131325,6047,4.4
Morehouse,6/1/1998,12384,10916,1468,11.9,137455,131244,6212,4.5
Morehouse,7/1/1998,12470,11019,1451,11.6,137588,131329,6259,4.5
Morehouse,8/1/1998,12397,10901,1496,12.1,137570,131390,6179,4.5
Morehouse,9/1/1998,12254,10703,1551,12.7,138286,131986,6300,4.6
Morehouse,10/1/1998,12053,10773,1280,10.6,138279,131999,6280,4.5
Morehouse,11/1/1998,11978,10789,1189,9.9,138381,132280,6100,4.4
Morehouse,12/1/1998,12144,10746,1398,11.5,138634,132602,6032,4.4
Morehouse,1/1/1999,11995,10343,1652,13.8,139003,133027,5976,4.3
Morehouse,2/1/1999,11614,10306,1308,11.3,138967,132856,6111,4.4
Morehouse,3/1/1999,11532,10370,1162,10.1,138730,132947,5783,4.2
Morehouse,4/1/1999,11487,10446,1041,9.1,138959,132955,6004,4.3
Morehouse,5/1/1999,11528,10577,951,8.2,139107,133311,5796,4.2
Morehouse,6/1/1999,11981,10803,1178,9.8,139329,133378,5951,4.3
Morehouse,7/1/1999,12023,10890,1133,9.4,139439,133414,6025,4.3
Morehouse,8/1/1999,12062,10882,1180,9.8,139430,133591,5838,4.2
Morehouse,9/1/1999,12011,10860,1151,9.6,139622,133707,5915,4.2
Morehouse,10/1/1999,12081,10967,1114,9.2,139771,133993,5778,4.1
Morehouse,11/1/1999,12000,10941,1059,8.8,140025,134309,5716,4.1
Morehouse,12/1/1999,11777,10716,1061,9,140177,134523,5653,4
Morehouse,1/1/2000,12420,11405,1015,8.2,142267,136559,5708,4
Morehouse,2/1/2000,12229,11335,894,7.3,142456,136598,5858,4.1
Morehouse,3/1/2000,12265,11397,868,7.1,142434,136701,5733,4
Morehouse,4/1/2000,12246,11476,770,6.3,142751,137270,5481,3.8
Morehouse,5/1/2000,12250,11405,845,6.9,142388,136630,5758,4
Morehouse,6/1/2000,12404,11426,978,7.9,142591,136940,5651,4
Morehouse,7/1/2000,12449,11523,926,7.4,142278,136531,5747,4
Morehouse,8/1/2000,12385,11386,999,8.1,142514,136662,5853,4.1
Morehouse,9/1/2000,12424,11500,924,7.4,142518,136893,5625,3.9
Morehouse,10/1/2000,12550,11660,890,7.1,142622,137088,5534,3.9
Morehouse,11/1/2000,12617,11670,947,7.5,142962,137322,5639,3.9
Morehouse,12/1/2000,12667,11664,1003,7.9,143248,137614,5634,3.9
Morehouse,1/1/2001,12533,11308,1225,9.8,143800,137778,6023,4.2
Morehouse,2/1/2001,12477,11436,1041,8.3,143701,137612,6089,4.2
Morehouse,3/1/2001,12851,11723,1128,8.8,143924,137783,6141,4.3
Morehouse,4/1/2001,12535,11560,975,7.8,143569,137299,6271,4.4
Morehouse,5/1/2001,12538,11598,940,7.5,143318,137092,6226,4.3
Morehouse,6/1/2001,12504,11407,1097,8.8,143357,136873,6484,4.5
Morehouse,7/1/2001,12571,11549,1022,8.1,143654,137071,6583,4.6
Morehouse,8/1/2001,12523,11454,1069,8.5,143284,136241,7042,4.9
Morehouse,9/1/2001,12709,11700,1009,7.9,143989,136846,7142,5
Morehouse,10/1/2001,12815,11834,981,7.7,144086,136392,7694,5.3
Morehouse,11/1/2001,12743,11725,1018,8,144240,136238,8003,5.5
Morehouse,12/1/2001,12775,11711,1064,8.3,144305,136047,8258,5.7
Morehouse,1/1/2002,12370,11145,1225,9.9,143883,135701,8182,5.7
Morehouse,2/1/2002,12311,11253,1058,8.6,144653,136438,8215,5.7
Morehouse,3/1/2002,12420,11365,1055,8.5,144481,136177,8304,5.7
Morehouse,4/1/2002,12298,11306,992,8.1,144725,136126,8599,5.9
Morehouse,5/1/2002,12407,11459,948,7.6,144938,136539,8399,5.8
Morehouse,6/1/2002,12411,11282,1129,9.1,144808,136415,8393,5.8
Morehouse,7/1/2002,12521,11472,1049,8.4,144803,136413,8390,5.8
Morehouse,8/1/2002,12634,11549,1085,8.6,145009,136705,8304,5.7
Morehouse,9/1/2002,12544,11544,1000,8,145552,137302,8251,5.7
Morehouse,10/1/2002,12791,11824,967,7.6,145314,137008,8307,5.7
Morehouse,11/1/2002,12702,11665,1037,8.2,145041,136521,8520,5.9
Morehouse,12/1/2002,12746,11603,1143,9,145066,136426,8640,6
Morehouse,1/1/2003,12716,11369,1347,10.6,145937,137417,8520,5.8
Morehouse,2/1/2003,12495,11284,1211,9.7,146100,137482,8618,5.9
Morehouse,3/1/2003,12648,11407,1241,9.8,146022,137434,8588,5.9
Morehouse,4/1/2003,12584,11387,1197,9.5,146474,137633,8842,6
Morehouse,5/1/2003,12606,11390,1216,9.6,146500,137544,8957,6.1
Morehouse,6/1/2003,12944,11434,1510,11.7,147056,137790,9266,6.3
Morehouse,7/1/2003,12804,11430,1374,10.7,146485,137474,9011,6.2
Morehouse,8/1/2003,12839,11505,1334,10.4,146445,137549,8896,6.1
Morehouse,9/1/2003,12642,11418,1224,9.7,146530,137609,8921,6.1
Morehouse,10/1/2003,12855,11727,1128,8.8,146716,137984,8732,6
Morehouse,11/1/2003,12706,11605,1101,8.7,147000,138424,8576,5.8
Morehouse,12/1/2003,12476,11330,1146,9.2,146729,138411,8317,5.7
Morehouse,1/1/2004,12129,10697,1432,11.8,146842,138472,8370,5.7
Morehouse,2/1/2004,11877,10686,1191,10,146709,138542,8167,5.6
Morehouse,3/1/2004,11904,10636,1268,10.7,146944,138453,8491,5.8
Morehouse,4/1/2004,11833,10697,1136,9.6,146850,138680,8170,5.6
Morehouse,5/1/2004,11767,10676,1091,9.3,147065,138852,8212,5.6
Morehouse,6/1/2004,11990,10682,1308,10.9,147460,139174,8286,5.6
Morehouse,7/1/2004,12078,10888,1190,9.9,147692,139556,8136,5.5
Morehouse,8/1/2004,11890,10771,1119,9.4,147564,139573,7990,5.4
Morehouse,9/1/2004,11766,10680,1086,9.2,147415,139487,7927,5.4
Morehouse,10/1/2004,11943,10874,1069,9,147793,139732,8061,5.5
Morehouse,11/1/2004,11755,10735,1020,8.7,148162,140231,7932,5.4
Morehouse,12/1/2004,11636,10564,1072,9.2,148059,140125,7934,5.4
Morehouse,1/1/2005,11742,10473,1269,10.8,148029,140245,7784,5.3
Morehouse,2/1/2005,11438,10323,1115,9.7,148364,140385,7980,5.4
Morehouse,3/1/2005,11452,10438,1014,8.9,148391,140654,7737,5.2
Morehouse,4/1/2005,11593,10627,966,8.3,148926,141254,7672,5.2
Morehouse,5/1/2005,11587,10643,944,8.1,149261,141609,7651,5.1
Morehouse,6/1/2005,11795,10678,1117,9.5,149238,141714,7524,5
Morehouse,7/1/2005,11677,10631,1046,9,149432,142026,7406,5
Morehouse,8/1/2005,11428,10432,996,8.7,149779,142434,7345,4.9
Morehouse,9/1/2005,12425,11218,1207,9.7,149954,142401,7553,5
Morehouse,10/1/2005,12441,11381,1060,8.5,150001,142548,7453,5
Morehouse,11/1/2005,12143,11070,1073,8.8,150065,142499,7566,5
Morehouse,12/1/2005,11691,10843,848,7.3,150030,142752,7279,4.9
Morehouse,1/1/2006,11636,10879,757,6.5,150214,143150,7064,4.7
Morehouse,2/1/2006,11566,10932,634,5.5,150641,143457,7184,4.8
Morehouse,3/1/2006,11591,10942,649,5.6,150813,143741,7072,4.7
Morehouse,4/1/2006,11764,11138,626,5.3,150881,143761,7120,4.7
Morehouse,5/1/2006,11651,10979,672,5.8,151069,144089,6980,4.6
Morehouse,6/1/2006,11775,10916,859,7.3,151354,144353,7001,4.6
Morehouse,7/1/2006,11613,10831,782,6.7,151377,144202,7175,4.7
Morehouse,8/1/2006,11474,10683,791,6.9,151716,144625,7091,4.7
Morehouse,9/1/2006,11556,10846,710,6.1,151662,144815,6847,4.5
Morehouse,10/1/2006,11733,11043,690,5.9,152041,145314,6727,4.4
Morehouse,11/1/2006,11753,11003,750,6.4,152406,145534,6872,4.5
Morehouse,12/1/2006,11598,10772,826,7.1,152732,145970,6762,4.4
Morehouse,1/1/2007,11700,10669,1031,8.8,153144,146028,7116,4.6
Morehouse,2/1/2007,11813,10821,992,8.4,152983,146057,6927,4.5
Morehouse,3/1/2007,11661,10857,804,6.9,153051,146320,6731,4.4
Morehouse,4/1/2007,11739,10927,812,6.9,152435,145586,6850,4.5
Morehouse,5/1/2007,11510,10701,809,7,152670,145903,6766,4.4
Morehouse,6/1/2007,11611,10652,959,8.3,153041,146063,6979,4.6
Morehouse,7/1/2007,11647,10636,1011,8.7,153054,145905,7149,4.7
Morehouse,8/1/2007,11546,10611,935,8.1,152749,145682,7067,4.6
Morehouse,9/1/2007,11855,10963,892,7.5,153414,146244,7170,4.7
Morehouse,10/1/2007,11696,10888,808,6.9,153183,145946,7237,4.7
Morehouse,11/1/2007,11823,10963,860,7.3,153835,146595,7240,4.7
Morehouse,12/1/2007,11754,10730,1024,8.7,153918,146273,7645,5
Morehouse,1/1/2008,11881,10747,1134,9.5,154063,146378,7685,5
Morehouse,2/1/2008,11786,10794,992,8.4,153653,146156,7497,4.9
Morehouse,3/1/2008,11961,11065,896,7.5,153908,146086,7822,5.1
Morehouse,4/1/2008,11833,11057,776,6.6,153769,146132,7637,5
Morehouse,5/1/2008,11757,10918,839,7.1,154303,145908,8395,5.4
Morehouse,6/1/2008,11776,10769,1007,8.6,154313,145737,8575,5.6
Morehouse,7/1/2008,11941,10847,1094,9.2,154469,145532,8937,5.8
Morehouse,8/1/2008,11747,10727,1020,8.7,154641,145203,9438,6.1
Morehouse,9/1/2008,11664,10753,911,7.8,154570,145076,9494,6.1
Morehouse,10/1/2008,11792,10828,964,8.2,154876,144802,10074,6.5
Morehouse,11/1/2008,12059,10780,1279,10.6,154639,144100,10538,6.8
Morehouse,12/1/2008,11611,10397,1214,10.5,154655,143369,11286,7.3
Morehouse,1/1/2009,11725,10316,1409,12,154210,142152,12058,7.8
Morehouse,2/1/2009,11617,9951,1666,14.3,154538,141640,12898,8.3
Morehouse,3/1/2009,11577,9990,1587,13.7,154133,140707,13426,8.7
Morehouse,4/1/2009,11553,10043,1510,13.1,154509,140656,13853,9
Morehouse,5/1/2009,11935,10137,1798,15.1,154747,140248,14499,9.4
Morehouse,6/1/2009,12118,10104,2014,16.6,154716,140009,14707,9.5
Morehouse,7/1/2009,12132,10058,2074,17.1,154502,139901,14601,9.5
Morehouse,8/1/2009,11507,9809,1698,14.8,154307,139492,14814,9.6
Morehouse,9/1/2009,11310,9706,1604,14.2,153827,138818,15009,9.8
Morehouse,10/1/2009,11375,9869,1506,13.2,153784,138432,15352,10
Morehouse,11/1/2009,11341,9901,1440,12.7,153878,138659,15219,9.9
Morehouse,12/1/2009,11375,9824,1551,13.6,153111,138013,15098,9.9
Morehouse,1/1/2010,10978,9265,1713,15.6,153484,138438,15046,9.8
Morehouse,2/1/2010,10972,9344,1628,14.8,153694,138581,15113,9.8
Morehouse,3/1/2010,11026,9471,1555,14.1,153954,138751,15202,9.9
Morehouse,4/1/2010,11094,9649,1445,13,154622,139297,15325,9.9
Morehouse,5/1/2010,11103,9583,1520,13.7,154091,139241,14849,9.6
Morehouse,6/1/2010,11342,9637,1705,15,153616,139141,14474,9.4
Morehouse,7/1/2010,11266,9543,1723,15.3,153691,139179,14512,9.4
Morehouse,8/1/2010,10972,9357,1615,14.7,154086,139438,14648,9.5
Morehouse,9/1/2010,11024,9432,1592,14.4,153975,139396,14579,9.5
Morehouse,10/1/2010,10927,9420,1507,13.8,153635,139119,14516,9.4
Morehouse,11/1/2010,10986,9433,1553,14.1,154125,139044,15081,9.8
Morehouse,12/1/2010,10981,9340,1641,14.9,153650,139301,14348,9.3
Morehouse,1/1/2011,10972,9241,1731,15.8,153263,139250,14013,9.1
Morehouse,2/1/2011,10920,9279,1641,15,153214,139394,13820,9
Morehouse,3/1/2011,11016,9431,1585,14.4,153376,139639,13737,9
Morehouse,4/1/2011,10879,9462,1417,13,153543,139586,13957,9.1
Morehouse,5/1/2011,10929,9519,1410,12.9,153479,139624,13855,9
Morehouse,6/1/2011,11100,9508,1592,14.3,153346,139384,13962,9.1
Morehouse,7/1/2011,11184,9661,1523,13.6,153288,139524,13763,9
Morehouse,8/1/2011,11074,9627,1447,13.1,153760,139942,13818,9
Morehouse,9/1/2011,11056,9610,1446,13.1,154131,140183,13948,9
Morehouse,10/1/2011,11178,9846,1332,11.9,153961,140368,13594,8.8
Morehouse,11/1/2011,11228,9783,1445,12.9,154128,140826,13302,8.6
Morehouse,12/1/2011,11300,9804,1496,13.2,153995,140902,13093,8.5
Morehouse,1/1/2012,11282,9644,1638,14.5,154381,141584,12797,8.3
Morehouse,2/1/2012,11209,9699,1510,13.5,154671,141858,12813,8.3
Morehouse,3/1/2012,11201,9751,1450,12.9,154749,142036,12713,8.2
Morehouse,4/1/2012,11189,9853,1336,11.9,154545,141899,12646,8.2
Morehouse,5/1/2012,11307,9977,1330,11.8,154866,142206,12660,8.2
Morehouse,6/1/2012,11484,9949,1535,13.4,155083,142391,12692,8.2
Morehouse,7/1/2012,11466,9942,1524,13.3,154948,142292,12656,8.2
Morehouse,8/1/2012,11196,9771,1425,12.7,154763,142291,12471,8.1
Morehouse,9/1/2012,11270,9939,1331,11.8,155160,143044,12115,7.8
Morehouse,10/1/2012,11258,10026,1232,10.9,155554,143431,12124,7.8
Morehouse,11/1/2012,11120,9956,1164,10.5,155338,143333,12005,7.7
Morehouse,12/1/2012,11260,9970,1290,11.5,155628,143330,12298,7.9
Morehouse,1/1/2013,11152,9634,1518,13.6,155763,143292,12471,8
Morehouse,2/1/2013,11155,9670,1485,13.3,155312,143362,11950,7.7
Morehouse,3/1/2013,11186,9759,1427,12.8,155005,143316,11689,7.5
Morehouse,4/1/2013,11073,9753,1320,11.9,155394,143635,11760,7.6
Morehouse,5/1/2013,11204,9944,1260,11.2,155536,143882,11654,7.5
Morehouse,6/1/2013,11313,9852,1461,12.9,155749,143999,11751,7.5
Morehouse,7/1/2013,11330,9948,1382,12.2,155599,144264,11335,7.3
Morehouse,8/1/2013,10980,9689,1291,11.8,155605,144326,11279,7.2
Morehouse,9/1/2013,11033,9762,1271,11.5,155687,144418,11270,7.2
Morehouse,10/1/2013,10918,9757,1161,10.6,154673,143537,11136,7.2
Morehouse,11/1/2013,10880,9767,1113,10.2,155265,144479,10787,6.9
Morehouse,12/1/2013,10875,9732,1143,10.5,155182,144778,10404,6.7
Morehouse,1/1/2014,10927,9716,1211,11.1,155352,145150,10202,6.6
Morehouse,2/1/2014,10967,9781,1186,10.8,155483,145134,10349,6.7
Morehouse,3/1/2014,11020,9877,1143,10.4,156028,145648,10380,6.7
Morehouse,4/1/2014,10906,9853,1053,9.7,155369,145667,9702,6.2
Morehouse,5/1/2014,11061,9931,1130,10.2,155684,145825,9859,6.3
Morehouse,6/1/2014,11188,9928,1260,11.3,155707,146247,9460,6.1
Morehouse,7/1/2014,11239,9931,1308,11.6,156007,146399,9608,6.2
Morehouse,8/1/2014,11094,9821,1273,11.5,156130,146530,9599,6.1
Morehouse,9/1/2014,11214,9920,1294,11.5,156040,146778,9262,5.9
Morehouse,10/1/2014,11238,10020,1218,10.8,156417,147427,8990,5.7
Morehouse,11/1/2014,11155,9896,1259,11.3,156494,147404,9090,5.8
Morehouse,12/1/2014,11122,9777,1345,12.1,156332,147615,8717,5.6
Morehouse,1/1/2015,11019,9598,1421,12.9,157030,148145,8885,5.7
Morehouse,2/1/2015,10953,9629,1324,12.1,156644,148045,8599,5.5
Morehouse,3/1/2015,10935,9660,1275,11.7,156643,148128,8515,5.4
Morehouse,4/1/2015,10785,9646,1139,10.6,157060,148511,8550,5.4
Morehouse,5/1/2015,10827,9621,1206,11.1,157651,148817,8834,5.6
Morehouse,6/1/2015,10895,9592,1303,12,157062,148816,8247,5.3
Morehouse,7/1/2015,10784,9582,1202,11.1,156997,148830,8167,5.2
Morehouse,8/1/2015,10640,9567,1073,10.1,157172,149181,7992,5.1
Morehouse,9/1/2015,10626,9572,1054,9.9,156733,148826,7907,5
Morehouse,10/1/2015,10546,9510,1036,9.8,157167,149246,7922,5
Morehouse,11/1/2015,10556,9555,1001,9.5,157463,149463,8000,5.1
Morehouse,12/1/2015,10566,9539,1027,9.7,158035,150128,7907,5
Morehouse,1/1/2016,10521,9403,1118,10.6,158280,150653,7627,4.8
Morehouse,2/1/2016,10624,9552,1072,10.1,158640,150939,7702,4.9
Morehouse,3/1/2016,10634,9599,1035,9.7,159179,151218,7961,5
Morehouse,4/1/2016,10685,9682,1003,9.4,159141,151074,8067,5.1
Morehouse,5/1/2016,10730,9692,1038,9.7,158784,151132,7652,4.8
Morehouse,6/1/2016,10819,9675,1144,10.6,158967,151223,7744,4.9
Morehouse,7/1/2016,10770,9660,1110,10.3,159194,151554,7641,4.8
Morehouse,8/1/2016,10542,9518,1024,9.7,159562,151779,7784,4.9
Morehouse,9/1/2016,10670,9673,997,9.3,159714,151761,7953,5
Morehouse,10/1/2016,10473,9556,917,8.8,159605,151793,7811,4.9
Morehouse,11/1/2016,10442,9537,905,8.7,159506,151954,7553,4.7
Morehouse,12/1/2016,10486,9555,931,8.9,159678,152157,7521,4.7
Morehouse,1/1/2017,10439,9419,1020,9.8,159620,152152,7468,4.7
Morehouse,2/1/2017,10476,9547,929,8.9,159859,152480,7379,4.6
Morehouse,3/1/2017,10456,9574,882,8.4,160137,153065,7073,4.4
Morehouse,4/1/2017,10382,9504,878,8.5,160345,153255,7089,4.4
Morehouse,5/1/2017,10376,9521,855,8.2,160068,153069,7000,4.4
Morehouse,6/1/2017,10481,9594,887,8.5,160192,153318,6873,4.3
Morehouse,7/1/2017,10393,9543,850,8.2,160462,153569,6892,4.3
Morehouse,8/1/2017,10253,9443,810,7.9,160586,153503,7082,4.4
Morehouse,9/1/2017,10309,9552,757,7.3,161140,154286,6854,4.3
Morehouse,10/1/2017,10231,9564,667,6.5,160309,153609,6700,4.2
Morehouse,11/1/2017,10133,9473,660,6.5,160579,153805,6774,4.2
Morehouse,12/1/2017,10256,9555,701,6.8,160535,153904,6632,4.1
Morehouse,1/1/2018,10199,9366,833,8.2,160914,154425,6489,4
Morehouse,2/1/2018,10232,9389,843,8.2,161778,155197,6581,4.1
Morehouse,3/1/2018,10334,9461,873,8.4,161686,155214,6472,4
Morehouse,4/1/2018,10281,9483,798,7.8,161771,155312,6459,4
Morehouse,5/1/2018,10221,9392,829,8.1,161848,155652,6196,3.8
Morehouse,6/1/2018,10275,9346,929,9,162210,155762,6447,4
Morehouse,7/1/2018,10183,9302,881,8.7,162341,156146,6195,3.8
Morehouse,8/1/2018,10024,9206,818,8.2,161660,155504,6156,3.8
Morehouse,9/1/2018,10101,9325,776,7.7,162087,156015,6073,3.7
Morehouse,10/1/2018,10043,9308,735,7.3,162602,156391,6211,3.8
Morehouse,11/1/2018,9939,9219,720,7.2,162836,156721,6115,3.8
Morehouse,12/1/2018,9983,9150,833,8.3,163206,156817,6389,3.9
Morehouse,1/1/2019,10004,9088,916,9.2,162963,156487,6475,4
Morehouse,2/1/2019,10052,9231,821,8.2,162999,156863,6136,3.8
Morehouse,3/1/2019,10034,9317,717,7.1,162904,156701,6202,3.8
Morehouse,4/1/2019,9960,9303,657,6.6,162586,156625,5961,3.7
Morehouse,5/1/2019,9950,9265,685,6.9,162751,156821,5930,3.6
Morehouse,6/1/2019,10024,9203,821,8.2,163168,157232,5935,3.6
Morehouse,7/1/2019,9778,8906,872,8.9,163590,157529,6061,3.7
Morehouse,8/1/2019,9854,8996,858,8.7,163774,157829,5945,3.6
Morehouse,9/1/2019,9962,9213,749,7.5,164092,158339,5753,3.5
Morehouse,10/1/2019,9994,9223,771,7.7,164416,158545,5871,3.6
Morehouse,11/1/2019,9871,9058,813,8.2,164496,158629,5868,3.6
Morehouse,12/1/2019,9892,9037,855,8.6,164699,158845,5853,3.6
Morehouse,1/1/2020,9871,8979,892,9,164377,158508,5869,3.6
Morehouse,2/1/2020,9762,8972,790,8.1,164467,158714,5753,3.5
Morehouse,3/1/2020,10367,9126,1241,12,162559,155353,7206,4.4
Morehouse,4/1/2020,9349,8346,1003,10.7,156269,133185,23084,14.8
Morehouse,5/1/2020,9686,8552,1134,11.7,158101,137173,20929,13.2
Morehouse,6/1/2020,10006,8821,1185,11.8,159994,142342,17652,11
Morehouse,7/1/2020,10068,8889,1179,11.7,160132,143779,16352,10.2
Morehouse,8/1/2020,10116,9069,1047,10.3,160706,147245,13461,8.4
Morehouse,9/1/2020,10174,9093,1081,10.6,160174,147620,12554,7.8
Morehouse,10/1/2020,10063,9084,979,9.7,161003,149931,11072,6.9
Morehouse,11/1/2020,9908,9024,884,8.9,160629,149934,10694,6.7
Morehouse,12/1/2020,9994,9090,904,9,160745,149975,10770,6.7
Morehouse,1/1/2021,9779,8835,944,9.7,160088,149852,10236,6.4
Morehouse,2/1/2021,9776,8892,884,9,160184,150189,9995,6.2
Morehouse,3/1/2021,9818,8965,853,8.7,160400,150644,9756,6.1
Morehouse,4/1/2021,9926,9134,792,8,160843,151081,9762,6.1
Morehouse,5/1/2021,9877,9091,786,8,160800,151535,9266,5.8
Morehouse,6/1/2021,10075,9173,902,9,161197,151734,9462,5.9
Morehouse,7/1/2021,9924,9111,813,8.2,161504,152773,8731,5.4
Morehouse,8/1/2021,9780,9070,710,7.3,161527,153250,8276,5.1
Morehouse,9/1/2021,10083,9474,609,6,161495,153843,7652,4.7
Morehouse,10/1/2021,9862,9316,546,5.5,161754,154475,7279,4.5
Morehouse,11/1/2021,9877,9368,509,5.2,162281,155530,6751,4.2
Morehouse,12/1/2021,9846,9372,474,4.8,162497,156099,6398,3.9
Morehouse,1/1/2022,9848,9240,608,6.2,163627,157115,6512,4
Morehouse,2/1/2022,9907,9341,566,5.7,163899,157598,6301,3.8
Morehouse,3/1/2022,9962,9438,524,5.3,164220,158206,6014,3.7
Morehouse,4/1/2022,9873,9404,469,4.8,163893,157891,6002,3.7
Morehouse,5/1/2022,9816,9318,498,5.1,164362,158378,5983,3.6
Morehouse,6/1/2022,9947,9352,595,6,164046,158094,5951,3.6
Morehouse,7/1/2022,9803,9228,575,5.9,164026,158258,5768,3.5
Morehouse,8/1/2022,9759,9213,546,5.6,164654,158735,5919,3.6
Morehouse,9/1/2022,9710,9226,484,5,164602,158810,5792,3.5
Morehouse,10/1/2022,9597,9155,442,4.6,164648,158684,5964,3.6
Morehouse,11/1/2022,9561,9126,435,4.5,164450,158507,5943,3.6
Morehouse,12/1/2022,9601,9137,464,4.8,165025,159259,5766,3.5
Morehouse,1/1/2023,9455,8871,584,6.2,165964,160217,5747,3.5
Morehouse,2/1/2023,9462,8898,564,6,166358,160395,5962,3.6
Morehouse,3/1/2023,9628,9074,554,5.8,166651,160812,5839,3.5
Morehouse,4/1/2023,9605,9106,499,5.2,166725,160974,5751,3.4
Morehouse,5/1/2023,9547,8979,568,5.9,166886,160796,6089,3.6
Morehouse,6/1/2023,9746,9117,629,6.5,166937,160979,5958,3.6
Morehouse,7/1/2023,9598,9026,572,6,167103,161183,5920,3.5
Morehouse,8/1/2023,9492,8884,608,6.4,167759,161475,6284,3.7
Morehouse,9/1/2023,9579,9032,547,5.7,167767,161442,6326,3.8
Morehouse,10/1/2023,9571,9000,571,6,167690,161211,6479,3.9
Morehouse,11/1/2023,9576,8990,586,6.1,168140,161886,6254,3.7
Morehouse,12/1/2023,9526,8929,597,6.3,167439,161124,6315,3.8
Morehouse,1/1/2024,9515,8832,683,7.2,167339,161190,6149,3.7
Morehouse,2/1/2024,9435,8825,610,6.5,167475,161013,6462,3.9
Morehouse,3/1/2024,9482,8887,595,6.3,167922,161425,6497,3.9
Morehouse,4/1/2024,9488,8928,560,5.9,167988,161495,6492,3.9
Morehouse,5/1/2024,9405,8838,567,6,167799,161164,6635,4
Morehouse,6/1/2024,9566,8906,660,6.9,168005,161155,6849,4.1
Morehouse,7/1/2024,9592,8892,700,7.3,168315,161219,7097,4.2
Morehouse,8/1/2024,9437,8762,675,7.2,168496,161425,7071,4.2
Morehouse,9/1/2024,9577,8983,594,6.2,168703,161802,6901,4.1
Morehouse,10/1/2024,9604,8967,637,6.6,168428,161456,6972,4.1
Morehouse,11/1/2024,9512,8870,642,6.7,168304,161183,7121,4.2
Morehouse,12/1/2024,9495,8856,639,6.7,168547,161661,6886,4.1
Morehouse,1/1/2025,9286,8578,708,7.6,170744,163895,6849,4
Morehouse,2/1/2025,9185,8561,624,6.8,170359,163307,7052,4.1
Natchitoches,1/1/1990,14823,13479,1344,9.1,125833,119081,6752,5.4
Natchitoches,2/1/1990,14552,13387,1165,8,125710,119059,6651,5.3
Natchitoches,3/1/1990,14524,13513,1011,7,125801,119203,6598,5.2
Natchitoches,4/1/1990,14388,13325,1063,7.4,125649,118852,6797,5.4
Natchitoches,5/1/1990,14572,13508,1064,7.3,125893,119151,6742,5.4
Natchitoches,6/1/1990,14957,13622,1335,8.9,125573,118983,6590,5.2
Natchitoches,7/1/1990,14975,13709,1266,8.5,125732,118810,6922,5.5
Natchitoches,8/1/1990,15361,13956,1405,9.1,125990,118802,7188,5.7
Natchitoches,9/1/1990,15306,13903,1403,9.2,125892,118524,7368,5.9
Natchitoches,10/1/1990,15201,13979,1222,8,125995,118536,7459,5.9
Natchitoches,11/1/1990,15019,13819,1200,8,126070,118306,7764,6.2
Natchitoches,12/1/1990,15226,13958,1268,8.3,126142,118241,7901,6.3
Natchitoches,1/1/1991,15395,13608,1787,11.6,125955,117940,8015,6.4
Natchitoches,2/1/1991,15326,13773,1553,10.1,126020,117755,8265,6.6
Natchitoches,3/1/1991,15368,14081,1287,8.4,126238,117652,8586,6.8
Natchitoches,4/1/1991,15294,14044,1250,8.2,126548,118109,8439,6.7
Natchitoches,5/1/1991,15487,14049,1438,9.3,126176,117440,8736,6.9
Natchitoches,6/1/1991,15556,14103,1453,9.3,126331,117639,8692,6.9
Natchitoches,7/1/1991,15419,14148,1271,8.2,126154,117568,8586,6.8
Natchitoches,8/1/1991,15375,14088,1287,8.4,126150,117484,8666,6.9
Natchitoches,9/1/1991,15319,14114,1205,7.9,126650,117928,8722,6.9
Natchitoches,10/1/1991,15303,14139,1164,7.6,126642,117800,8842,7
Natchitoches,11/1/1991,15348,14264,1084,7.1,126701,117770,8931,7
Natchitoches,12/1/1991,15434,14289,1145,7.4,126664,117466,9198,7.3
Natchitoches,1/1/1992,15297,13892,1405,9.2,127261,117978,9283,7.3
Natchitoches,2/1/1992,15376,14111,1265,8.2,127207,117753,9454,7.4
Natchitoches,3/1/1992,15610,14383,1227,7.9,127604,118144,9460,7.4
Natchitoches,4/1/1992,15716,14589,1127,7.2,127841,118426,9415,7.4
Natchitoches,5/1/1992,15799,14584,1215,7.7,128119,118375,9744,7.6
Natchitoches,6/1/1992,16156,14610,1546,9.6,128459,118419,10040,7.8
Natchitoches,7/1/1992,16531,15155,1376,8.3,128563,118713,9850,7.7
Natchitoches,8/1/1992,16376,15017,1359,8.3,128613,118826,9787,7.6
Natchitoches,9/1/1992,16196,14983,1213,7.5,128501,118720,9781,7.6
Natchitoches,10/1/1992,16182,15088,1094,6.8,128026,118628,9398,7.3
Natchitoches,11/1/1992,16201,15194,1007,6.2,128441,118876,9565,7.4
Natchitoches,12/1/1992,15858,14796,1062,6.7,128554,118997,9557,7.4
Natchitoches,1/1/1993,15576,14237,1339,8.6,128400,119075,9325,7.3
Natchitoches,2/1/1993,15577,14464,1113,7.1,128458,119275,9183,7.1
Natchitoches,3/1/1993,15911,14820,1091,6.9,128598,119542,9056,7
Natchitoches,4/1/1993,16002,14973,1029,6.4,128584,119474,9110,7.1
Natchitoches,5/1/1993,16009,14883,1126,7,129264,120115,9149,7.1
Natchitoches,6/1/1993,16271,15032,1239,7.6,129411,120290,9121,7
Natchitoches,7/1/1993,16206,15083,1123,6.9,129397,120467,8930,6.9
Natchitoches,8/1/1993,16148,15045,1103,6.8,129619,120856,8763,6.8
Natchitoches,9/1/1993,16102,15097,1005,6.2,129268,120554,8714,6.7
Natchitoches,10/1/1993,16207,15212,995,6.1,129573,120823,8750,6.8
Natchitoches,11/1/1993,15951,14975,976,6.1,129711,121169,8542,6.6
Natchitoches,12/1/1993,15911,14988,923,5.8,129941,121464,8477,6.5
Natchitoches,1/1/1994,15463,14305,1158,7.5,130596,121966,8630,6.6
Natchitoches,2/1/1994,15456,14377,1079,7,130669,122086,8583,6.6
Natchitoches,3/1/1994,15467,14428,1039,6.7,130400,121930,8470,6.5
Natchitoches,4/1/1994,15734,14681,1053,6.7,130621,122290,8331,6.4
Natchitoches,5/1/1994,15767,14727,1040,6.6,130779,122864,7915,6.1
Natchitoches,6/1/1994,15835,14588,1247,7.9,130561,122634,7927,6.1
Natchitoches,7/1/1994,16135,14920,1215,7.5,130652,122706,7946,6.1
Natchitoches,8/1/1994,16489,15168,1321,8,131275,123342,7933,6
Natchitoches,9/1/1994,16548,15383,1165,7,131421,123687,7734,5.9
Natchitoches,10/1/1994,16512,15446,1066,6.5,131744,124112,7632,5.8
Natchitoches,11/1/1994,16363,15398,965,5.9,131891,124516,7375,5.6
Natchitoches,12/1/1994,16129,15206,923,5.7,131951,124721,7230,5.5
Natchitoches,1/1/1995,16328,15135,1193,7.3,132038,124663,7375,5.6
Natchitoches,2/1/1995,16350,15098,1252,7.7,132115,124928,7187,5.4
Natchitoches,3/1/1995,16489,15264,1225,7.4,132108,124955,7153,5.4
Natchitoches,4/1/1995,16632,15314,1318,7.9,132590,124945,7645,5.8
Natchitoches,5/1/1995,16338,15140,1198,7.3,131851,124421,7430,5.6
Natchitoches,6/1/1995,16576,15260,1316,7.9,131949,124522,7427,5.6
Natchitoches,7/1/1995,16840,15630,1210,7.2,132343,124816,7527,5.7
Natchitoches,8/1/1995,16697,15445,1252,7.5,132336,124852,7484,5.7
Natchitoches,9/1/1995,16937,15699,1238,7.3,132611,125133,7478,5.6
Natchitoches,10/1/1995,17182,16023,1159,6.7,132716,125388,7328,5.5
Natchitoches,11/1/1995,16802,15715,1087,6.5,132614,125188,7426,5.6
Natchitoches,12/1/1995,17180,16019,1161,6.8,132511,125088,7423,5.6
Natchitoches,1/1/1996,16964,15542,1422,8.4,132616,125125,7491,5.6
Natchitoches,2/1/1996,16885,15660,1225,7.3,132952,125639,7313,5.5
Natchitoches,3/1/1996,17417,16054,1363,7.8,133180,125862,7318,5.5
Natchitoches,4/1/1996,17592,16293,1299,7.4,133409,125994,7415,5.6
Natchitoches,5/1/1996,17807,16437,1370,7.7,133667,126244,7423,5.6
Natchitoches,6/1/1996,18065,16637,1428,7.9,133697,126602,7095,5.3
Natchitoches,7/1/1996,17749,16433,1316,7.4,134284,126947,7337,5.5
Natchitoches,8/1/1996,17413,16174,1239,7.1,134054,127172,6882,5.1
Natchitoches,9/1/1996,16973,15818,1155,6.8,134515,127536,6979,5.2
Natchitoches,10/1/1996,17030,15893,1137,6.7,134921,127890,7031,5.2
Natchitoches,11/1/1996,16787,15763,1024,6.1,135007,127771,7236,5.4
Natchitoches,12/1/1996,16781,15717,1064,6.3,135113,127860,7253,5.4
Natchitoches,1/1/1997,16495,15158,1337,8.1,135456,128298,7158,5.3
Natchitoches,2/1/1997,16434,15266,1168,7.1,135400,128298,7102,5.2
Natchitoches,3/1/1997,16694,15487,1207,7.2,135891,128891,7000,5.2
Natchitoches,4/1/1997,16647,15486,1161,7,136016,129143,6873,5.1
Natchitoches,5/1/1997,16820,15673,1147,6.8,136119,129464,6655,4.9
Natchitoches,6/1/1997,17197,15756,1441,8.4,136211,129412,6799,5
Natchitoches,7/1/1997,17287,15995,1292,7.5,136477,129822,6655,4.9
Natchitoches,8/1/1997,17104,15865,1239,7.2,136618,130010,6608,4.8
Natchitoches,9/1/1997,17006,15809,1197,7,136675,130019,6656,4.9
Natchitoches,10/1/1997,16863,15821,1042,6.2,136633,130179,6454,4.7
Natchitoches,11/1/1997,16976,15953,1023,6,136961,130653,6308,4.6
Natchitoches,12/1/1997,16970,15942,1028,6.1,137155,130679,6476,4.7
Natchitoches,1/1/1998,16502,15331,1171,7.1,137095,130726,6368,4.6
Natchitoches,2/1/1998,16578,15556,1022,6.2,137112,130807,6306,4.6
Natchitoches,3/1/1998,16824,15743,1081,6.4,137236,130814,6422,4.7
Natchitoches,4/1/1998,16676,15726,950,5.7,137150,131209,5941,4.3
Natchitoches,5/1/1998,17006,16027,979,5.8,137372,131325,6047,4.4
Natchitoches,6/1/1998,17089,15984,1105,6.5,137455,131244,6212,4.5
Natchitoches,7/1/1998,17658,16574,1084,6.1,137588,131329,6259,4.5
Natchitoches,8/1/1998,17475,16344,1131,6.5,137570,131390,6179,4.5
Natchitoches,9/1/1998,17303,16298,1005,5.8,138286,131986,6300,4.6
Natchitoches,10/1/1998,17211,16296,915,5.3,138279,131999,6280,4.5
Natchitoches,11/1/1998,17220,16402,818,4.8,138381,132280,6100,4.4
Natchitoches,12/1/1998,17400,16558,842,4.8,138634,132602,6032,4.4
Natchitoches,1/1/1999,17274,16267,1007,5.8,139003,133027,5976,4.3
Natchitoches,2/1/1999,17171,16360,811,4.7,138967,132856,6111,4.4
Natchitoches,3/1/1999,17563,16769,794,4.5,138730,132947,5783,4.2
Natchitoches,4/1/1999,17503,16649,854,4.9,138959,132955,6004,4.3
Natchitoches,5/1/1999,17560,16675,885,5,139107,133311,5796,4.2
Natchitoches,6/1/1999,17767,16713,1054,5.9,139329,133378,5951,4.3
Natchitoches,7/1/1999,18297,17280,1017,5.6,139439,133414,6025,4.3
Natchitoches,8/1/1999,18339,17366,973,5.3,139430,133591,5838,4.2
Natchitoches,9/1/1999,18066,17173,893,4.9,139622,133707,5915,4.2
Natchitoches,10/1/1999,18102,17300,802,4.4,139771,133993,5778,4.1
Natchitoches,11/1/1999,17904,17183,721,4,140025,134309,5716,4.1
Natchitoches,12/1/1999,17833,17173,660,3.7,140177,134523,5653,4
Natchitoches,1/1/2000,16204,15274,930,5.7,142267,136559,5708,4
Natchitoches,2/1/2000,16123,15345,778,4.8,142456,136598,5858,4.1
Natchitoches,3/1/2000,16264,15420,844,5.2,142434,136701,5733,4
Natchitoches,4/1/2000,16397,15595,802,4.9,142751,137270,5481,3.8
Natchitoches,5/1/2000,16447,15516,931,5.7,142388,136630,5758,4
Natchitoches,6/1/2000,16675,15550,1125,6.7,142591,136940,5651,4
Natchitoches,7/1/2000,16724,15660,1064,6.4,142278,136531,5747,4
Natchitoches,8/1/2000,16791,15724,1067,6.4,142514,136662,5853,4.1
Natchitoches,9/1/2000,16476,15531,945,5.7,142518,136893,5625,3.9
Natchitoches,10/1/2000,16798,15833,965,5.7,142622,137088,5534,3.9
Natchitoches,11/1/2000,16639,15704,935,5.6,142962,137322,5639,3.9
Natchitoches,12/1/2000,16762,15844,918,5.5,143248,137614,5634,3.9
Natchitoches,1/1/2001,16767,15585,1182,7,143800,137778,6023,4.2
Natchitoches,2/1/2001,16733,15695,1038,6.2,143701,137612,6089,4.2
Natchitoches,3/1/2001,17002,15867,1135,6.7,143924,137783,6141,4.3
Natchitoches,4/1/2001,16882,15809,1073,6.4,143569,137299,6271,4.4
Natchitoches,5/1/2001,16989,15910,1079,6.4,143318,137092,6226,4.3
Natchitoches,6/1/2001,17053,15832,1221,7.2,143357,136873,6484,4.5
Natchitoches,7/1/2001,17226,16079,1147,6.7,143654,137071,6583,4.6
Natchitoches,8/1/2001,17117,15991,1126,6.6,143284,136241,7042,4.9
Natchitoches,9/1/2001,16886,15771,1115,6.6,143989,136846,7142,5
Natchitoches,10/1/2001,16738,15673,1065,6.4,144086,136392,7694,5.3
Natchitoches,11/1/2001,16678,15635,1043,6.3,144240,136238,8003,5.5
Natchitoches,12/1/2001,16592,15531,1061,6.4,144305,136047,8258,5.7
Natchitoches,1/1/2002,16390,15136,1254,7.7,143883,135701,8182,5.7
Natchitoches,2/1/2002,16263,15251,1012,6.2,144653,136438,8215,5.7
Natchitoches,3/1/2002,16398,15321,1077,6.6,144481,136177,8304,5.7
Natchitoches,4/1/2002,16479,15416,1063,6.5,144725,136126,8599,5.9
Natchitoches,5/1/2002,16673,15524,1149,6.9,144938,136539,8399,5.8
Natchitoches,6/1/2002,16856,15487,1369,8.1,144808,136415,8393,5.8
Natchitoches,7/1/2002,16865,15647,1218,7.2,144803,136413,8390,5.8
Natchitoches,8/1/2002,16763,15548,1215,7.2,145009,136705,8304,5.7
Natchitoches,9/1/2002,16559,15442,1117,6.7,145552,137302,8251,5.7
Natchitoches,10/1/2002,16797,15715,1082,6.4,145314,137008,8307,5.7
Natchitoches,11/1/2002,16628,15530,1098,6.6,145041,136521,8520,5.9
Natchitoches,12/1/2002,16690,15609,1081,6.5,145066,136426,8640,6
Natchitoches,1/1/2003,16237,14948,1289,7.9,145937,137417,8520,5.8
Natchitoches,2/1/2003,16340,15202,1138,7,146100,137482,8618,5.9
Natchitoches,3/1/2003,16526,15304,1222,7.4,146022,137434,8588,5.9
Natchitoches,4/1/2003,16766,15628,1138,6.8,146474,137633,8842,6
Natchitoches,5/1/2003,16972,15790,1182,7,146500,137544,8957,6.1
Natchitoches,6/1/2003,17234,15649,1585,9.2,147056,137790,9266,6.3
Natchitoches,7/1/2003,16892,15471,1421,8.4,146485,137474,9011,6.2
Natchitoches,8/1/2003,16811,15472,1339,8,146445,137549,8896,6.1
Natchitoches,9/1/2003,16755,15521,1234,7.4,146530,137609,8921,6.1
Natchitoches,10/1/2003,16825,15698,1127,6.7,146716,137984,8732,6
Natchitoches,11/1/2003,16682,15587,1095,6.6,147000,138424,8576,5.8
Natchitoches,12/1/2003,16739,15677,1062,6.3,146729,138411,8317,5.7
Natchitoches,1/1/2004,16765,15565,1200,7.2,146842,138472,8370,5.7
Natchitoches,2/1/2004,16768,15764,1004,6,146709,138542,8167,5.6
Natchitoches,3/1/2004,16924,15818,1106,6.5,146944,138453,8491,5.8
Natchitoches,4/1/2004,17284,16307,977,5.7,146850,138680,8170,5.6
Natchitoches,5/1/2004,17421,16348,1073,6.2,147065,138852,8212,5.6
Natchitoches,6/1/2004,17690,16423,1267,7.2,147460,139174,8286,5.6
Natchitoches,7/1/2004,17501,16330,1171,6.7,147692,139556,8136,5.5
Natchitoches,8/1/2004,17400,16384,1016,5.8,147564,139573,7990,5.4
Natchitoches,9/1/2004,17307,16244,1063,6.1,147415,139487,7927,5.4
Natchitoches,10/1/2004,17313,16269,1044,6,147793,139732,8061,5.5
Natchitoches,11/1/2004,17269,16290,979,5.7,148162,140231,7932,5.4
Natchitoches,12/1/2004,17138,16168,970,5.7,148059,140125,7934,5.4
Natchitoches,1/1/2005,17020,15936,1084,6.4,148029,140245,7784,5.3
Natchitoches,2/1/2005,16991,16046,945,5.6,148364,140385,7980,5.4
Natchitoches,3/1/2005,17139,16196,943,5.5,148391,140654,7737,5.2
Natchitoches,4/1/2005,17549,16599,950,5.4,148926,141254,7672,5.2
Natchitoches,5/1/2005,17572,16508,1064,6.1,149261,141609,7651,5.1
Natchitoches,6/1/2005,17744,16541,1203,6.8,149238,141714,7524,5
Natchitoches,7/1/2005,17396,16257,1139,6.5,149432,142026,7406,5
Natchitoches,8/1/2005,17305,16244,1061,6.1,149779,142434,7345,4.9
Natchitoches,9/1/2005,19508,17582,1926,9.9,149954,142401,7553,5
Natchitoches,10/1/2005,19640,17915,1725,8.8,150001,142548,7453,5
Natchitoches,11/1/2005,19486,17791,1695,8.7,150065,142499,7566,5
Natchitoches,12/1/2005,18491,17476,1015,5.5,150030,142752,7279,4.9
Natchitoches,1/1/2006,17788,16942,846,4.8,150214,143150,7064,4.7
Natchitoches,2/1/2006,17763,17102,661,3.7,150641,143457,7184,4.8
Natchitoches,3/1/2006,17968,17271,697,3.9,150813,143741,7072,4.7
Natchitoches,4/1/2006,18175,17471,704,3.9,150881,143761,7120,4.7
Natchitoches,5/1/2006,18202,17425,777,4.3,151069,144089,6980,4.6
Natchitoches,6/1/2006,18331,17397,934,5.1,151354,144353,7001,4.6
Natchitoches,7/1/2006,18266,17427,839,4.6,151377,144202,7175,4.7
Natchitoches,8/1/2006,17989,17181,808,4.5,151716,144625,7091,4.7
Natchitoches,9/1/2006,17959,17205,754,4.2,151662,144815,6847,4.5
Natchitoches,10/1/2006,18067,17335,732,4.1,152041,145314,6727,4.4
Natchitoches,11/1/2006,18108,17355,753,4.2,152406,145534,6872,4.5
Natchitoches,12/1/2006,17942,17183,759,4.2,152732,145970,6762,4.4
Natchitoches,1/1/2007,17391,16466,925,5.3,153144,146028,7116,4.6
Natchitoches,2/1/2007,17525,16735,790,4.5,152983,146057,6927,4.5
Natchitoches,3/1/2007,17692,16893,799,4.5,153051,146320,6731,4.4
Natchitoches,4/1/2007,17567,16775,792,4.5,152435,145586,6850,4.5
Natchitoches,5/1/2007,17467,16605,862,4.9,152670,145903,6766,4.4
Natchitoches,6/1/2007,17673,16652,1021,5.8,153041,146063,6979,4.6
Natchitoches,7/1/2007,17658,16655,1003,5.7,153054,145905,7149,4.7
Natchitoches,8/1/2007,17420,16491,929,5.3,152749,145682,7067,4.6
Natchitoches,9/1/2007,17568,16713,855,4.9,153414,146244,7170,4.7
Natchitoches,10/1/2007,17487,16663,824,4.7,153183,145946,7237,4.7
Natchitoches,11/1/2007,17359,16615,744,4.3,153835,146595,7240,4.7
Natchitoches,12/1/2007,17319,16483,836,4.8,153918,146273,7645,5
Natchitoches,1/1/2008,17001,16007,994,5.8,154063,146378,7685,5
Natchitoches,2/1/2008,17077,16270,807,4.7,153653,146156,7497,4.9
Natchitoches,3/1/2008,17428,16566,862,4.9,153908,146086,7822,5.1
Natchitoches,4/1/2008,17197,16407,790,4.6,153769,146132,7637,5
Natchitoches,5/1/2008,17265,16260,1005,5.8,154303,145908,8395,5.4
Natchitoches,6/1/2008,17274,16198,1076,6.2,154313,145737,8575,5.6
Natchitoches,7/1/2008,17315,16227,1088,6.3,154469,145532,8937,5.8
Natchitoches,8/1/2008,17103,16032,1071,6.3,154641,145203,9438,6.1
Natchitoches,9/1/2008,17208,16201,1007,5.9,154570,145076,9494,6.1
Natchitoches,10/1/2008,17473,16447,1026,5.9,154876,144802,10074,6.5
Natchitoches,11/1/2008,17546,16522,1024,5.8,154639,144100,10538,6.8
Natchitoches,12/1/2008,17415,16149,1266,7.3,154655,143369,11286,7.3
Natchitoches,1/1/2009,17273,15890,1383,8,154210,142152,12058,7.8
Natchitoches,2/1/2009,17335,16032,1303,7.5,154538,141640,12898,8.3
Natchitoches,3/1/2009,17515,16100,1415,8.1,154133,140707,13426,8.7
Natchitoches,4/1/2009,17524,16161,1363,7.8,154509,140656,13853,9
Natchitoches,5/1/2009,17506,16157,1349,7.7,154747,140248,14499,9.4
Natchitoches,6/1/2009,17740,16143,1597,9,154716,140009,14707,9.5
Natchitoches,7/1/2009,17896,16396,1500,8.4,154502,139901,14601,9.5
Natchitoches,8/1/2009,17484,16084,1400,8,154307,139492,14814,9.6
Natchitoches,9/1/2009,17545,16199,1346,7.7,153827,138818,15009,9.8
Natchitoches,10/1/2009,17328,15969,1359,7.8,153784,138432,15352,10
Natchitoches,11/1/2009,17319,16026,1293,7.5,153878,138659,15219,9.9
Natchitoches,12/1/2009,17250,15911,1339,7.8,153111,138013,15098,9.9
Natchitoches,1/1/2010,16136,14658,1478,9.2,153484,138438,15046,9.8
Natchitoches,2/1/2010,16480,15242,1238,7.5,153694,138581,15113,9.8
Natchitoches,3/1/2010,16653,15426,1227,7.4,153954,138751,15202,9.9
Natchitoches,4/1/2010,16798,15602,1196,7.1,154622,139297,15325,9.9
Natchitoches,5/1/2010,16865,15523,1342,8,154091,139241,14849,9.6
Natchitoches,6/1/2010,17126,15599,1527,8.9,153616,139141,14474,9.4
Natchitoches,7/1/2010,16957,15386,1571,9.3,153691,139179,14512,9.4
Natchitoches,8/1/2010,16572,15071,1501,9.1,154086,139438,14648,9.5
Natchitoches,9/1/2010,16512,15068,1444,8.7,153975,139396,14579,9.5
Natchitoches,10/1/2010,16538,15120,1418,8.6,153635,139119,14516,9.4
Natchitoches,11/1/2010,16473,15044,1429,8.7,154125,139044,15081,9.8
Natchitoches,12/1/2010,16180,14850,1330,8.2,153650,139301,14348,9.3
Natchitoches,1/1/2011,16074,14617,1457,9.1,153263,139250,14013,9.1
Natchitoches,2/1/2011,16058,14789,1269,7.9,153214,139394,13820,9
Natchitoches,3/1/2011,16238,14939,1299,8,153376,139639,13737,9
Natchitoches,4/1/2011,16262,15036,1226,7.5,153543,139586,13957,9.1
Natchitoches,5/1/2011,16239,14899,1340,8.3,153479,139624,13855,9
Natchitoches,6/1/2011,16730,15011,1719,10.3,153346,139384,13962,9.1
Natchitoches,7/1/2011,16494,14963,1531,9.3,153288,139524,13763,9
Natchitoches,8/1/2011,16124,14625,1499,9.3,153760,139942,13818,9
Natchitoches,9/1/2011,16271,14838,1433,8.8,154131,140183,13948,9
Natchitoches,10/1/2011,16088,14707,1381,8.6,153961,140368,13594,8.8
Natchitoches,11/1/2011,15996,14615,1381,8.6,154128,140826,13302,8.6
Natchitoches,12/1/2011,15977,14606,1371,8.6,153995,140902,13093,8.5
Natchitoches,1/1/2012,15698,14227,1471,9.4,154381,141584,12797,8.3
Natchitoches,2/1/2012,15877,14487,1390,8.8,154671,141858,12813,8.3
Natchitoches,3/1/2012,16018,14704,1314,8.2,154749,142036,12713,8.2
Natchitoches,4/1/2012,16115,14884,1231,7.6,154545,141899,12646,8.2
Natchitoches,5/1/2012,16302,14942,1360,8.3,154866,142206,12660,8.2
Natchitoches,6/1/2012,16645,15008,1637,9.8,155083,142391,12692,8.2
Natchitoches,7/1/2012,16428,14856,1572,9.6,154948,142292,12656,8.2
Natchitoches,8/1/2012,15880,14423,1457,9.2,154763,142291,12471,8.1
Natchitoches,9/1/2012,16000,14746,1254,7.8,155160,143044,12115,7.8
Natchitoches,10/1/2012,16191,14917,1274,7.9,155554,143431,12124,7.8
Natchitoches,11/1/2012,16081,14907,1174,7.3,155338,143333,12005,7.7
Natchitoches,12/1/2012,16077,14817,1260,7.8,155628,143330,12298,7.9
Natchitoches,1/1/2013,16171,14670,1501,9.3,155763,143292,12471,8
Natchitoches,2/1/2013,16917,15607,1310,7.7,155312,143362,11950,7.7
Natchitoches,3/1/2013,17043,15739,1304,7.7,155005,143316,11689,7.5
Natchitoches,4/1/2013,17077,15814,1263,7.4,155394,143635,11760,7.6
Natchitoches,5/1/2013,17205,15832,1373,8,155536,143882,11654,7.5
Natchitoches,6/1/2013,16752,15134,1618,9.7,155749,143999,11751,7.5
Natchitoches,7/1/2013,16706,15236,1470,8.8,155599,144264,11335,7.3
Natchitoches,8/1/2013,16308,14930,1378,8.4,155605,144326,11279,7.2
Natchitoches,9/1/2013,17145,15786,1359,7.9,155687,144418,11270,7.2
Natchitoches,10/1/2013,16895,15623,1272,7.5,154673,143537,11136,7.2
Natchitoches,11/1/2013,16803,15683,1120,6.7,155265,144479,10787,6.9
Natchitoches,12/1/2013,16760,15694,1066,6.4,155182,144778,10404,6.7
Natchitoches,1/1/2014,16129,14998,1131,7,155352,145150,10202,6.6
Natchitoches,2/1/2014,16748,15644,1104,6.6,155483,145134,10349,6.7
Natchitoches,3/1/2014,16870,15703,1167,6.9,156028,145648,10380,6.7
Natchitoches,4/1/2014,16871,15806,1065,6.3,155369,145667,9702,6.2
Natchitoches,5/1/2014,17075,15833,1242,7.3,155684,145825,9859,6.3
Natchitoches,6/1/2014,16704,15224,1480,8.9,155707,146247,9460,6.1
Natchitoches,7/1/2014,16721,15224,1497,9,156007,146399,9608,6.2
Natchitoches,8/1/2014,16376,14965,1411,8.6,156130,146530,9599,6.1
Natchitoches,9/1/2014,17134,15747,1387,8.1,156040,146778,9262,5.9
Natchitoches,10/1/2014,17040,15740,1300,7.6,156417,147427,8990,5.7
Natchitoches,11/1/2014,16941,15663,1278,7.5,156494,147404,9090,5.8
Natchitoches,12/1/2014,16993,15755,1238,7.3,156332,147615,8717,5.6
Natchitoches,1/1/2015,16185,14828,1357,8.4,157030,148145,8885,5.7
Natchitoches,2/1/2015,16757,15502,1255,7.5,156644,148045,8599,5.5
Natchitoches,3/1/2015,16789,15550,1239,7.4,156643,148128,8515,5.4
Natchitoches,4/1/2015,16679,15481,1198,7.2,157060,148511,8550,5.4
Natchitoches,5/1/2015,16765,15469,1296,7.7,157651,148817,8834,5.6
Natchitoches,6/1/2015,16304,14870,1434,8.8,157062,148816,8247,5.3
Natchitoches,7/1/2015,16428,15000,1428,8.7,156997,148830,8167,5.2
Natchitoches,8/1/2015,15964,14676,1288,8.1,157172,149181,7992,5.1
Natchitoches,9/1/2015,16644,15440,1204,7.2,156733,148826,7907,5
Natchitoches,10/1/2015,16375,15229,1146,7,157167,149246,7922,5
Natchitoches,11/1/2015,16434,15386,1048,6.4,157463,149463,8000,5.1
Natchitoches,12/1/2015,16467,15495,972,5.9,158035,150128,7907,5
Natchitoches,1/1/2016,16048,14924,1124,7,158280,150653,7627,4.8
Natchitoches,2/1/2016,16889,15861,1028,6.1,158640,150939,7702,4.9
Natchitoches,3/1/2016,17079,15994,1085,6.4,159179,151218,7961,5
Natchitoches,4/1/2016,16998,15955,1043,6.1,159141,151074,8067,5.1
Natchitoches,5/1/2016,17079,15968,1111,6.5,158784,151132,7652,4.8
Natchitoches,6/1/2016,16616,15250,1366,8.2,158967,151223,7744,4.9
Natchitoches,7/1/2016,16455,15178,1277,7.8,159194,151554,7641,4.8
Natchitoches,8/1/2016,16127,14910,1217,7.5,159562,151779,7784,4.9
Natchitoches,9/1/2016,16945,15820,1125,6.6,159714,151761,7953,5
Natchitoches,10/1/2016,16812,15767,1045,6.2,159605,151793,7811,4.9
Natchitoches,11/1/2016,16689,15682,1007,6,159506,151954,7553,4.7
Natchitoches,12/1/2016,16744,15754,990,5.9,159678,152157,7521,4.7
Natchitoches,1/1/2017,15967,14835,1132,7.1,159620,152152,7468,4.7
Natchitoches,2/1/2017,16573,15566,1007,6.1,159859,152480,7379,4.6
Natchitoches,3/1/2017,16764,15783,981,5.9,160137,153065,7073,4.4
Natchitoches,4/1/2017,16719,15778,941,5.6,160345,153255,7089,4.4
Natchitoches,5/1/2017,16758,15807,951,5.7,160068,153069,7000,4.4
Natchitoches,6/1/2017,16328,15183,1145,7,160192,153318,6873,4.3
Natchitoches,7/1/2017,15976,14898,1078,6.7,160462,153569,6892,4.3
Natchitoches,8/1/2017,15632,14579,1053,6.7,160586,153503,7082,4.4
Natchitoches,9/1/2017,16409,15439,970,5.9,161140,154286,6854,4.3
Natchitoches,10/1/2017,16242,15422,820,5,160309,153609,6700,4.2
Natchitoches,11/1/2017,16182,15349,833,5.1,160579,153805,6774,4.2
Natchitoches,12/1/2017,16320,15536,784,4.8,160535,153904,6632,4.1
Natchitoches,1/1/2018,15835,14879,956,6,160914,154425,6489,4
Natchitoches,2/1/2018,16556,15719,837,5.1,161778,155197,6581,4.1
Natchitoches,3/1/2018,16954,16105,849,5,161686,155214,6472,4
Natchitoches,4/1/2018,16489,15633,856,5.2,161771,155312,6459,4
Natchitoches,5/1/2018,16556,15673,883,5.3,161848,155652,6196,3.8
Natchitoches,6/1/2018,16361,15143,1218,7.4,162210,155762,6447,4
Natchitoches,7/1/2018,16231,15085,1146,7.1,162341,156146,6195,3.8
Natchitoches,8/1/2018,16110,15049,1061,6.6,161660,155504,6156,3.8
Natchitoches,9/1/2018,16609,15678,931,5.6,162087,156015,6073,3.7
Natchitoches,10/1/2018,16382,15487,895,5.5,162602,156391,6211,3.8
Natchitoches,11/1/2018,16441,15564,877,5.3,162836,156721,6115,3.8
Natchitoches,12/1/2018,16438,15593,845,5.1,163206,156817,6389,3.9
Natchitoches,1/1/2019,15745,14638,1107,7,162963,156487,6475,4
Natchitoches,2/1/2019,16132,15302,830,5.1,162999,156863,6136,3.8
Natchitoches,3/1/2019,16260,15470,790,4.9,162904,156701,6202,3.8
Natchitoches,4/1/2019,16155,15459,696,4.3,162586,156625,5961,3.7
Natchitoches,5/1/2019,16312,15481,831,5.1,162751,156821,5930,3.6
Natchitoches,6/1/2019,16112,15012,1100,6.8,163168,157232,5935,3.6
Natchitoches,7/1/2019,16204,15073,1131,7,163590,157529,6061,3.7
Natchitoches,8/1/2019,16513,15388,1125,6.8,163774,157829,5945,3.6
Natchitoches,9/1/2019,16879,15878,1001,5.9,164092,158339,5753,3.5
Natchitoches,10/1/2019,16615,15688,927,5.6,164416,158545,5871,3.6
Natchitoches,11/1/2019,16497,15582,915,5.5,164496,158629,5868,3.6
Natchitoches,12/1/2019,16482,15536,946,5.7,164699,158845,5853,3.6
Natchitoches,1/1/2020,16025,15086,939,5.9,164377,158508,5869,3.6
Natchitoches,2/1/2020,16353,15649,704,4.3,164467,158714,5753,3.5
Natchitoches,3/1/2020,16753,15488,1265,7.6,162559,155353,7206,4.4
Natchitoches,4/1/2020,15059,13811,1248,8.3,156269,133185,23084,14.8
Natchitoches,5/1/2020,15450,14126,1324,8.6,158101,137173,20929,13.2
Natchitoches,6/1/2020,15668,14193,1475,9.4,159994,142342,17652,11
Natchitoches,7/1/2020,15611,14174,1437,9.2,160132,143779,16352,10.2
Natchitoches,8/1/2020,15894,14644,1250,7.9,160706,147245,13461,8.4
Natchitoches,9/1/2020,16274,14996,1278,7.9,160174,147620,12554,7.8
Natchitoches,10/1/2020,16344,15278,1066,6.5,161003,149931,11072,6.9
Natchitoches,11/1/2020,16131,15180,951,5.9,160629,149934,10694,6.7
Natchitoches,12/1/2020,16167,15201,966,6,160745,149975,10770,6.7
Natchitoches,1/1/2021,15971,14980,991,6.2,160088,149852,10236,6.4
Natchitoches,2/1/2021,16105,15217,888,5.5,160184,150189,9995,6.2
Natchitoches,3/1/2021,16399,15543,856,5.2,160400,150644,9756,6.1
Natchitoches,4/1/2021,16514,15722,792,4.8,160843,151081,9762,6.1
Natchitoches,5/1/2021,16386,15559,827,5,160800,151535,9266,5.8
Natchitoches,6/1/2021,16009,14962,1047,6.5,161197,151734,9462,5.9
Natchitoches,7/1/2021,16257,15320,937,5.8,161504,152773,8731,5.4
Natchitoches,8/1/2021,16140,15339,801,5,161527,153250,8276,5.1
Natchitoches,9/1/2021,16687,16001,686,4.1,161495,153843,7652,4.7
Natchitoches,10/1/2021,16442,15827,615,3.7,161754,154475,7279,4.5
Natchitoches,11/1/2021,16433,15867,566,3.4,162281,155530,6751,4.2
Natchitoches,12/1/2021,16474,15957,517,3.1,162497,156099,6398,3.9
Natchitoches,1/1/2022,16173,15512,661,4.1,163627,157115,6512,4
Natchitoches,2/1/2022,16397,15811,586,3.6,163899,157598,6301,3.8
Natchitoches,3/1/2022,16594,16032,562,3.4,164220,158206,6014,3.7
Natchitoches,4/1/2022,16620,16095,525,3.2,163893,157891,6002,3.7
Natchitoches,5/1/2022,16574,15986,588,3.5,164362,158378,5983,3.6
Natchitoches,6/1/2022,16517,15649,868,5.3,164046,158094,5951,3.6
Natchitoches,7/1/2022,16354,15550,804,4.9,164026,158258,5768,3.5
Natchitoches,8/1/2022,16540,15785,755,4.6,164654,158735,5919,3.6
Natchitoches,9/1/2022,16572,15923,649,3.9,164602,158810,5792,3.5
Natchitoches,10/1/2022,16488,15883,605,3.7,164648,158684,5964,3.6
Natchitoches,11/1/2022,16440,15841,599,3.6,164450,158507,5943,3.6
Natchitoches,12/1/2022,16686,16100,586,3.5,165025,159259,5766,3.5
Natchitoches,1/1/2023,17184,16466,718,4.2,165964,160217,5747,3.5
Natchitoches,2/1/2023,17499,16854,645,3.7,166358,160395,5962,3.6
Natchitoches,3/1/2023,17578,16950,628,3.6,166651,160812,5839,3.5
Natchitoches,4/1/2023,17447,16843,604,3.5,166725,160974,5751,3.4
Natchitoches,5/1/2023,17254,16554,700,4.1,166886,160796,6089,3.6
Natchitoches,6/1/2023,17110,16229,881,5.1,166937,160979,5958,3.6
Natchitoches,7/1/2023,16967,16223,744,4.4,167103,161183,5920,3.5
Natchitoches,8/1/2023,17197,16415,782,4.5,167759,161475,6284,3.7
Natchitoches,9/1/2023,17318,16600,718,4.1,167767,161442,6326,3.8
Natchitoches,10/1/2023,17381,16659,722,4.2,167690,161211,6479,3.9
Natchitoches,11/1/2023,17410,16716,694,4,168140,161886,6254,3.7
Natchitoches,12/1/2023,17389,16694,695,4,167439,161124,6315,3.8
Natchitoches,1/1/2024,17183,16367,816,4.7,167339,161190,6149,3.7
Natchitoches,2/1/2024,17377,16636,741,4.3,167475,161013,6462,3.9
Natchitoches,3/1/2024,17483,16758,725,4.1,167922,161425,6497,3.9
Natchitoches,4/1/2024,17421,16717,704,4,167988,161495,6492,3.9
Natchitoches,5/1/2024,17124,16398,726,4.2,167799,161164,6635,4
Natchitoches,6/1/2024,17036,16064,972,5.7,168005,161155,6849,4.1
Natchitoches,7/1/2024,17044,16119,925,5.4,168315,161219,7097,4.2
Natchitoches,8/1/2024,17136,16210,926,5.4,168496,161425,7071,4.2
Natchitoches,9/1/2024,17276,16420,856,5,168703,161802,6901,4.1
Natchitoches,10/1/2024,17214,16389,825,4.8,168428,161456,6972,4.1
Natchitoches,11/1/2024,17139,16313,826,4.8,168304,161183,7121,4.2
Natchitoches,12/1/2024,17140,16368,772,4.5,168547,161661,6886,4.1
Natchitoches,1/1/2025,14179,13387,792,5.6,170744,163895,6849,4
Natchitoches,2/1/2025,14347,13576,771,5.4,170359,163307,7052,4.1
Orleans,1/1/1990,200682,186114,14568,7.3,125833,119081,6752,5.4
Orleans,2/1/1990,200662,187673,12989,6.5,125710,119059,6651,5.3
Orleans,3/1/1990,201703,189239,12464,6.2,125801,119203,6598,5.2
Orleans,4/1/1990,202978,190563,12415,6.1,125649,118852,6797,5.4
Orleans,5/1/1990,205439,192039,13400,6.5,125893,119151,6742,5.4
Orleans,6/1/1990,210294,194133,16161,7.7,125573,118983,6590,5.2
Orleans,7/1/1990,209234,192834,16400,7.8,125732,118810,6922,5.5
Orleans,8/1/1990,205332,189644,15688,7.6,125990,118802,7188,5.7
Orleans,9/1/1990,204034,188177,15857,7.8,125892,118524,7368,5.9
Orleans,10/1/1990,206840,191251,15589,7.5,125995,118536,7459,5.9
Orleans,11/1/1990,206206,190685,15521,7.5,126070,118306,7764,6.2
Orleans,12/1/1990,204828,189888,14940,7.3,126142,118241,7901,6.3
Orleans,1/1/1991,202203,186836,15367,7.6,125955,117940,8015,6.4
Orleans,2/1/1991,203013,187990,15023,7.4,126020,117755,8265,6.6
Orleans,3/1/1991,204013,188816,15197,7.4,126238,117652,8586,6.8
Orleans,4/1/1991,206431,191623,14808,7.2,126548,118109,8439,6.7
Orleans,5/1/1991,207880,191109,16771,8.1,126176,117440,8736,6.9
Orleans,6/1/1991,213609,194110,19499,9.1,126331,117639,8692,6.9
Orleans,7/1/1991,211221,192992,18229,8.6,126154,117568,8586,6.8
Orleans,8/1/1991,205923,189249,16674,8.1,126150,117484,8666,6.9
Orleans,9/1/1991,205517,189364,16153,7.9,126650,117928,8722,6.9
Orleans,10/1/1991,208564,192111,16453,7.9,126642,117800,8842,7
Orleans,11/1/1991,209212,192019,17193,8.2,126701,117770,8931,7
Orleans,12/1/1991,207172,190694,16478,8,126664,117466,9198,7.3
Orleans,1/1/1992,206872,188558,18314,8.9,127261,117978,9283,7.3
Orleans,2/1/1992,206582,189384,17198,8.3,127207,117753,9454,7.4
Orleans,3/1/1992,207684,190650,17034,8.2,127604,118144,9460,7.4
Orleans,4/1/1992,209757,192648,17109,8.2,127841,118426,9415,7.4
Orleans,5/1/1992,211615,192902,18713,8.8,128119,118375,9744,7.6
Orleans,6/1/1992,218437,195317,23120,10.6,128459,118419,10040,7.8
Orleans,7/1/1992,203147,180536,22611,11.1,128563,118713,9850,7.7
Orleans,8/1/1992,197372,176767,20605,10.4,128613,118826,9787,7.6
Orleans,9/1/1992,196214,175639,20575,10.5,128501,118720,9781,7.6
Orleans,10/1/1992,197792,177853,19939,10.1,128026,118628,9398,7.3
Orleans,11/1/1992,198414,178210,20204,10.2,128441,118876,9565,7.4
Orleans,12/1/1992,202008,183411,18597,9.2,128554,118997,9557,7.4
Orleans,1/1/1993,200255,180552,19703,9.8,128400,119075,9325,7.3
Orleans,2/1/1993,200675,182428,18247,9.1,128458,119275,9183,7.1
Orleans,3/1/1993,201451,183412,18039,9,128598,119542,9056,7
Orleans,4/1/1993,202467,184880,17587,8.7,128584,119474,9110,7.1
Orleans,5/1/1993,205807,186571,19236,9.3,129264,120115,9149,7.1
Orleans,6/1/1993,211441,188354,23087,10.9,129411,120290,9121,7
Orleans,7/1/1993,209107,186136,22971,11,129397,120467,8930,6.9
Orleans,8/1/1993,203859,183110,20749,10.2,129619,120856,8763,6.8
Orleans,9/1/1993,202240,182411,19829,9.8,129268,120554,8714,6.7
Orleans,10/1/1993,206096,185677,20419,9.9,129573,120823,8750,6.8
Orleans,11/1/1993,207352,186734,20618,9.9,129711,121169,8542,6.6
Orleans,12/1/1993,205341,186181,19160,9.3,129941,121464,8477,6.5
Orleans,1/1/1994,204675,183575,21100,10.3,130596,121966,8630,6.6
Orleans,2/1/1994,205426,185548,19878,9.7,130669,122086,8583,6.6
Orleans,3/1/1994,205748,186327,19421,9.4,130400,121930,8470,6.5
Orleans,4/1/1994,205724,187623,18101,8.8,130621,122290,8331,6.4
Orleans,5/1/1994,207615,189042,18573,8.9,130779,122864,7915,6.1
Orleans,6/1/1994,212905,190116,22789,10.7,130561,122634,7927,6.1
Orleans,7/1/1994,211063,188621,22442,10.6,130652,122706,7946,6.1
Orleans,8/1/1994,206827,186096,20731,10,131275,123342,7933,6
Orleans,9/1/1994,206262,186467,19795,9.6,131421,123687,7734,5.9
Orleans,10/1/1994,209209,188884,20325,9.7,131744,124112,7632,5.8
Orleans,11/1/1994,209728,190151,19577,9.3,131891,124516,7375,5.6
Orleans,12/1/1994,205931,188813,17118,8.3,131951,124721,7230,5.5
Orleans,1/1/1995,204199,185815,18384,9,132038,124663,7375,5.6
Orleans,2/1/1995,204104,187360,16744,8.2,132115,124928,7187,5.4
Orleans,3/1/1995,206011,188941,17070,8.3,132108,124955,7153,5.4
Orleans,4/1/1995,207246,189901,17345,8.4,132590,124945,7645,5.8
Orleans,5/1/1995,208211,190344,17867,8.6,131851,124421,7430,5.6
Orleans,6/1/1995,213406,191532,21874,10.2,131949,124522,7427,5.6
Orleans,7/1/1995,212419,190365,22054,10.4,132343,124816,7527,5.7
Orleans,8/1/1995,206015,186863,19152,9.3,132336,124852,7484,5.7
Orleans,9/1/1995,206143,187410,18733,9.1,132611,125133,7478,5.6
Orleans,10/1/1995,207599,189045,18554,8.9,132716,125388,7328,5.5
Orleans,11/1/1995,208141,189752,18389,8.8,132614,125188,7426,5.6
Orleans,12/1/1995,205708,188263,17445,8.5,132511,125088,7423,5.6
Orleans,1/1/1996,204378,184635,19743,9.7,132616,125125,7491,5.6
Orleans,2/1/1996,204093,186858,17235,8.4,132952,125639,7313,5.5
Orleans,3/1/1996,206306,188929,17377,8.4,133180,125862,7318,5.5
Orleans,4/1/1996,206833,190047,16786,8.1,133409,125994,7415,5.6
Orleans,5/1/1996,210227,191321,18906,9,133667,126244,7423,5.6
Orleans,6/1/1996,214261,192871,21390,10,133697,126602,7095,5.3
Orleans,7/1/1996,212711,191616,21095,9.9,134284,126947,7337,5.5
Orleans,8/1/1996,206087,188504,17583,8.5,134054,127172,6882,5.1
Orleans,9/1/1996,207093,189910,17183,8.3,134515,127536,6979,5.2
Orleans,10/1/1996,208328,191445,16883,8.1,134921,127890,7031,5.2
Orleans,11/1/1996,208653,192387,16266,7.8,135007,127771,7236,5.4
Orleans,12/1/1996,206134,191676,14458,7,135113,127860,7253,5.4
Orleans,1/1/1997,203592,187921,15671,7.7,135456,128298,7158,5.3
Orleans,2/1/1997,202914,188913,14001,6.9,135400,128298,7102,5.2
Orleans,3/1/1997,205358,191575,13783,6.7,135891,128891,7000,5.2
Orleans,4/1/1997,205450,192794,12656,6.2,136016,129143,6873,5.1
Orleans,5/1/1997,208428,193790,14638,7,136119,129464,6655,4.9
Orleans,6/1/1997,211806,194225,17581,8.3,136211,129412,6799,5
Orleans,7/1/1997,210271,193556,16715,7.9,136477,129822,6655,4.9
Orleans,8/1/1997,205169,190155,15014,7.3,136618,130010,6608,4.8
Orleans,9/1/1997,204944,190556,14388,7,136675,130019,6656,4.9
Orleans,10/1/1997,206198,192322,13876,6.7,136633,130179,6454,4.7
Orleans,11/1/1997,207888,194237,13651,6.6,136961,130653,6308,4.6
Orleans,12/1/1997,206319,193752,12567,6.1,137155,130679,6476,4.7
Orleans,1/1/1998,203504,189712,13792,6.8,137095,130726,6368,4.6
Orleans,2/1/1998,203466,191260,12206,6,137112,130807,6306,4.6
Orleans,3/1/1998,205929,193169,12760,6.2,137236,130814,6422,4.7
Orleans,4/1/1998,206893,194920,11973,5.8,137150,131209,5941,4.3
Orleans,5/1/1998,209529,196031,13498,6.4,137372,131325,6047,4.4
Orleans,6/1/1998,212968,195881,17087,8,137455,131244,6212,4.5
Orleans,7/1/1998,210852,194171,16681,7.9,137588,131329,6259,4.5
Orleans,8/1/1998,205246,190315,14931,7.3,137570,131390,6179,4.5
Orleans,9/1/1998,205699,191477,14222,6.9,138286,131986,6300,4.6
Orleans,10/1/1998,205366,192144,13222,6.4,138279,131999,6280,4.5
Orleans,11/1/1998,206154,193382,12772,6.2,138381,132280,6100,4.4
Orleans,12/1/1998,204493,192953,11540,5.6,138634,132602,6032,4.4
Orleans,1/1/1999,202515,190138,12377,6.1,139003,133027,5976,4.3
Orleans,2/1/1999,202373,191207,11166,5.5,138967,132856,6111,4.4
Orleans,3/1/1999,203109,192960,10149,5,138730,132947,5783,4.2
Orleans,4/1/1999,203322,193277,10045,4.9,138959,132955,6004,4.3
Orleans,5/1/1999,204751,194075,10676,5.2,139107,133311,5796,4.2
Orleans,6/1/1999,208190,194426,13764,6.6,139329,133378,5951,4.3
Orleans,7/1/1999,205775,192678,13097,6.4,139439,133414,6025,4.3
Orleans,8/1/1999,200687,188841,11846,5.9,139430,133591,5838,4.2
Orleans,9/1/1999,201114,189373,11741,5.8,139622,133707,5915,4.2
Orleans,10/1/1999,202329,190813,11516,5.7,139771,133993,5778,4.1
Orleans,11/1/1999,203308,192665,10643,5.2,140025,134309,5716,4.1
Orleans,12/1/1999,201007,191557,9450,4.7,140177,134523,5653,4
Orleans,1/1/2000,208820,197611,11209,5.4,142267,136559,5708,4
Orleans,2/1/2000,209475,199086,10389,5,142456,136598,5858,4.1
Orleans,3/1/2000,210823,200844,9979,4.7,142434,136701,5733,4
Orleans,4/1/2000,210850,202017,8833,4.2,142751,137270,5481,3.8
Orleans,5/1/2000,212664,201711,10953,5.2,142388,136630,5758,4
Orleans,6/1/2000,215072,201729,13343,6.2,142591,136940,5651,4
Orleans,7/1/2000,212500,199770,12730,6,142278,136531,5747,4
Orleans,8/1/2000,207329,195400,11929,5.8,142514,136662,5853,4.1
Orleans,9/1/2000,206901,196025,10876,5.3,142518,136893,5625,3.9
Orleans,10/1/2000,208096,196902,11194,5.4,142622,137088,5534,3.9
Orleans,11/1/2000,209913,198430,11483,5.5,142962,137322,5639,3.9
Orleans,12/1/2000,208636,198359,10277,4.9,143248,137614,5634,3.9
Orleans,1/1/2001,206262,194120,12142,5.9,143800,137778,6023,4.2
Orleans,2/1/2001,205751,195208,10543,5.1,143701,137612,6089,4.2
Orleans,3/1/2001,207695,197269,10426,5,143924,137783,6141,4.3
Orleans,4/1/2001,206477,196783,9694,4.7,143569,137299,6271,4.4
Orleans,5/1/2001,207756,197132,10624,5.1,143318,137092,6226,4.3
Orleans,6/1/2001,210246,197111,13135,6.2,143357,136873,6484,4.5
Orleans,7/1/2001,208584,196225,12359,5.9,143654,137071,6583,4.6
Orleans,8/1/2001,202624,190657,11967,5.9,143284,136241,7042,4.9
Orleans,9/1/2001,204082,192507,11575,5.7,143989,136846,7142,5
Orleans,10/1/2001,205064,192232,12832,6.3,144086,136392,7694,5.3
Orleans,11/1/2001,206890,193588,13302,6.4,144240,136238,8003,5.5
Orleans,12/1/2001,204569,192197,12372,6,144305,136047,8258,5.7
Orleans,1/1/2002,199738,186450,13288,6.7,143883,135701,8182,5.7
Orleans,2/1/2002,200862,188785,12077,6,144653,136438,8215,5.7
Orleans,3/1/2002,201760,190279,11481,5.7,144481,136177,8304,5.7
Orleans,4/1/2002,201736,190701,11035,5.5,144725,136126,8599,5.9
Orleans,5/1/2002,203604,191299,12305,6,144938,136539,8399,5.8
Orleans,6/1/2002,206077,191575,14502,7,144808,136415,8393,5.8
Orleans,7/1/2002,204227,190704,13523,6.6,144803,136413,8390,5.8
Orleans,8/1/2002,199289,186618,12671,6.4,145009,136705,8304,5.7
Orleans,9/1/2002,200219,188739,11480,5.7,145552,137302,8251,5.7
Orleans,10/1/2002,199996,188260,11736,5.9,145314,137008,8307,5.7
Orleans,11/1/2002,201835,189571,12264,6.1,145041,136521,8520,5.9
Orleans,12/1/2002,199617,188216,11401,5.7,145066,136426,8640,6
Orleans,1/1/2003,196774,184484,12290,6.2,145937,137417,8520,5.8
Orleans,2/1/2003,197914,186375,11539,5.8,146100,137482,8618,5.9
Orleans,3/1/2003,198802,188030,10772,5.4,146022,137434,8588,5.9
Orleans,4/1/2003,198952,188564,10388,5.2,146474,137633,8842,6
Orleans,5/1/2003,200711,188772,11939,5.9,146500,137544,8957,6.1
Orleans,6/1/2003,204016,189120,14896,7.3,147056,137790,9266,6.3
Orleans,7/1/2003,201603,187705,13898,6.9,146485,137474,9011,6.2
Orleans,8/1/2003,196388,183308,13080,6.7,146445,137549,8896,6.1
Orleans,9/1/2003,196673,184821,11852,6,146530,137609,8921,6.1
Orleans,10/1/2003,197326,185512,11814,6,146716,137984,8732,6
Orleans,11/1/2003,199804,187812,11992,6,147000,138424,8576,5.8
Orleans,12/1/2003,197529,186642,10887,5.5,146729,138411,8317,5.7
Orleans,1/1/2004,193624,181185,12439,6.4,146842,138472,8370,5.7
Orleans,2/1/2004,193984,183089,10895,5.6,146709,138542,8167,5.6
Orleans,3/1/2004,195234,184873,10361,5.3,146944,138453,8491,5.8
Orleans,4/1/2004,195033,185663,9370,4.8,146850,138680,8170,5.6
Orleans,5/1/2004,196825,186144,10681,5.4,147065,138852,8212,5.6
Orleans,6/1/2004,199748,186869,12879,6.4,147460,139174,8286,5.6
Orleans,7/1/2004,198749,186765,11984,6,147692,139556,8136,5.5
Orleans,8/1/2004,193744,182806,10938,5.6,147564,139573,7990,5.4
Orleans,9/1/2004,194297,183696,10601,5.5,147415,139487,7927,5.4
Orleans,10/1/2004,195663,184274,11389,5.8,147793,139732,8061,5.5
Orleans,11/1/2004,198687,186953,11734,5.9,148162,140231,7932,5.4
Orleans,12/1/2004,196836,185809,11027,5.6,148059,140125,7934,5.4
Orleans,1/1/2005,193165,180388,12777,6.6,148029,140245,7784,5.3
Orleans,2/1/2005,193580,181853,11727,6.1,148364,140385,7980,5.4
Orleans,3/1/2005,194446,183994,10452,5.4,148391,140654,7737,5.2
Orleans,4/1/2005,195408,185591,9817,5,148926,141254,7672,5.2
Orleans,5/1/2005,197592,186306,11286,5.7,149261,141609,7651,5.1
Orleans,6/1/2005,200006,186888,13118,6.6,149238,141714,7524,5
Orleans,7/1/2005,199212,186442,12770,6.4,149432,142026,7406,5
Orleans,8/1/2005,193865,182295,11570,6,149779,142434,7345,4.9
Orleans,7/1/2006,98699,93519,5180,5.2,151377,144202,7175,4.7
Orleans,8/1/2006,97907,92911,4996,5.1,151716,144625,7091,4.7
Orleans,9/1/2006,98805,92669,6136,6.2,151662,144815,6847,4.5
Orleans,10/1/2006,100434,94823,5611,5.6,152041,145314,6727,4.4
Orleans,11/1/2006,100930,95693,5237,5.2,152406,145534,6872,4.5
Orleans,12/1/2006,100750,95983,4767,4.7,152732,145970,6762,4.4
Orleans,1/1/2007,107173,101296,5877,5.5,153144,146028,7116,4.6
Orleans,2/1/2007,106966,101914,5052,4.7,152983,146057,6927,4.5
Orleans,3/1/2007,108137,103270,4867,4.5,153051,146320,6731,4.4
Orleans,4/1/2007,106819,101982,4837,4.5,152435,145586,6850,4.5
Orleans,5/1/2007,107019,101739,5280,4.9,152670,145903,6766,4.4
Orleans,6/1/2007,108913,102783,6130,5.6,153041,146063,6979,4.6
Orleans,7/1/2007,108760,102942,5818,5.3,153054,145905,7149,4.7
Orleans,8/1/2007,107273,101737,5536,5.2,152749,145682,7067,4.6
Orleans,9/1/2007,106938,101448,5490,5.1,153414,146244,7170,4.7
Orleans,10/1/2007,108833,104058,4775,4.4,153183,145946,7237,4.7
Orleans,11/1/2007,109580,104947,4633,4.2,153835,146595,7240,4.7
Orleans,12/1/2007,109546,104739,4807,4.4,153918,146273,7645,5
Orleans,1/1/2008,129688,123298,6390,4.9,154063,146378,7685,5
Orleans,2/1/2008,128940,123686,5254,4.1,153653,146156,7497,4.9
Orleans,3/1/2008,130665,124877,5788,4.4,153908,146086,7822,5.1
Orleans,4/1/2008,131815,126557,5258,4,153769,146132,7637,5
Orleans,5/1/2008,131840,125620,6220,4.7,154303,145908,8395,5.4
Orleans,6/1/2008,134760,126776,7984,5.9,154313,145737,8575,5.6
Orleans,7/1/2008,135090,126758,8332,6.2,154469,145532,8937,5.8
Orleans,8/1/2008,134883,126112,8771,6.5,154641,145203,9438,6.1
Orleans,9/1/2008,136012,125847,10165,7.5,154570,145076,9494,6.1
Orleans,10/1/2008,136111,126739,9372,6.9,154876,144802,10074,6.5
Orleans,11/1/2008,134898,126150,8748,6.5,154639,144100,10538,6.8
Orleans,12/1/2008,135059,125938,9121,6.8,154655,143369,11286,7.3
Orleans,1/1/2009,145317,134356,10961,7.5,154210,142152,12058,7.8
Orleans,2/1/2009,145197,134888,10309,7.1,154538,141640,12898,8.3
Orleans,3/1/2009,145263,134986,10277,7.1,154133,140707,13426,8.7
Orleans,4/1/2009,146456,136205,10251,7,154509,140656,13853,9
Orleans,5/1/2009,146236,135448,10788,7.4,154747,140248,14499,9.4
Orleans,6/1/2009,148753,135630,13123,8.8,154716,140009,14707,9.5
Orleans,7/1/2009,149723,136618,13105,8.8,154502,139901,14601,9.5
Orleans,8/1/2009,148573,136138,12435,8.4,154307,139492,14814,9.6
Orleans,9/1/2009,147232,134903,12329,8.4,153827,138818,15009,9.8
Orleans,10/1/2009,147250,135690,11560,7.9,153784,138432,15352,10
Orleans,11/1/2009,147046,136241,10805,7.3,153878,138659,15219,9.9
Orleans,12/1/2009,145828,134891,10937,7.5,153111,138013,15098,9.9
Orleans,1/1/2010,160560,148034,12526,7.8,153484,138438,15046,9.8
Orleans,2/1/2010,160232,148817,11415,7.1,153694,138581,15113,9.8
Orleans,3/1/2010,161940,150256,11684,7.2,153954,138751,15202,9.9
Orleans,4/1/2010,162880,151313,11567,7.1,154622,139297,15325,9.9
Orleans,5/1/2010,161977,149587,12390,7.6,154091,139241,14849,9.6
Orleans,6/1/2010,164558,150042,14516,8.8,153616,139141,14474,9.4
Orleans,7/1/2010,164346,149522,14824,9,153691,139179,14512,9.4
Orleans,8/1/2010,163569,148920,14649,9,154086,139438,14648,9.5
Orleans,9/1/2010,163759,149322,14437,8.8,153975,139396,14579,9.5
Orleans,10/1/2010,163159,149340,13819,8.5,153635,139119,14516,9.4
Orleans,11/1/2010,163572,150056,13516,8.3,154125,139044,15081,9.8
Orleans,12/1/2010,162945,149991,12954,7.9,153650,139301,14348,9.3
Orleans,1/1/2011,166040,151587,14453,8.7,153263,139250,14013,9.1
Orleans,2/1/2011,165647,152614,13033,7.9,153214,139394,13820,9
Orleans,3/1/2011,166806,153771,13035,7.8,153376,139639,13737,9
Orleans,4/1/2011,165975,153618,12357,7.4,153543,139586,13957,9.1
Orleans,5/1/2011,165739,152759,12980,7.8,153479,139624,13855,9
Orleans,6/1/2011,167296,152265,15031,9,153346,139384,13962,9.1
Orleans,7/1/2011,167091,152219,14872,8.9,153288,139524,13763,9
Orleans,8/1/2011,166156,151906,14250,8.6,153760,139942,13818,9
Orleans,9/1/2011,166307,152324,13983,8.4,154131,140183,13948,9
Orleans,10/1/2011,167134,153714,13420,8,153961,140368,13594,8.8
Orleans,11/1/2011,167324,154932,12392,7.4,154128,140826,13302,8.6
Orleans,12/1/2011,166418,154186,12232,7.4,153995,140902,13093,8.5
Orleans,1/1/2012,167745,154211,13534,8.1,154381,141584,12797,8.3
Orleans,2/1/2012,167676,155169,12507,7.5,154671,141858,12813,8.3
Orleans,3/1/2012,169141,156655,12486,7.4,154749,142036,12713,8.2
Orleans,4/1/2012,169953,158223,11730,6.9,154545,141899,12646,8.2
Orleans,5/1/2012,170215,157654,12561,7.4,154866,142206,12660,8.2
Orleans,6/1/2012,171938,157257,14681,8.5,155083,142391,12692,8.2
Orleans,7/1/2012,172132,157603,14529,8.4,154948,142292,12656,8.2
Orleans,8/1/2012,169717,156364,13353,7.9,154763,142291,12471,8.1
Orleans,9/1/2012,168793,156142,12651,7.5,155160,143044,12115,7.8
Orleans,10/1/2012,170082,158181,11901,7,155554,143431,12124,7.8
Orleans,11/1/2012,169403,158598,10805,6.4,155338,143333,12005,7.7
Orleans,12/1/2012,169362,158023,11339,6.7,155628,143330,12298,7.9
Orleans,1/1/2013,172854,159421,13433,7.8,155763,143292,12471,8
Orleans,2/1/2013,172571,160427,12144,7,155312,143362,11950,7.7
Orleans,3/1/2013,172442,160632,11810,6.8,155005,143316,11689,7.5
Orleans,4/1/2013,173058,161503,11555,6.7,155394,143635,11760,7.6
Orleans,5/1/2013,173146,160843,12303,7.1,155536,143882,11654,7.5
Orleans,6/1/2013,175788,161520,14268,8.1,155749,143999,11751,7.5
Orleans,7/1/2013,174596,160892,13704,7.8,155599,144264,11335,7.3
Orleans,8/1/2013,173786,160928,12858,7.4,155605,144326,11279,7.2
Orleans,9/1/2013,173124,160715,12409,7.2,155687,144418,11270,7.2
Orleans,10/1/2013,173285,161783,11502,6.6,154673,143537,11136,7.2
Orleans,11/1/2013,174064,163691,10373,6,155265,144479,10787,6.9
Orleans,12/1/2013,172801,163251,9550,5.5,155182,144778,10404,6.7
Orleans,1/1/2014,173277,162472,10805,6.2,155352,145150,10202,6.6
Orleans,2/1/2014,174233,164056,10177,5.8,155483,145134,10349,6.7
Orleans,3/1/2014,176191,165680,10511,6,156028,145648,10380,6.7
Orleans,4/1/2014,175668,165854,9814,5.6,155369,145667,9702,6.2
Orleans,5/1/2014,176642,165417,11225,6.4,155684,145825,9859,6.3
Orleans,6/1/2014,179796,166784,13012,7.2,155707,146247,9460,6.1
Orleans,7/1/2014,180628,166555,14073,7.8,156007,146399,9608,6.2
Orleans,8/1/2014,179679,165795,13884,7.7,156130,146530,9599,6.1
Orleans,9/1/2014,179004,165337,13667,7.6,156040,146778,9262,5.9
Orleans,10/1/2014,180518,167551,12967,7.2,156417,147427,8990,5.7
Orleans,11/1/2014,181657,168774,12883,7.1,156494,147404,9090,5.8
Orleans,12/1/2014,179685,167675,12010,6.7,156332,147615,8717,5.6
Orleans,1/1/2015,180441,167125,13316,7.4,157030,148145,8885,5.7
Orleans,2/1/2015,180049,168082,11967,6.6,156644,148045,8599,5.5
Orleans,3/1/2015,181071,169348,11723,6.5,156643,148128,8515,5.4
Orleans,4/1/2015,183140,171898,11242,6.1,157060,148511,8550,5.4
Orleans,5/1/2015,183021,171186,11835,6.5,157651,148817,8834,5.6
Orleans,6/1/2015,183467,170545,12922,7,157062,148816,8247,5.3
Orleans,7/1/2015,182824,169942,12882,7,156997,148830,8167,5.2
Orleans,8/1/2015,180356,168517,11839,6.6,157172,149181,7992,5.1
Orleans,9/1/2015,178919,167268,11651,6.5,156733,148826,7907,5
Orleans,10/1/2015,180754,169599,11155,6.2,157167,149246,7922,5
Orleans,11/1/2015,180053,169879,10174,5.7,157463,149463,8000,5.1
Orleans,12/1/2015,179170,169818,9352,5.2,158035,150128,7907,5
Orleans,1/1/2016,178622,167836,10786,6,158280,150653,7627,4.8
Orleans,2/1/2016,178520,168677,9843,5.5,158640,150939,7702,4.9
Orleans,3/1/2016,179846,169586,10260,5.7,159179,151218,7961,5
Orleans,4/1/2016,180528,170728,9800,5.4,159141,151074,8067,5.1
Orleans,5/1/2016,180219,170249,9970,5.5,158784,151132,7652,4.8
Orleans,6/1/2016,182020,169965,12055,6.6,158967,151223,7744,4.9
Orleans,7/1/2016,182098,170095,12003,6.6,159194,151554,7641,4.8
Orleans,8/1/2016,180184,168734,11450,6.4,159562,151779,7784,4.9
Orleans,9/1/2016,180071,168848,11223,6.2,159714,151761,7953,5
Orleans,10/1/2016,179918,169666,10252,5.7,159605,151793,7811,4.9
Orleans,11/1/2016,179536,170102,9434,5.3,159506,151954,7553,4.7
Orleans,12/1/2016,177415,168480,8935,5,159678,152157,7521,4.7
Orleans,1/1/2017,176521,166295,10226,5.8,159620,152152,7468,4.7
Orleans,2/1/2017,177781,168669,9112,5.1,159859,152480,7379,4.6
Orleans,3/1/2017,177717,168886,8831,5,160137,153065,7073,4.4
Orleans,4/1/2017,179090,170326,8764,4.9,160345,153255,7089,4.4
Orleans,5/1/2017,178202,169400,8802,4.9,160068,153069,7000,4.4
Orleans,6/1/2017,179873,169257,10616,5.9,160192,153318,6873,4.3
Orleans,7/1/2017,179858,169325,10533,5.9,160462,153569,6892,4.3
Orleans,8/1/2017,178605,168231,10374,5.8,160586,153503,7082,4.4
Orleans,9/1/2017,178744,169470,9274,5.2,161140,154286,6854,4.3
Orleans,10/1/2017,178373,170264,8109,4.5,160309,153609,6700,4.2
Orleans,11/1/2017,178794,170866,7928,4.4,160579,153805,6774,4.2
Orleans,12/1/2017,177623,170159,7464,4.2,160535,153904,6632,4.1
Orleans,1/1/2018,176873,168365,8508,4.8,160914,154425,6489,4
Orleans,2/1/2018,177630,169588,8042,4.5,161778,155197,6581,4.1
Orleans,3/1/2018,177960,169743,8217,4.6,161686,155214,6472,4
Orleans,4/1/2018,179568,171432,8136,4.5,161771,155312,6459,4
Orleans,5/1/2018,178421,169945,8476,4.8,161848,155652,6196,3.8
Orleans,6/1/2018,180857,169633,11224,6.2,162210,155762,6447,4
Orleans,7/1/2018,180563,169915,10648,5.9,162341,156146,6195,3.8
Orleans,8/1/2018,177638,167796,9842,5.5,161660,155504,6156,3.8
Orleans,9/1/2018,177073,168126,8947,5.1,162087,156015,6073,3.7
Orleans,10/1/2018,178230,169732,8498,4.8,162602,156391,6211,3.8
Orleans,11/1/2018,178127,170262,7865,4.4,162836,156721,6115,3.8
Orleans,12/1/2018,176723,168998,7725,4.4,163206,156817,6389,3.9
Orleans,1/1/2019,176946,167756,9190,5.2,162963,156487,6475,4
Orleans,2/1/2019,177212,169607,7605,4.3,162999,156863,6136,3.8
Orleans,3/1/2019,176713,169527,7186,4.1,162904,156701,6202,3.8
Orleans,4/1/2019,178344,171541,6803,3.8,162586,156625,5961,3.7
Orleans,5/1/2019,177804,170112,7692,4.3,162751,156821,5930,3.6
Orleans,6/1/2019,181075,171066,10009,5.5,163168,157232,5935,3.6
Orleans,7/1/2019,180597,170698,9899,5.5,163590,157529,6061,3.7
Orleans,8/1/2019,178758,169537,9221,5.2,163774,157829,5945,3.6
Orleans,9/1/2019,178524,170069,8455,4.7,164092,158339,5753,3.5
Orleans,10/1/2019,180153,171547,8606,4.8,164416,158545,5871,3.6
Orleans,11/1/2019,180698,172483,8215,4.5,164496,158629,5868,3.6
Orleans,12/1/2019,178909,171098,7811,4.4,164699,158845,5853,3.6
Orleans,1/1/2020,178190,169808,8382,4.7,164377,158508,5869,3.6
Orleans,2/1/2020,177341,170466,6875,3.9,164467,158714,5753,3.5
Orleans,3/1/2020,178237,166095,12142,6.8,162559,155353,7206,4.4
Orleans,4/1/2020,174320,139176,35144,20.2,156269,133185,23084,14.8
Orleans,5/1/2020,176261,143001,33260,18.9,158101,137173,20929,13.2
Orleans,6/1/2020,182550,149973,32577,17.8,159994,142342,17652,11
Orleans,7/1/2020,181921,151907,30014,16.5,160132,143779,16352,10.2
Orleans,8/1/2020,179648,154586,25062,14,160706,147245,13461,8.4
Orleans,9/1/2020,180118,154714,25404,14.1,160174,147620,12554,7.8
Orleans,10/1/2020,180809,158799,22010,12.2,161003,149931,11072,6.9
Orleans,11/1/2020,177565,159449,18116,10.2,160629,149934,10694,6.7
Orleans,12/1/2020,175939,158679,17260,9.8,160745,149975,10770,6.7
Orleans,1/1/2021,174679,156314,18365,10.5,160088,149852,10236,6.4
Orleans,2/1/2021,175574,158701,16873,9.6,160184,150189,9995,6.2
Orleans,3/1/2021,176006,160085,15921,9,160400,150644,9756,6.1
Orleans,4/1/2021,179480,161729,17751,9.9,160843,151081,9762,6.1
Orleans,5/1/2021,178894,161905,16989,9.5,160800,151535,9266,5.8
Orleans,6/1/2021,181260,162364,18896,10.4,161197,151734,9462,5.9
Orleans,7/1/2021,181046,164789,16257,9,161504,152773,8731,5.4
Orleans,8/1/2021,177886,164056,13830,7.8,161527,153250,8276,5.1
Orleans,9/1/2021,171767,158530,13237,7.7,161495,153843,7652,4.7
Orleans,10/1/2021,173203,162746,10457,6,161754,154475,7279,4.5
Orleans,11/1/2021,174286,164963,9323,5.3,162281,155530,6751,4.2
Orleans,12/1/2021,172974,164836,8138,4.7,162497,156099,6398,3.9
Orleans,1/1/2022,173015,163228,9787,5.7,163627,157115,6512,4
Orleans,2/1/2022,174183,165468,8715,5,163899,157598,6301,3.8
Orleans,3/1/2022,175103,167089,8014,4.6,164220,158206,6014,3.7
Orleans,4/1/2022,174985,167713,7272,4.2,163893,157891,6002,3.7
Orleans,5/1/2022,175412,167929,7483,4.3,164362,158378,5983,3.6
Orleans,6/1/2022,177329,168123,9206,5.2,164046,158094,5951,3.6
Orleans,7/1/2022,176766,167927,8839,5,164026,158258,5768,3.5
Orleans,8/1/2022,174932,166717,8215,4.7,164654,158735,5919,3.6
Orleans,9/1/2022,174058,166801,7257,4.2,164602,158810,5792,3.5
Orleans,10/1/2022,174312,167686,6626,3.8,164648,158684,5964,3.6
Orleans,11/1/2022,174423,168081,6342,3.6,164450,158507,5943,3.6
Orleans,12/1/2022,174059,167686,6373,3.7,165025,159259,5766,3.5
Orleans,1/1/2023,173708,165973,7735,4.5,165964,160217,5747,3.5
Orleans,2/1/2023,174741,167459,7282,4.2,166358,160395,5962,3.6
Orleans,3/1/2023,175626,168472,7154,4.1,166651,160812,5839,3.5
Orleans,4/1/2023,175733,169186,6547,3.7,166725,160974,5751,3.4
Orleans,5/1/2023,175812,168230,7582,4.3,166886,160796,6089,3.6
Orleans,6/1/2023,177337,168356,8981,5.1,166937,160979,5958,3.6
Orleans,7/1/2023,175756,167494,8262,4.7,167103,161183,5920,3.5
Orleans,8/1/2023,175617,166688,8929,5.1,167759,161475,6284,3.7
Orleans,9/1/2023,174977,166686,8291,4.7,167767,161442,6326,3.8
Orleans,10/1/2023,175178,166875,8303,4.7,167690,161211,6479,3.9
Orleans,11/1/2023,175306,167409,7897,4.5,168140,161886,6254,3.7
Orleans,12/1/2023,173294,165506,7788,4.5,167439,161124,6315,3.8
Orleans,1/1/2024,172751,163588,9163,5.3,167339,161190,6149,3.7
Orleans,2/1/2024,173485,165091,8394,4.8,167475,161013,6462,3.9
Orleans,3/1/2024,174859,166676,8183,4.7,167922,161425,6497,3.9
Orleans,4/1/2024,175274,167768,7506,4.3,167988,161495,6492,3.9
Orleans,5/1/2024,173813,166079,7734,4.4,167799,161164,6635,4
Orleans,6/1/2024,176144,166133,10011,5.7,168005,161155,6849,4.1
Orleans,7/1/2024,177740,167515,10225,5.8,168315,161219,7097,4.2
Orleans,8/1/2024,175377,165666,9711,5.5,168496,161425,7071,4.2
Orleans,9/1/2024,174706,165694,9012,5.2,168703,161802,6901,4.1
Orleans,10/1/2024,175584,166339,9245,5.3,168428,161456,6972,4.1
Orleans,11/1/2024,175740,167043,8697,4.9,168304,161183,7121,4.2
Orleans,12/1/2024,173800,165809,7991,4.6,168547,161661,6886,4.1
Orleans,1/1/2025,173823,165552,8271,4.8,170744,163895,6849,4
Orleans,2/1/2025,175205,167548,7657,4.4,170359,163307,7052,4.1
Ouachita,1/1/1990,63881,60280,3601,5.6,125833,119081,6752,5.4
Ouachita,2/1/1990,64707,61533,3174,4.9,125710,119059,6651,5.3
Ouachita,3/1/1990,65066,61968,3098,4.8,125801,119203,6598,5.2
Ouachita,4/1/1990,64775,61710,3065,4.7,125649,118852,6797,5.4
Ouachita,5/1/1990,64262,61074,3188,5,125893,119151,6742,5.4
Ouachita,6/1/1990,64742,60912,3830,5.9,125573,118983,6590,5.2
Ouachita,7/1/1990,66878,63134,3744,5.6,125732,118810,6922,5.5
Ouachita,8/1/1990,66034,61929,4105,6.2,125990,118802,7188,5.7
Ouachita,9/1/1990,65560,61344,4216,6.4,125892,118524,7368,5.9
Ouachita,10/1/1990,65915,62012,3903,5.9,125995,118536,7459,5.9
Ouachita,11/1/1990,65612,61661,3951,6,126070,118306,7764,6.2
Ouachita,12/1/1990,65356,61646,3710,5.7,126142,118241,7901,6.3
Ouachita,1/1/1991,64506,59911,4595,7.1,125955,117940,8015,6.4
Ouachita,2/1/1991,64945,60807,4138,6.4,126020,117755,8265,6.6
Ouachita,3/1/1991,65682,61709,3973,6,126238,117652,8586,6.8
Ouachita,4/1/1991,66697,62765,3932,5.9,126548,118109,8439,6.7
Ouachita,5/1/1991,65723,61563,4160,6.3,126176,117440,8736,6.9
Ouachita,6/1/1991,66638,61993,4645,7,126331,117639,8692,6.9
Ouachita,7/1/1991,67720,63647,4073,6,126154,117568,8586,6.8
Ouachita,8/1/1991,66160,62146,4014,6.1,126150,117484,8666,6.9
Ouachita,9/1/1991,67039,63215,3824,5.7,126650,117928,8722,6.9
Ouachita,10/1/1991,68132,64358,3774,5.5,126642,117800,8842,7
Ouachita,11/1/1991,68161,64805,3356,4.9,126701,117770,8931,7
Ouachita,12/1/1991,67544,64100,3444,5.1,126664,117466,9198,7.3
Ouachita,1/1/1992,66142,62148,3994,6,127261,117978,9283,7.3
Ouachita,2/1/1992,65883,62304,3579,5.4,127207,117753,9454,7.4
Ouachita,3/1/1992,65692,62139,3553,5.4,127604,118144,9460,7.4
Ouachita,4/1/1992,66042,62647,3395,5.1,127841,118426,9415,7.4
Ouachita,5/1/1992,65631,62044,3587,5.5,128119,118375,9744,7.6
Ouachita,6/1/1992,66831,62441,4390,6.6,128459,118419,10040,7.8
Ouachita,7/1/1992,69678,65583,4095,5.9,128563,118713,9850,7.7
Ouachita,8/1/1992,69165,65117,4048,5.9,128613,118826,9787,7.6
Ouachita,9/1/1992,68351,64563,3788,5.5,128501,118720,9781,7.6
Ouachita,10/1/1992,67331,63971,3360,5,128026,118628,9398,7.3
Ouachita,11/1/1992,66731,63598,3133,4.7,128441,118876,9565,7.4
Ouachita,12/1/1992,65401,62255,3146,4.8,128554,118997,9557,7.4
Ouachita,1/1/1993,64654,60825,3829,5.9,128400,119075,9325,7.3
Ouachita,2/1/1993,64913,61452,3461,5.3,128458,119275,9183,7.1
Ouachita,3/1/1993,65143,61692,3451,5.3,128598,119542,9056,7
Ouachita,4/1/1993,65161,61666,3495,5.4,128584,119474,9110,7.1
Ouachita,5/1/1993,65166,61498,3668,5.6,129264,120115,9149,7.1
Ouachita,6/1/1993,65213,60892,4321,6.6,129411,120290,9121,7
Ouachita,7/1/1993,66428,62569,3859,5.8,129397,120467,8930,6.9
Ouachita,8/1/1993,65115,61360,3755,5.8,129619,120856,8763,6.8
Ouachita,9/1/1993,65717,62023,3694,5.6,129268,120554,8714,6.7
Ouachita,10/1/1993,66261,62571,3690,5.6,129573,120823,8750,6.8
Ouachita,11/1/1993,66079,62654,3425,5.2,129711,121169,8542,6.6
Ouachita,12/1/1993,65623,62255,3368,5.1,129941,121464,8477,6.5
Ouachita,1/1/1994,64301,60197,4104,6.4,130596,121966,8630,6.6
Ouachita,2/1/1994,64809,60889,3920,6,130669,122086,8583,6.6
Ouachita,3/1/1994,64564,60563,4001,6.2,130400,121930,8470,6.5
Ouachita,4/1/1994,65040,61251,3789,5.8,130621,122290,8331,6.4
Ouachita,5/1/1994,64928,61151,3777,5.8,130779,122864,7915,6.1
Ouachita,6/1/1994,65073,60563,4510,6.9,130561,122634,7927,6.1
Ouachita,7/1/1994,66605,62591,4014,6,130652,122706,7946,6.1
Ouachita,8/1/1994,66582,62354,4228,6.4,131275,123342,7933,6
Ouachita,9/1/1994,65804,61744,4060,6.2,131421,123687,7734,5.9
Ouachita,10/1/1994,66335,62363,3972,6,131744,124112,7632,5.8
Ouachita,11/1/1994,66344,62718,3626,5.5,131891,124516,7375,5.6
Ouachita,12/1/1994,65680,62422,3258,5,131951,124721,7230,5.5
Ouachita,1/1/1995,65148,61268,3880,6,132038,124663,7375,5.6
Ouachita,2/1/1995,65810,62367,3443,5.2,132115,124928,7187,5.4
Ouachita,3/1/1995,66435,62977,3458,5.2,132108,124955,7153,5.4
Ouachita,4/1/1995,66842,63493,3349,5,132590,124945,7645,5.8
Ouachita,5/1/1995,66686,63324,3362,5,131851,124421,7430,5.6
Ouachita,6/1/1995,67684,63770,3914,5.8,131949,124522,7427,5.6
Ouachita,7/1/1995,67943,64373,3570,5.3,132343,124816,7527,5.7
Ouachita,8/1/1995,67750,64061,3689,5.4,132336,124852,7484,5.7
Ouachita,9/1/1995,67557,63938,3619,5.4,132611,125133,7478,5.6
Ouachita,10/1/1995,67844,64255,3589,5.3,132716,125388,7328,5.5
Ouachita,11/1/1995,68172,64718,3454,5.1,132614,125188,7426,5.6
Ouachita,12/1/1995,67287,63984,3303,4.9,132511,125088,7423,5.6
Ouachita,1/1/1996,66845,62673,4172,6.2,132616,125125,7491,5.6
Ouachita,2/1/1996,67225,63604,3621,5.4,132952,125639,7313,5.5
Ouachita,3/1/1996,67844,64322,3522,5.2,133180,125862,7318,5.5
Ouachita,4/1/1996,67850,64318,3532,5.2,133409,125994,7415,5.6
Ouachita,5/1/1996,68090,64268,3822,5.6,133667,126244,7423,5.6
Ouachita,6/1/1996,68915,64424,4491,6.5,133697,126602,7095,5.3
Ouachita,7/1/1996,68880,64600,4280,6.2,134284,126947,7337,5.5
Ouachita,8/1/1996,68892,64756,4136,6,134054,127172,6882,5.1
Ouachita,9/1/1996,68662,64506,4156,6.1,134515,127536,6979,5.2
Ouachita,10/1/1996,69582,65629,3953,5.7,134921,127890,7031,5.2
Ouachita,11/1/1996,69260,65526,3734,5.4,135007,127771,7236,5.4
Ouachita,12/1/1996,68428,64918,3510,5.1,135113,127860,7253,5.4
Ouachita,1/1/1997,67695,63374,4321,6.4,135456,128298,7158,5.3
Ouachita,2/1/1997,67380,63593,3787,5.6,135400,128298,7102,5.2
Ouachita,3/1/1997,68452,64343,4109,6,135891,128891,7000,5.2
Ouachita,4/1/1997,68321,64590,3731,5.5,136016,129143,6873,5.1
Ouachita,5/1/1997,67979,64042,3937,5.8,136119,129464,6655,4.9
Ouachita,6/1/1997,68464,63468,4996,7.3,136211,129412,6799,5
Ouachita,7/1/1997,68946,64429,4517,6.6,136477,129822,6655,4.9
Ouachita,8/1/1997,68818,64433,4385,6.4,136618,130010,6608,4.8
Ouachita,9/1/1997,68878,64719,4159,6,136675,130019,6656,4.9
Ouachita,10/1/1997,68815,64923,3892,5.7,136633,130179,6454,4.7
Ouachita,11/1/1997,68666,65137,3529,5.1,136961,130653,6308,4.6
Ouachita,12/1/1997,68322,65000,3322,4.9,137155,130679,6476,4.7
Ouachita,1/1/1998,67405,63561,3844,5.7,137095,130726,6368,4.6
Ouachita,2/1/1998,67273,64103,3170,4.7,137112,130807,6306,4.6
Ouachita,3/1/1998,67922,64448,3474,5.1,137236,130814,6422,4.7
Ouachita,4/1/1998,68306,65161,3145,4.6,137150,131209,5941,4.3
Ouachita,5/1/1998,68149,64839,3310,4.9,137372,131325,6047,4.4
Ouachita,6/1/1998,69462,65213,4249,6.1,137455,131244,6212,4.5
Ouachita,7/1/1998,69343,64893,4450,6.4,137588,131329,6259,4.5
Ouachita,8/1/1998,68545,64644,3901,5.7,137570,131390,6179,4.5
Ouachita,9/1/1998,68558,64892,3666,5.3,138286,131986,6300,4.6
Ouachita,10/1/1998,68418,65267,3151,4.6,138279,131999,6280,4.5
Ouachita,11/1/1998,68313,65458,2855,4.2,138381,132280,6100,4.4
Ouachita,12/1/1998,67919,65247,2672,3.9,138634,132602,6032,4.4
Ouachita,1/1/1999,67848,64792,3056,4.5,139003,133027,5976,4.3
Ouachita,2/1/1999,68103,65598,2505,3.7,138967,132856,6111,4.4
Ouachita,3/1/1999,68459,66077,2382,3.5,138730,132947,5783,4.2
Ouachita,4/1/1999,68755,66546,2209,3.2,138959,132955,6004,4.3
Ouachita,5/1/1999,68305,66095,2210,3.2,139107,133311,5796,4.2
Ouachita,6/1/1999,69239,66312,2927,4.2,139329,133378,5951,4.3
Ouachita,7/1/1999,70180,67457,2723,3.9,139439,133414,6025,4.3
Ouachita,8/1/1999,69958,67316,2642,3.8,139430,133591,5838,4.2
Ouachita,9/1/1999,70086,67609,2477,3.5,139622,133707,5915,4.2
Ouachita,10/1/1999,70270,67801,2469,3.5,139771,133993,5778,4.1
Ouachita,11/1/1999,69852,67605,2247,3.2,140025,134309,5716,4.1
Ouachita,12/1/1999,69766,67653,2113,3,140177,134523,5653,4
Ouachita,1/1/2000,68454,65289,3165,4.6,142267,136559,5708,4
Ouachita,2/1/2000,68596,65776,2820,4.1,142456,136598,5858,4.1
Ouachita,3/1/2000,68994,66038,2956,4.3,142434,136701,5733,4
Ouachita,4/1/2000,70221,67524,2697,3.8,142751,137270,5481,3.8
Ouachita,5/1/2000,69869,66854,3015,4.3,142388,136630,5758,4
Ouachita,6/1/2000,70188,66469,3719,5.3,142591,136940,5651,4
Ouachita,7/1/2000,70093,66629,3464,4.9,142278,136531,5747,4
Ouachita,8/1/2000,69893,66361,3532,5.1,142514,136662,5853,4.1
Ouachita,9/1/2000,69391,66015,3376,4.9,142518,136893,5625,3.9
Ouachita,10/1/2000,69733,66464,3269,4.7,142622,137088,5534,3.9
Ouachita,11/1/2000,69679,66432,3247,4.7,142962,137322,5639,3.9
Ouachita,12/1/2000,69656,66549,3107,4.5,143248,137614,5634,3.9
Ouachita,1/1/2001,69854,65848,4006,5.7,143800,137778,6023,4.2
Ouachita,2/1/2001,69608,66193,3415,4.9,143701,137612,6089,4.2
Ouachita,3/1/2001,70140,66431,3709,5.3,143924,137783,6141,4.3
Ouachita,4/1/2001,71124,67618,3506,4.9,143569,137299,6271,4.4
Ouachita,5/1/2001,70682,67182,3500,5,143318,137092,6226,4.3
Ouachita,6/1/2001,71311,67068,4243,5.9,143357,136873,6484,4.5
Ouachita,7/1/2001,71393,67557,3836,5.4,143654,137071,6583,4.6
Ouachita,8/1/2001,71351,67430,3921,5.5,143284,136241,7042,4.9
Ouachita,9/1/2001,71854,67949,3905,5.4,143989,136846,7142,5
Ouachita,10/1/2001,71512,67676,3836,5.4,144086,136392,7694,5.3
Ouachita,11/1/2001,71384,67691,3693,5.2,144240,136238,8003,5.5
Ouachita,12/1/2001,71180,67547,3633,5.1,144305,136047,8258,5.7
Ouachita,1/1/2002,70082,66072,4010,5.7,143883,135701,8182,5.7
Ouachita,2/1/2002,70794,67358,3436,4.9,144653,136438,8215,5.7
Ouachita,3/1/2002,71226,67751,3475,4.9,144481,136177,8304,5.7
Ouachita,4/1/2002,71656,68243,3413,4.8,144725,136126,8599,5.9
Ouachita,5/1/2002,71561,68037,3524,4.9,144938,136539,8399,5.8
Ouachita,6/1/2002,73184,68878,4306,5.9,144808,136415,8393,5.8
Ouachita,7/1/2002,72433,68553,3880,5.4,144803,136413,8390,5.8
Ouachita,8/1/2002,72024,68223,3801,5.3,145009,136705,8304,5.7
Ouachita,9/1/2002,72033,68364,3669,5.1,145552,137302,8251,5.7
Ouachita,10/1/2002,72212,68638,3574,4.9,145314,137008,8307,5.7
Ouachita,11/1/2002,71629,67921,3708,5.2,145041,136521,8520,5.9
Ouachita,12/1/2002,71339,67615,3724,5.2,145066,136426,8640,6
Ouachita,1/1/2003,72169,67923,4246,5.9,145937,137417,8520,5.8
Ouachita,2/1/2003,72336,68509,3827,5.3,146100,137482,8618,5.9
Ouachita,3/1/2003,72781,68699,4082,5.6,146022,137434,8588,5.9
Ouachita,4/1/2003,72077,68075,4002,5.6,146474,137633,8842,6
Ouachita,5/1/2003,71475,67287,4188,5.9,146500,137544,8957,6.1
Ouachita,6/1/2003,72794,67529,5265,7.2,147056,137790,9266,6.3
Ouachita,7/1/2003,72631,67798,4833,6.7,146485,137474,9011,6.2
Ouachita,8/1/2003,71857,67290,4567,6.4,146445,137549,8896,6.1
Ouachita,9/1/2003,71709,67503,4206,5.9,146530,137609,8921,6.1
Ouachita,10/1/2003,71876,67965,3911,5.4,146716,137984,8732,6
Ouachita,11/1/2003,71934,68181,3753,5.2,147000,138424,8576,5.8
Ouachita,12/1/2003,71643,68051,3592,5,146729,138411,8317,5.7
Ouachita,1/1/2004,71742,67329,4413,6.2,146842,138472,8370,5.7
Ouachita,2/1/2004,71263,67523,3740,5.2,146709,138542,8167,5.6
Ouachita,3/1/2004,71523,67559,3964,5.5,146944,138453,8491,5.8
Ouachita,4/1/2004,71235,67635,3600,5.1,146850,138680,8170,5.6
Ouachita,5/1/2004,70972,67231,3741,5.3,147065,138852,8212,5.6
Ouachita,6/1/2004,72347,67818,4529,6.3,147460,139174,8286,5.6
Ouachita,7/1/2004,72632,68456,4176,5.7,147692,139556,8136,5.5
Ouachita,8/1/2004,71793,67978,3815,5.3,147564,139573,7990,5.4
Ouachita,9/1/2004,71268,67579,3689,5.2,147415,139487,7927,5.4
Ouachita,10/1/2004,71412,67743,3669,5.1,147793,139732,8061,5.5
Ouachita,11/1/2004,71036,67434,3602,5.1,148162,140231,7932,5.4
Ouachita,12/1/2004,70980,67360,3620,5.1,148059,140125,7934,5.4
Ouachita,1/1/2005,70315,66021,4294,6.1,148029,140245,7784,5.3
Ouachita,2/1/2005,70350,66516,3834,5.4,148364,140385,7980,5.4
Ouachita,3/1/2005,70849,67040,3809,5.4,148391,140654,7737,5.2
Ouachita,4/1/2005,70801,67176,3625,5.1,148926,141254,7672,5.2
Ouachita,5/1/2005,70664,66818,3846,5.4,149261,141609,7651,5.1
Ouachita,6/1/2005,71228,66609,4619,6.5,149238,141714,7524,5
Ouachita,7/1/2005,71703,67475,4228,5.9,149432,142026,7406,5
Ouachita,8/1/2005,70865,66886,3979,5.6,149779,142434,7345,4.9
Ouachita,9/1/2005,77701,71645,6056,7.8,149954,142401,7553,5
Ouachita,10/1/2005,78145,72749,5396,6.9,150001,142548,7453,5
Ouachita,11/1/2005,77599,72198,5401,7,150065,142499,7566,5
Ouachita,12/1/2005,75229,71647,3582,4.8,150030,142752,7279,4.9
Ouachita,1/1/2006,72867,69839,3028,4.2,150214,143150,7064,4.7
Ouachita,2/1/2006,72389,69923,2466,3.4,150641,143457,7184,4.8
Ouachita,3/1/2006,72448,69811,2637,3.6,150813,143741,7072,4.7
Ouachita,4/1/2006,72567,70020,2547,3.5,150881,143761,7120,4.7
Ouachita,5/1/2006,72644,69836,2808,3.9,151069,144089,6980,4.6
Ouachita,6/1/2006,73501,70048,3453,4.7,151354,144353,7001,4.6
Ouachita,7/1/2006,73497,70512,2985,4.1,151377,144202,7175,4.7
Ouachita,8/1/2006,72389,69395,2994,4.1,151716,144625,7091,4.7
Ouachita,9/1/2006,71908,68980,2928,4.1,151662,144815,6847,4.5
Ouachita,10/1/2006,72774,69856,2918,4,152041,145314,6727,4.4
Ouachita,11/1/2006,73094,70214,2880,3.9,152406,145534,6872,4.5
Ouachita,12/1/2006,73066,70332,2734,3.7,152732,145970,6762,4.4
Ouachita,1/1/2007,71463,67781,3682,5.2,153144,146028,7116,4.6
Ouachita,2/1/2007,71516,68232,3284,4.6,152983,146057,6927,4.5
Ouachita,3/1/2007,71627,68456,3171,4.4,153051,146320,6731,4.4
Ouachita,4/1/2007,71714,68411,3303,4.6,152435,145586,6850,4.5
Ouachita,5/1/2007,71599,68069,3530,4.9,152670,145903,6766,4.4
Ouachita,6/1/2007,72470,68249,4221,5.8,153041,146063,6979,4.6
Ouachita,7/1/2007,72639,68577,4062,5.6,153054,145905,7149,4.7
Ouachita,8/1/2007,71924,68219,3705,5.2,152749,145682,7067,4.6
Ouachita,9/1/2007,72278,68756,3522,4.9,153414,146244,7170,4.7
Ouachita,10/1/2007,71634,68507,3127,4.4,153183,145946,7237,4.7
Ouachita,11/1/2007,72304,69326,2978,4.1,153835,146595,7240,4.7
Ouachita,12/1/2007,71733,68567,3166,4.4,153918,146273,7645,5
Ouachita,1/1/2008,70905,67416,3489,4.9,154063,146378,7685,5
Ouachita,2/1/2008,70706,67820,2886,4.1,153653,146156,7497,4.9
Ouachita,3/1/2008,71467,68339,3128,4.4,153908,146086,7822,5.1
Ouachita,4/1/2008,71582,68790,2792,3.9,153769,146132,7637,5
Ouachita,5/1/2008,71630,68440,3190,4.5,154303,145908,8395,5.4
Ouachita,6/1/2008,72209,68202,4007,5.5,154313,145737,8575,5.6
Ouachita,7/1/2008,72340,68440,3900,5.4,154469,145532,8937,5.8
Ouachita,8/1/2008,71558,67638,3920,5.5,154641,145203,9438,6.1
Ouachita,9/1/2008,71932,68433,3499,4.9,154570,145076,9494,6.1
Ouachita,10/1/2008,71902,68235,3667,5.1,154876,144802,10074,6.5
Ouachita,11/1/2008,71631,67901,3730,5.2,154639,144100,10538,6.8
Ouachita,12/1/2008,71246,67289,3957,5.6,154655,143369,11286,7.3
Ouachita,1/1/2009,71425,66752,4673,6.5,154210,142152,12058,7.8
Ouachita,2/1/2009,72077,67672,4405,6.1,154538,141640,12898,8.3
Ouachita,3/1/2009,72368,67662,4706,6.5,154133,140707,13426,8.7
Ouachita,4/1/2009,72332,67711,4621,6.4,154509,140656,13853,9
Ouachita,5/1/2009,71493,66685,4808,6.7,154747,140248,14499,9.4
Ouachita,6/1/2009,71970,66335,5635,7.8,154716,140009,14707,9.5
Ouachita,7/1/2009,72102,66544,5558,7.7,154502,139901,14601,9.5
Ouachita,8/1/2009,71484,66211,5273,7.4,154307,139492,14814,9.6
Ouachita,9/1/2009,70686,65765,4921,7,153827,138818,15009,9.8
Ouachita,10/1/2009,71125,66421,4704,6.6,153784,138432,15352,10
Ouachita,11/1/2009,71589,67041,4548,6.4,153878,138659,15219,9.9
Ouachita,12/1/2009,71057,66302,4755,6.7,153111,138013,15098,9.9
Ouachita,1/1/2010,70682,65261,5421,7.7,153484,138438,15046,9.8
Ouachita,2/1/2010,70394,65378,5016,7.1,153694,138581,15113,9.8
Ouachita,3/1/2010,71233,66204,5029,7.1,153954,138751,15202,9.9
Ouachita,4/1/2010,71434,66430,5004,7,154622,139297,15325,9.9
Ouachita,5/1/2010,71189,65876,5313,7.5,154091,139241,14849,9.6
Ouachita,6/1/2010,71527,65466,6061,8.5,153616,139141,14474,9.4
Ouachita,7/1/2010,71768,65815,5953,8.3,153691,139179,14512,9.4
Ouachita,8/1/2010,70604,64774,5830,8.3,154086,139438,14648,9.5
Ouachita,9/1/2010,70938,65291,5647,8,153975,139396,14579,9.5
Ouachita,10/1/2010,70290,64782,5508,7.8,153635,139119,14516,9.4
Ouachita,11/1/2010,70351,64881,5470,7.8,154125,139044,15081,9.8
Ouachita,12/1/2010,69781,64457,5324,7.6,153650,139301,14348,9.3
Ouachita,1/1/2011,70230,64293,5937,8.5,153263,139250,14013,9.1
Ouachita,2/1/2011,69977,64457,5520,7.9,153214,139394,13820,9
Ouachita,3/1/2011,70586,65127,5459,7.7,153376,139639,13737,9
Ouachita,4/1/2011,69988,64916,5072,7.2,153543,139586,13957,9.1
Ouachita,5/1/2011,70025,64702,5323,7.6,153479,139624,13855,9
Ouachita,6/1/2011,70759,64655,6104,8.6,153346,139384,13962,9.1
Ouachita,7/1/2011,70505,64658,5847,8.3,153288,139524,13763,9
Ouachita,8/1/2011,69769,64154,5615,8,153760,139942,13818,9
Ouachita,9/1/2011,69916,64394,5522,7.9,154131,140183,13948,9
Ouachita,10/1/2011,70470,65089,5381,7.6,153961,140368,13594,8.8
Ouachita,11/1/2011,70325,65248,5077,7.2,154128,140826,13302,8.6
Ouachita,12/1/2011,69748,64660,5088,7.3,153995,140902,13093,8.5
Ouachita,1/1/2012,69967,64295,5672,8.1,154381,141584,12797,8.3
Ouachita,2/1/2012,70129,64839,5290,7.5,154671,141858,12813,8.3
Ouachita,3/1/2012,70844,65623,5221,7.4,154749,142036,12713,8.2
Ouachita,4/1/2012,70690,65828,4862,6.9,154545,141899,12646,8.2
Ouachita,5/1/2012,71312,66093,5219,7.3,154866,142206,12660,8.2
Ouachita,6/1/2012,72081,65976,6105,8.5,155083,142391,12692,8.2
Ouachita,7/1/2012,71990,66151,5839,8.1,154948,142292,12656,8.2
Ouachita,8/1/2012,70536,65166,5370,7.6,154763,142291,12471,8.1
Ouachita,9/1/2012,70908,65941,4967,7,155160,143044,12115,7.8
Ouachita,10/1/2012,71887,67150,4737,6.6,155554,143431,12124,7.8
Ouachita,11/1/2012,71345,66997,4348,6.1,155338,143333,12005,7.7
Ouachita,12/1/2012,71400,66724,4676,6.5,155628,143330,12298,7.9
Ouachita,1/1/2013,70598,65030,5568,7.9,155763,143292,12471,8
Ouachita,2/1/2013,70470,65415,5055,7.2,155312,143362,11950,7.7
Ouachita,3/1/2013,70946,66007,4939,7,155005,143316,11689,7.5
Ouachita,4/1/2013,71342,66557,4785,6.7,155394,143635,11760,7.6
Ouachita,5/1/2013,71295,66223,5072,7.1,155536,143882,11654,7.5
Ouachita,6/1/2013,71954,66110,5844,8.1,155749,143999,11751,7.5
Ouachita,7/1/2013,71660,66378,5282,7.4,155599,144264,11335,7.3
Ouachita,8/1/2013,70540,65593,4947,7,155605,144326,11279,7.2
Ouachita,9/1/2013,70546,65831,4715,6.7,155687,144418,11270,7.2
Ouachita,10/1/2013,70821,66326,4495,6.3,154673,143537,11136,7.2
Ouachita,11/1/2013,71043,66927,4116,5.8,155265,144479,10787,6.9
Ouachita,12/1/2013,70515,66625,3890,5.5,155182,144778,10404,6.7
Ouachita,1/1/2014,70114,65745,4369,6.2,155352,145150,10202,6.6
Ouachita,2/1/2014,70298,66118,4180,5.9,155483,145134,10349,6.7
Ouachita,3/1/2014,71105,66820,4285,6,156028,145648,10380,6.7
Ouachita,4/1/2014,71249,67209,4040,5.7,155369,145667,9702,6.2
Ouachita,5/1/2014,71399,66720,4679,6.6,155684,145825,9859,6.3
Ouachita,6/1/2014,71983,66641,5342,7.4,155707,146247,9460,6.1
Ouachita,7/1/2014,72559,66980,5579,7.7,156007,146399,9608,6.2
Ouachita,8/1/2014,71750,66208,5542,7.7,156130,146530,9599,6.1
Ouachita,9/1/2014,71815,66500,5315,7.4,156040,146778,9262,5.9
Ouachita,10/1/2014,72480,67291,5189,7.2,156417,147427,8990,5.7
Ouachita,11/1/2014,72333,67121,5212,7.2,156494,147404,9090,5.8
Ouachita,12/1/2014,72052,67073,4979,6.9,156332,147615,8717,5.6
Ouachita,1/1/2015,71618,66202,5416,7.6,157030,148145,8885,5.7
Ouachita,2/1/2015,71538,66616,4922,6.9,156644,148045,8599,5.5
Ouachita,3/1/2015,72047,67214,4833,6.7,156643,148128,8515,5.4
Ouachita,4/1/2015,72544,67895,4649,6.4,157060,148511,8550,5.4
Ouachita,5/1/2015,72724,67732,4992,6.9,157651,148817,8834,5.6
Ouachita,6/1/2015,72860,67502,5358,7.4,157062,148816,8247,5.3
Ouachita,7/1/2015,72435,67381,5054,7,156997,148830,8167,5.2
Ouachita,8/1/2015,71391,66667,4724,6.6,157172,149181,7992,5.1
Ouachita,9/1/2015,71276,66736,4540,6.4,156733,148826,7907,5
Ouachita,10/1/2015,71775,67373,4402,6.1,157167,149246,7922,5
Ouachita,11/1/2015,71639,67572,4067,5.7,157463,149463,8000,5.1
Ouachita,12/1/2015,71070,67247,3823,5.4,158035,150128,7907,5
Ouachita,1/1/2016,71018,66522,4496,6.3,158280,150653,7627,4.8
Ouachita,2/1/2016,71529,67328,4201,5.9,158640,150939,7702,4.9
Ouachita,3/1/2016,72084,67848,4236,5.9,159179,151218,7961,5
Ouachita,4/1/2016,71916,67810,4106,5.7,159141,151074,8067,5.1
Ouachita,5/1/2016,71371,67159,4212,5.9,158784,151132,7652,4.8
Ouachita,6/1/2016,72348,67401,4947,6.8,158967,151223,7744,4.9
Ouachita,7/1/2016,72201,67450,4751,6.6,159194,151554,7641,4.8
Ouachita,8/1/2016,71136,66595,4541,6.4,159562,151779,7784,4.9
Ouachita,9/1/2016,71505,67075,4430,6.2,159714,151761,7953,5
Ouachita,10/1/2016,71344,67167,4177,5.9,159605,151793,7811,4.9
Ouachita,11/1/2016,71265,67298,3967,5.6,159506,151954,7553,4.7
Ouachita,12/1/2016,70679,66794,3885,5.5,159678,152157,7521,4.7
Ouachita,1/1/2017,69812,65442,4370,6.3,159620,152152,7468,4.7
Ouachita,2/1/2017,70214,66184,4030,5.7,159859,152480,7379,4.6
Ouachita,3/1/2017,70601,66785,3816,5.4,160137,153065,7073,4.4
Ouachita,4/1/2017,70752,67039,3713,5.2,160345,153255,7089,4.4
Ouachita,5/1/2017,70220,66526,3694,5.3,160068,153069,7000,4.4
Ouachita,6/1/2017,70915,66832,4083,5.8,160192,153318,6873,4.3
Ouachita,7/1/2017,70987,67059,3928,5.5,160462,153569,6892,4.3
Ouachita,8/1/2017,70283,66453,3830,5.4,160586,153503,7082,4.4
Ouachita,9/1/2017,70668,67066,3602,5.1,161140,154286,6854,4.3
Ouachita,10/1/2017,70358,67186,3172,4.5,160309,153609,6700,4.2
Ouachita,11/1/2017,70966,67793,3173,4.5,160579,153805,6774,4.2
Ouachita,12/1/2017,70717,67654,3063,4.3,160535,153904,6632,4.1
Ouachita,1/1/2018,70306,66828,3478,4.9,160914,154425,6489,4
Ouachita,2/1/2018,70587,67198,3389,4.8,161778,155197,6581,4.1
Ouachita,3/1/2018,71144,67659,3485,4.9,161686,155214,6472,4
Ouachita,4/1/2018,71331,67962,3369,4.7,161771,155312,6459,4
Ouachita,5/1/2018,71159,67658,3501,4.9,161848,155652,6196,3.8
Ouachita,6/1/2018,71737,67407,4330,6,162210,155762,6447,4
Ouachita,7/1/2018,71782,67707,4075,5.7,162341,156146,6195,3.8
Ouachita,8/1/2018,70200,66436,3764,5.4,161660,155504,6156,3.8
Ouachita,9/1/2018,70327,66767,3560,5.1,162087,156015,6073,3.7
Ouachita,10/1/2018,70395,66873,3522,5,162602,156391,6211,3.8
Ouachita,11/1/2018,70507,67154,3353,4.8,162836,156721,6115,3.8
Ouachita,12/1/2018,70338,66908,3430,4.9,163206,156817,6389,3.9
Ouachita,1/1/2019,69985,66056,3929,5.6,162963,156487,6475,4
Ouachita,2/1/2019,69866,66474,3392,4.9,162999,156863,6136,3.8
Ouachita,3/1/2019,70263,67078,3185,4.5,162904,156701,6202,3.8
Ouachita,4/1/2019,69975,67001,2974,4.3,162586,156625,5961,3.7
Ouachita,5/1/2019,70124,66762,3362,4.8,162751,156821,5930,3.6
Ouachita,6/1/2019,70537,66492,4045,5.7,163168,157232,5935,3.6
Ouachita,7/1/2019,70755,66783,3972,5.6,163590,157529,6061,3.7
Ouachita,8/1/2019,69411,65641,3770,5.4,163774,157829,5945,3.6
Ouachita,9/1/2019,69797,66220,3577,5.1,164092,158339,5753,3.5
Ouachita,10/1/2019,70208,66546,3662,5.2,164416,158545,5871,3.6
Ouachita,11/1/2019,70337,66746,3591,5.1,164496,158629,5868,3.6
Ouachita,12/1/2019,69662,66225,3437,4.9,164699,158845,5853,3.6
Ouachita,1/1/2020,68946,65260,3686,5.3,164377,158508,5869,3.6
Ouachita,2/1/2020,68599,65506,3093,4.5,164467,158714,5753,3.5
Ouachita,3/1/2020,70020,64773,5247,7.5,162559,155353,7206,4.4
Ouachita,4/1/2020,64828,57866,6962,10.7,156269,133185,23084,14.8
Ouachita,5/1/2020,67012,59878,7134,10.6,158101,137173,20929,13.2
Ouachita,6/1/2020,69273,62361,6912,10,159994,142342,17652,11
Ouachita,7/1/2020,70415,63746,6669,9.5,160132,143779,16352,10.2
Ouachita,8/1/2020,69628,64116,5512,7.9,160706,147245,13461,8.4
Ouachita,9/1/2020,69833,64318,5515,7.9,160174,147620,12554,7.8
Ouachita,10/1/2020,69757,64822,4935,7.1,161003,149931,11072,6.9
Ouachita,11/1/2020,69476,65121,4355,6.3,160629,149934,10694,6.7
Ouachita,12/1/2020,69299,64874,4425,6.4,160745,149975,10770,6.7
Ouachita,1/1/2021,68243,63708,4535,6.6,160088,149852,10236,6.4
Ouachita,2/1/2021,68411,64149,4262,6.2,160184,150189,9995,6.2
Ouachita,3/1/2021,69011,64958,4053,5.9,160400,150644,9756,6.1
Ouachita,4/1/2021,69027,65068,3959,5.7,160843,151081,9762,6.1
Ouachita,5/1/2021,69321,65385,3936,5.7,160800,151535,9266,5.8
Ouachita,6/1/2021,70117,65649,4468,6.4,161197,151734,9462,5.9
Ouachita,7/1/2021,70496,66565,3931,5.6,161504,152773,8731,5.4
Ouachita,8/1/2021,69052,65613,3439,5,161527,153250,8276,5.1
Ouachita,9/1/2021,70264,67235,3029,4.3,161495,153843,7652,4.7
Ouachita,10/1/2021,69242,66544,2698,3.9,161754,154475,7279,4.5
Ouachita,11/1/2021,69638,67178,2460,3.5,162281,155530,6751,4.2
Ouachita,12/1/2021,69505,67269,2236,3.2,162497,156099,6398,3.9
Ouachita,1/1/2022,69172,66370,2802,4.1,163627,157115,6512,4
Ouachita,2/1/2022,69217,66722,2495,3.6,163899,157598,6301,3.8
Ouachita,3/1/2022,69807,67374,2433,3.5,164220,158206,6014,3.7
Ouachita,4/1/2022,69389,67108,2281,3.3,163893,157891,6002,3.7
Ouachita,5/1/2022,69925,67406,2519,3.6,164362,158378,5983,3.6
Ouachita,6/1/2022,70807,67666,3141,4.4,164046,158094,5951,3.6
Ouachita,7/1/2022,70425,67516,2909,4.1,164026,158258,5768,3.5
Ouachita,8/1/2022,69717,66951,2766,4,164654,158735,5919,3.6
Ouachita,9/1/2022,69627,67126,2501,3.6,164602,158810,5792,3.5
Ouachita,10/1/2022,69448,67123,2325,3.3,164648,158684,5964,3.6
Ouachita,11/1/2022,69499,67246,2253,3.2,164450,158507,5943,3.6
Ouachita,12/1/2022,69391,67161,2230,3.2,165025,159259,5766,3.5
Ouachita,1/1/2023,69021,66372,2649,3.8,165964,160217,5747,3.5
Ouachita,2/1/2023,69204,66700,2504,3.6,166358,160395,5962,3.6
Ouachita,3/1/2023,70085,67654,2431,3.5,166651,160812,5839,3.5
Ouachita,4/1/2023,69606,67334,2272,3.3,166725,160974,5751,3.4
Ouachita,5/1/2023,69842,67187,2655,3.8,166886,160796,6089,3.6
Ouachita,6/1/2023,70393,67310,3083,4.4,166937,160979,5958,3.6
Ouachita,7/1/2023,70568,67928,2640,3.7,167103,161183,5920,3.5
Ouachita,8/1/2023,69648,66864,2784,4,167759,161475,6284,3.7
Ouachita,9/1/2023,69654,66886,2768,4,167767,161442,6326,3.8
Ouachita,10/1/2023,69708,66910,2798,4,167690,161211,6479,3.9
Ouachita,11/1/2023,69741,67035,2706,3.9,168140,161886,6254,3.7
Ouachita,12/1/2023,68974,66288,2686,3.9,167439,161124,6315,3.8
Ouachita,1/1/2024,68498,65417,3081,4.5,167339,161190,6149,3.7
Ouachita,2/1/2024,68803,65773,3030,4.4,167475,161013,6462,3.9
Ouachita,3/1/2024,69093,66150,2943,4.3,167922,161425,6497,3.9
Ouachita,4/1/2024,69027,66374,2653,3.8,167988,161495,6492,3.9
Ouachita,5/1/2024,68909,66107,2802,4.1,167799,161164,6635,4
Ouachita,6/1/2024,69477,65959,3518,5.1,168005,161155,6849,4.1
Ouachita,7/1/2024,70037,66623,3414,4.9,168315,161219,7097,4.2
Ouachita,8/1/2024,69004,65521,3483,5,168496,161425,7071,4.2
Ouachita,9/1/2024,68674,65410,3264,4.8,168703,161802,6901,4.1
Ouachita,10/1/2024,68928,65589,3339,4.8,168428,161456,6972,4.1
Ouachita,11/1/2024,69059,65725,3334,4.8,168304,161183,7121,4.2
Ouachita,12/1/2024,68497,65474,3023,4.4,168547,161661,6886,4.1
Ouachita,1/1/2025,68939,65646,3293,4.8,170744,163895,6849,4
Ouachita,2/1/2025,69197,66042,3155,4.6,170359,163307,7052,4.1
Plaquemines,1/1/1990,10013,9234,779,7.8,125833,119081,6752,5.4
Plaquemines,2/1/1990,9987,9311,676,6.8,125710,119059,6651,5.3
Plaquemines,3/1/1990,9961,9389,572,5.7,125801,119203,6598,5.2
Plaquemines,4/1/1990,10023,9455,568,5.7,125649,118852,6797,5.4
Plaquemines,5/1/1990,10065,9527,538,5.3,125893,119151,6742,5.4
Plaquemines,6/1/1990,10307,9631,676,6.6,125573,118983,6590,5.2
Plaquemines,7/1/1990,10170,9568,602,5.9,125732,118810,6922,5.5
Plaquemines,8/1/1990,9994,9409,585,5.9,125990,118802,7188,5.7
Plaquemines,9/1/1990,9881,9337,544,5.5,125892,118524,7368,5.9
Plaquemines,10/1/1990,10005,9489,516,5.2,125995,118536,7459,5.9
Plaquemines,11/1/1990,10231,9460,771,7.5,126070,118306,7764,6.2
Plaquemines,12/1/1990,10131,9420,711,7,126142,118241,7901,6.3
Plaquemines,1/1/1991,10271,9345,926,9,125955,117940,8015,6.4
Plaquemines,2/1/1991,10217,9402,815,8,126020,117755,8265,6.6
Plaquemines,3/1/1991,10189,9443,746,7.3,126238,117652,8586,6.8
Plaquemines,4/1/1991,10261,9583,678,6.6,126548,118109,8439,6.7
Plaquemines,5/1/1991,10277,9558,719,7,126176,117440,8736,6.9
Plaquemines,6/1/1991,10489,9707,782,7.5,126331,117639,8692,6.9
Plaquemines,7/1/1991,10291,9652,639,6.2,126154,117568,8586,6.8
Plaquemines,8/1/1991,10041,9465,576,5.7,126150,117484,8666,6.9
Plaquemines,9/1/1991,10063,9471,592,5.9,126650,117928,8722,6.9
Plaquemines,10/1/1991,10192,9609,583,5.7,126642,117800,8842,7
Plaquemines,11/1/1991,10379,9603,776,7.5,126701,117770,8931,7
Plaquemines,12/1/1991,10346,9537,809,7.8,126664,117466,9198,7.3
Plaquemines,1/1/1992,10505,9555,950,9,127261,117978,9283,7.3
Plaquemines,2/1/1992,10755,9597,1158,10.8,127207,117753,9454,7.4
Plaquemines,3/1/1992,10782,9661,1121,10.4,127604,118144,9460,7.4
Plaquemines,4/1/1992,10858,9762,1096,10.1,127841,118426,9415,7.4
Plaquemines,5/1/1992,10848,9774,1074,9.9,128119,118375,9744,7.6
Plaquemines,6/1/1992,11099,9898,1201,10.8,128459,118419,10040,7.8
Plaquemines,7/1/1992,10268,9147,1121,10.9,128563,118713,9850,7.7
Plaquemines,8/1/1992,9971,8957,1014,10.2,128613,118826,9787,7.6
Plaquemines,9/1/1992,9894,8901,993,10,128501,118720,9781,7.6
Plaquemines,10/1/1992,10154,9012,1142,11.2,128026,118628,9398,7.3
Plaquemines,11/1/1992,10275,9031,1244,12.1,128441,118876,9565,7.4
Plaquemines,12/1/1992,10552,9293,1259,11.9,128554,118997,9557,7.4
Plaquemines,1/1/1993,10394,9062,1332,12.8,128400,119075,9325,7.3
Plaquemines,2/1/1993,10281,9156,1125,10.9,128458,119275,9183,7.1
Plaquemines,3/1/1993,10259,9204,1055,10.3,128598,119542,9056,7
Plaquemines,4/1/1993,10181,9278,903,8.9,128584,119474,9110,7.1
Plaquemines,5/1/1993,10416,9363,1053,10.1,129264,120115,9149,7.1
Plaquemines,6/1/1993,10674,9452,1222,11.4,129411,120290,9121,7
Plaquemines,7/1/1993,10371,9340,1031,9.9,129397,120467,8930,6.9
Plaquemines,8/1/1993,10116,9189,927,9.2,129619,120856,8763,6.8
Plaquemines,9/1/1993,10044,9154,890,8.9,129268,120554,8714,6.7
Plaquemines,10/1/1993,10126,9319,807,8,129573,120823,8750,6.8
Plaquemines,11/1/1993,10264,9370,894,8.7,129711,121169,8542,6.6
Plaquemines,12/1/1993,10145,9344,801,7.9,129941,121464,8477,6.5
Plaquemines,1/1/1994,10294,9270,1024,9.9,130596,121966,8630,6.6
Plaquemines,2/1/1994,10438,9369,1069,10.2,130669,122086,8583,6.6
Plaquemines,3/1/1994,10481,9408,1073,10.2,130400,121930,8470,6.5
Plaquemines,4/1/1994,10666,9475,1191,11.2,130621,122290,8331,6.4
Plaquemines,5/1/1994,10723,9545,1178,11,130779,122864,7915,6.1
Plaquemines,6/1/1994,10808,9600,1208,11.2,130561,122634,7927,6.1
Plaquemines,7/1/1994,10659,9523,1136,10.7,130652,122706,7946,6.1
Plaquemines,8/1/1994,10353,9397,956,9.2,131275,123342,7933,6
Plaquemines,9/1/1994,10331,9415,916,8.9,131421,123687,7734,5.9
Plaquemines,10/1/1994,10327,9536,791,7.7,131744,124112,7632,5.8
Plaquemines,11/1/1994,10485,9600,885,8.4,131891,124516,7375,5.6
Plaquemines,12/1/1994,10423,9533,890,8.5,131951,124721,7230,5.5
Plaquemines,1/1/1995,10626,9518,1108,10.4,132038,124663,7375,5.6
Plaquemines,2/1/1995,10672,9598,1074,10.1,132115,124928,7187,5.4
Plaquemines,3/1/1995,10674,9679,995,9.3,132108,124955,7153,5.4
Plaquemines,4/1/1995,10634,9727,907,8.5,132590,124945,7645,5.8
Plaquemines,5/1/1995,10572,9750,822,7.8,131851,124421,7430,5.6
Plaquemines,6/1/1995,10733,9812,921,8.6,131949,124522,7427,5.6
Plaquemines,7/1/1995,10624,9752,872,8.2,132343,124816,7527,5.7
Plaquemines,8/1/1995,10278,9573,705,6.9,132336,124852,7484,5.7
Plaquemines,9/1/1995,10329,9599,730,7.1,132611,125133,7478,5.6
Plaquemines,10/1/1995,10315,9684,631,6.1,132716,125388,7328,5.5
Plaquemines,11/1/1995,10512,9721,791,7.5,132614,125188,7426,5.6
Plaquemines,12/1/1995,10316,9643,673,6.5,132511,125088,7423,5.6
Plaquemines,1/1/1996,10461,9623,838,8,132616,125125,7491,5.6
Plaquemines,2/1/1996,10496,9738,758,7.2,132952,125639,7313,5.5
Plaquemines,3/1/1996,10545,9846,699,6.6,133180,125862,7318,5.5
Plaquemines,4/1/1996,10569,9903,666,6.3,133409,125994,7415,5.6
Plaquemines,5/1/1996,10627,9969,658,6.2,133667,126244,7423,5.6
Plaquemines,6/1/1996,10701,10050,651,6.1,133697,126602,7095,5.3
Plaquemines,7/1/1996,10662,9985,677,6.3,134284,126947,7337,5.5
Plaquemines,8/1/1996,10368,9824,544,5.2,134054,127172,6882,5.1
Plaquemines,9/1/1996,10414,9895,519,5,134515,127536,6979,5.2
Plaquemines,10/1/1996,10458,9976,482,4.6,134921,127890,7031,5.2
Plaquemines,11/1/1996,10709,10025,684,6.4,135007,127771,7236,5.4
Plaquemines,12/1/1996,10697,9988,709,6.6,135113,127860,7253,5.4
Plaquemines,1/1/1997,10834,10056,778,7.2,135456,128298,7158,5.3
Plaquemines,2/1/1997,10818,10108,710,6.6,135400,128298,7102,5.2
Plaquemines,3/1/1997,10984,10250,734,6.7,135891,128891,7000,5.2
Plaquemines,4/1/1997,10923,10316,607,5.6,136016,129143,6873,5.1
Plaquemines,5/1/1997,10912,10368,544,5,136119,129464,6655,4.9
Plaquemines,6/1/1997,11038,10393,645,5.8,136211,129412,6799,5
Plaquemines,7/1/1997,10921,10356,565,5.2,136477,129822,6655,4.9
Plaquemines,8/1/1997,10688,10175,513,4.8,136618,130010,6608,4.8
Plaquemines,9/1/1997,10636,10196,440,4.1,136675,130019,6656,4.9
Plaquemines,10/1/1997,10692,10290,402,3.8,136633,130179,6454,4.7
Plaquemines,11/1/1997,10891,10392,499,4.6,136961,130653,6308,4.6
Plaquemines,12/1/1997,10913,10367,546,5,137155,130679,6476,4.7
Plaquemines,1/1/1998,10910,10293,617,5.7,137095,130726,6368,4.6
Plaquemines,2/1/1998,11028,10377,651,5.9,137112,130807,6306,4.6
Plaquemines,3/1/1998,11116,10481,635,5.7,137236,130814,6422,4.7
Plaquemines,4/1/1998,11110,10575,535,4.8,137150,131209,5941,4.3
Plaquemines,5/1/1998,11176,10636,540,4.8,137372,131325,6047,4.4
Plaquemines,6/1/1998,11351,10627,724,6.4,137455,131244,6212,4.5
Plaquemines,7/1/1998,11217,10534,683,6.1,137588,131329,6259,4.5
Plaquemines,8/1/1998,10893,10325,568,5.2,137570,131390,6179,4.5
Plaquemines,9/1/1998,10960,10389,571,5.2,138286,131986,6300,4.6
Plaquemines,10/1/1998,10934,10425,509,4.7,138279,131999,6280,4.5
Plaquemines,11/1/1998,11106,10492,614,5.5,138381,132280,6100,4.4
Plaquemines,12/1/1998,11040,10469,571,5.2,138634,132602,6032,4.4
Plaquemines,1/1/1999,11048,10364,684,6.2,139003,133027,5976,4.3
Plaquemines,2/1/1999,11148,10422,726,6.5,138967,132856,6111,4.4
Plaquemines,3/1/1999,11157,10518,639,5.7,138730,132947,5783,4.2
Plaquemines,4/1/1999,11139,10537,602,5.4,138959,132955,6004,4.3
Plaquemines,5/1/1999,11101,10580,521,4.7,139107,133311,5796,4.2
Plaquemines,6/1/1999,11268,10598,670,5.9,139329,133378,5951,4.3
Plaquemines,7/1/1999,11163,10503,660,5.9,139439,133414,6025,4.3
Plaquemines,8/1/1999,10841,10294,547,5,139430,133591,5838,4.2
Plaquemines,9/1/1999,10841,10323,518,4.8,139622,133707,5915,4.2
Plaquemines,10/1/1999,10946,10401,545,5,139771,133993,5778,4.1
Plaquemines,11/1/1999,11312,10503,809,7.2,140025,134309,5716,4.1
Plaquemines,12/1/1999,11130,10441,689,6.2,140177,134523,5653,4
Plaquemines,1/1/2000,10982,10285,697,6.3,142267,136559,5708,4
Plaquemines,2/1/2000,11036,10363,673,6.1,142456,136598,5858,4.1
Plaquemines,3/1/2000,11139,10454,685,6.1,142434,136701,5733,4
Plaquemines,4/1/2000,11061,10515,546,4.9,142751,137270,5481,3.8
Plaquemines,5/1/2000,11066,10499,567,5.1,142388,136630,5758,4
Plaquemines,6/1/2000,11208,10500,708,6.3,142591,136940,5651,4
Plaquemines,7/1/2000,11065,10398,667,6,142278,136531,5747,4
Plaquemines,8/1/2000,10760,10170,590,5.5,142514,136662,5853,4.1
Plaquemines,9/1/2000,10720,10204,516,4.8,142518,136893,5625,3.9
Plaquemines,10/1/2000,10787,10248,539,5,142622,137088,5534,3.9
Plaquemines,11/1/2000,10990,10328,662,6,142962,137322,5639,3.9
Plaquemines,12/1/2000,10912,10325,587,5.4,143248,137614,5634,3.9
Plaquemines,1/1/2001,11077,10378,699,6.3,143800,137778,6023,4.2
Plaquemines,2/1/2001,11049,10435,614,5.6,143701,137612,6089,4.2
Plaquemines,3/1/2001,11135,10545,590,5.3,143924,137783,6141,4.3
Plaquemines,4/1/2001,11042,10520,522,4.7,143569,137299,6271,4.4
Plaquemines,5/1/2001,11058,10537,521,4.7,143318,137092,6226,4.3
Plaquemines,6/1/2001,11214,10537,677,6,143357,136873,6484,4.5
Plaquemines,7/1/2001,11113,10490,623,5.6,143654,137071,6583,4.6
Plaquemines,8/1/2001,10731,10192,539,5,143284,136241,7042,4.9
Plaquemines,9/1/2001,10822,10291,531,4.9,143989,136846,7142,5
Plaquemines,10/1/2001,10831,10275,556,5.1,144086,136392,7694,5.3
Plaquemines,11/1/2001,11029,10349,680,6.2,144240,136238,8003,5.5
Plaquemines,12/1/2001,10952,10274,678,6.2,144305,136047,8258,5.7
Plaquemines,1/1/2002,10930,10154,776,7.1,143883,135701,8182,5.7
Plaquemines,2/1/2002,10975,10282,693,6.3,144653,136438,8215,5.7
Plaquemines,3/1/2002,10988,10362,626,5.7,144481,136177,8304,5.7
Plaquemines,4/1/2002,11017,10385,632,5.7,144725,136126,8599,5.9
Plaquemines,5/1/2002,11061,10418,643,5.8,144938,136539,8399,5.8
Plaquemines,6/1/2002,11206,10433,773,6.9,144808,136415,8393,5.8
Plaquemines,7/1/2002,11084,10386,698,6.3,144803,136413,8390,5.8
Plaquemines,8/1/2002,10798,10164,634,5.9,145009,136705,8304,5.7
Plaquemines,9/1/2002,10863,10278,585,5.4,145552,137302,8251,5.7
Plaquemines,10/1/2002,10864,10253,611,5.6,145314,137008,8307,5.7
Plaquemines,11/1/2002,11011,10324,687,6.2,145041,136521,8520,5.9
Plaquemines,12/1/2002,10920,10250,670,6.1,145066,136426,8640,6
Plaquemines,1/1/2003,11090,10378,712,6.4,145937,137417,8520,5.8
Plaquemines,2/1/2003,11172,10486,686,6.1,146100,137482,8618,5.9
Plaquemines,3/1/2003,11214,10578,636,5.7,146022,137434,8588,5.9
Plaquemines,4/1/2003,11200,10609,591,5.3,146474,137633,8842,6
Plaquemines,5/1/2003,11281,10621,660,5.9,146500,137544,8957,6.1
Plaquemines,6/1/2003,11433,10640,793,6.9,147056,137790,9266,6.3
Plaquemines,7/1/2003,11291,10561,730,6.5,146485,137474,9011,6.2
Plaquemines,8/1/2003,10930,10312,618,5.7,146445,137549,8896,6.1
Plaquemines,9/1/2003,10955,10398,557,5.1,146530,137609,8921,6.1
Plaquemines,10/1/2003,10980,10436,544,5,146716,137984,8732,6
Plaquemines,11/1/2003,11214,10567,647,5.8,147000,138424,8576,5.8
Plaquemines,12/1/2003,11125,10500,625,5.6,146729,138411,8317,5.7
Plaquemines,1/1/2004,11401,10711,690,6.1,146842,138472,8370,5.7
Plaquemines,2/1/2004,11477,10824,653,5.7,146709,138542,8167,5.6
Plaquemines,3/1/2004,11533,10929,604,5.2,146944,138453,8491,5.8
Plaquemines,4/1/2004,11484,10975,509,4.4,146850,138680,8170,5.6
Plaquemines,5/1/2004,11581,11004,577,5,147065,138852,8212,5.6
Plaquemines,6/1/2004,11766,11047,719,6.1,147460,139174,8286,5.6
Plaquemines,7/1/2004,11723,11040,683,5.8,147692,139556,8136,5.5
Plaquemines,8/1/2004,11378,10806,572,5,147564,139573,7990,5.4
Plaquemines,9/1/2004,11390,10859,531,4.7,147415,139487,7927,5.4
Plaquemines,10/1/2004,11458,10893,565,4.9,147793,139732,8061,5.5
Plaquemines,11/1/2004,11686,11052,634,5.4,148162,140231,7932,5.4
Plaquemines,12/1/2004,11573,10985,588,5.1,148059,140125,7934,5.4
Plaquemines,1/1/2005,11465,10819,646,5.6,148029,140245,7784,5.3
Plaquemines,2/1/2005,11519,10907,612,5.3,148364,140385,7980,5.4
Plaquemines,3/1/2005,11588,11036,552,4.8,148391,140654,7737,5.2
Plaquemines,4/1/2005,11631,11131,500,4.3,148926,141254,7672,5.2
Plaquemines,5/1/2005,11746,11174,572,4.9,149261,141609,7651,5.1
Plaquemines,6/1/2005,11910,11210,700,5.9,149238,141714,7524,5
Plaquemines,7/1/2005,11883,11183,700,5.9,149432,142026,7406,5
Plaquemines,8/1/2005,11550,10933,617,5.3,149779,142434,7345,4.9
Plaquemines,7/1/2006,9261,8868,393,4.2,151377,144202,7175,4.7
Plaquemines,8/1/2006,9172,8810,362,3.9,151716,144625,7091,4.7
Plaquemines,9/1/2006,9146,8788,358,3.9,151662,144815,6847,4.5
Plaquemines,10/1/2006,9336,8991,345,3.7,152041,145314,6727,4.4
Plaquemines,11/1/2006,9446,9075,371,3.9,152406,145534,6872,4.5
Plaquemines,12/1/2006,9442,9103,339,3.6,152732,145970,6762,4.4
Plaquemines,1/1/2007,8979,8586,393,4.4,153144,146028,7116,4.6
Plaquemines,2/1/2007,8964,8638,326,3.6,152983,146057,6927,4.5
Plaquemines,3/1/2007,9088,8753,335,3.7,153051,146320,6731,4.4
Plaquemines,4/1/2007,8962,8644,318,3.5,152435,145586,6850,4.5
Plaquemines,5/1/2007,8988,8622,366,4.1,152670,145903,6766,4.4
Plaquemines,6/1/2007,9130,8713,417,4.6,153041,146063,6979,4.6
Plaquemines,7/1/2007,9082,8725,357,3.9,153054,145905,7149,4.7
Plaquemines,8/1/2007,8947,8623,324,3.6,152749,145682,7067,4.6
Plaquemines,9/1/2007,8921,8598,323,3.6,153414,146244,7170,4.7
Plaquemines,10/1/2007,9115,8819,296,3.2,153183,145946,7237,4.7
Plaquemines,11/1/2007,9209,8895,314,3.4,153835,146595,7240,4.7
Plaquemines,12/1/2007,9189,8878,311,3.4,153918,146273,7645,5
Plaquemines,1/1/2008,8283,7915,368,4.4,154063,146378,7685,5
Plaquemines,2/1/2008,8234,7940,294,3.6,153653,146156,7497,4.9
Plaquemines,3/1/2008,8349,8017,332,4,153908,146086,7822,5.1
Plaquemines,4/1/2008,8415,8125,290,3.4,153769,146132,7637,5
Plaquemines,5/1/2008,8406,8066,340,4,154303,145908,8395,5.4
Plaquemines,6/1/2008,8546,8139,407,4.8,154313,145737,8575,5.6
Plaquemines,7/1/2008,8514,8137,377,4.4,154469,145532,8937,5.8
Plaquemines,8/1/2008,8496,8097,399,4.7,154641,145203,9438,6.1
Plaquemines,9/1/2008,8537,8080,457,5.4,154570,145076,9494,6.1
Plaquemines,10/1/2008,8560,8136,424,5,154876,144802,10074,6.5
Plaquemines,11/1/2008,8519,8099,420,4.9,154639,144100,10538,6.8
Plaquemines,12/1/2008,8512,8085,427,5,154655,143369,11286,7.3
Plaquemines,1/1/2009,7927,7462,465,5.9,154210,142152,12058,7.8
Plaquemines,2/1/2009,7928,7491,437,5.5,154538,141640,12898,8.3
Plaquemines,3/1/2009,7990,7495,495,6.2,154133,140707,13426,8.7
Plaquemines,4/1/2009,8030,7564,466,5.8,154509,140656,13853,9
Plaquemines,5/1/2009,8039,7522,517,6.4,154747,140248,14499,9.4
Plaquemines,6/1/2009,8157,7531,626,7.7,154716,140009,14707,9.5
Plaquemines,7/1/2009,8131,7586,545,6.7,154502,139901,14601,9.5
Plaquemines,8/1/2009,8104,7558,546,6.7,154307,139492,14814,9.6
Plaquemines,9/1/2009,7999,7489,510,6.4,153827,138818,15009,9.8
Plaquemines,10/1/2009,8059,7534,525,6.5,153784,138432,15352,10
Plaquemines,11/1/2009,8079,7565,514,6.4,153878,138659,15219,9.9
Plaquemines,12/1/2009,7981,7490,491,6.2,153111,138013,15098,9.9
Plaquemines,1/1/2010,9803,9191,612,6.2,153484,138438,15046,9.8
Plaquemines,2/1/2010,9878,9370,508,5.1,153694,138581,15113,9.8
Plaquemines,3/1/2010,9987,9458,529,5.3,153954,138751,15202,9.9
Plaquemines,4/1/2010,10158,9636,522,5.1,154622,139297,15325,9.9
Plaquemines,5/1/2010,10075,9528,547,5.4,154091,139241,14849,9.6
Plaquemines,6/1/2010,10178,9570,608,6,153616,139141,14474,9.4
Plaquemines,7/1/2010,10215,9655,560,5.5,153691,139179,14512,9.4
Plaquemines,8/1/2010,10150,9557,593,5.8,154086,139438,14648,9.5
Plaquemines,9/1/2010,10060,9501,559,5.6,153975,139396,14579,9.5
Plaquemines,10/1/2010,10123,9536,587,5.8,153635,139119,14516,9.4
Plaquemines,11/1/2010,10089,9484,605,6,154125,139044,15081,9.8
Plaquemines,12/1/2010,9991,9408,583,5.8,153650,139301,14348,9.3
Plaquemines,1/1/2011,10009,9328,681,6.8,153263,139250,14013,9.1
Plaquemines,2/1/2011,10011,9420,591,5.9,153214,139394,13820,9
Plaquemines,3/1/2011,10021,9450,571,5.7,153376,139639,13737,9
Plaquemines,4/1/2011,10128,9564,564,5.6,153543,139586,13957,9.1
Plaquemines,5/1/2011,10163,9561,602,5.9,153479,139624,13855,9
Plaquemines,6/1/2011,10196,9524,672,6.6,153346,139384,13962,9.1
Plaquemines,7/1/2011,10283,9646,637,6.2,153288,139524,13763,9
Plaquemines,8/1/2011,10219,9609,610,6,153760,139942,13818,9
Plaquemines,9/1/2011,10141,9544,597,5.9,154131,140183,13948,9
Plaquemines,10/1/2011,10191,9603,588,5.8,153961,140368,13594,8.8
Plaquemines,11/1/2011,10252,9676,576,5.6,154128,140826,13302,8.6
Plaquemines,12/1/2011,10166,9626,540,5.3,153995,140902,13093,8.5
Plaquemines,1/1/2012,9981,9350,631,6.3,154381,141584,12797,8.3
Plaquemines,2/1/2012,10044,9467,577,5.7,154671,141858,12813,8.3
Plaquemines,3/1/2012,10040,9470,570,5.7,154749,142036,12713,8.2
Plaquemines,4/1/2012,10174,9639,535,5.3,154545,141899,12646,8.2
Plaquemines,5/1/2012,10276,9683,593,5.8,154866,142206,12660,8.2
Plaquemines,6/1/2012,10320,9639,681,6.6,155083,142391,12692,8.2
Plaquemines,7/1/2012,10434,9812,622,6,154948,142292,12656,8.2
Plaquemines,8/1/2012,10226,9644,582,5.7,154763,142291,12471,8.1
Plaquemines,9/1/2012,10110,9541,569,5.6,155160,143044,12115,7.8
Plaquemines,10/1/2012,10229,9708,521,5.1,155554,143431,12124,7.8
Plaquemines,11/1/2012,10213,9741,472,4.6,155338,143333,12005,7.7
Plaquemines,12/1/2012,10252,9722,530,5.2,155628,143330,12298,7.9
Plaquemines,1/1/2013,10036,9399,637,6.3,155763,143292,12471,8
Plaquemines,2/1/2013,9996,9451,545,5.5,155312,143362,11950,7.7
Plaquemines,3/1/2013,9887,9352,535,5.4,155005,143316,11689,7.5
Plaquemines,4/1/2013,9981,9435,546,5.5,155394,143635,11760,7.6
Plaquemines,5/1/2013,10084,9491,593,5.9,155536,143882,11654,7.5
Plaquemines,6/1/2013,10181,9534,647,6.4,155749,143999,11751,7.5
Plaquemines,7/1/2013,10236,9651,585,5.7,155599,144264,11335,7.3
Plaquemines,8/1/2013,10172,9620,552,5.4,155605,144326,11279,7.2
Plaquemines,9/1/2013,10037,9528,509,5.1,155687,144418,11270,7.2
Plaquemines,10/1/2013,10030,9528,502,5,154673,143537,11136,7.2
Plaquemines,11/1/2013,10078,9608,470,4.7,155265,144479,10787,6.9
Plaquemines,12/1/2013,10065,9625,440,4.4,155182,144778,10404,6.7
Plaquemines,1/1/2014,9889,9394,495,5,155352,145150,10202,6.6
Plaquemines,2/1/2014,9979,9505,474,4.7,155483,145134,10349,6.7
Plaquemines,3/1/2014,10014,9517,497,5,156028,145648,10380,6.7
Plaquemines,4/1/2014,9988,9530,458,4.6,155369,145667,9702,6.2
Plaquemines,5/1/2014,10024,9499,525,5.2,155684,145825,9859,6.3
Plaquemines,6/1/2014,10263,9654,609,5.9,155707,146247,9460,6.1
Plaquemines,7/1/2014,10424,9780,644,6.2,156007,146399,9608,6.2
Plaquemines,8/1/2014,10353,9700,653,6.3,156130,146530,9599,6.1
Plaquemines,9/1/2014,10274,9655,619,6,156040,146778,9262,5.9
Plaquemines,10/1/2014,10306,9675,631,6.1,156417,147427,8990,5.7
Plaquemines,11/1/2014,10388,9749,639,6.2,156494,147404,9090,5.8
Plaquemines,12/1/2014,10322,9752,570,5.5,156332,147615,8717,5.6
Plaquemines,1/1/2015,10257,9587,670,6.5,157030,148145,8885,5.7
Plaquemines,2/1/2015,10252,9654,598,5.8,156644,148045,8599,5.5
Plaquemines,3/1/2015,10285,9688,597,5.8,156643,148128,8515,5.4
Plaquemines,4/1/2015,10346,9771,575,5.6,157060,148511,8550,5.4
Plaquemines,5/1/2015,10349,9768,581,5.6,157651,148817,8834,5.6
Plaquemines,6/1/2015,10439,9833,606,5.8,157062,148816,8247,5.3
Plaquemines,7/1/2015,10441,9852,589,5.6,156997,148830,8167,5.2
Plaquemines,8/1/2015,10292,9722,570,5.5,157172,149181,7992,5.1
Plaquemines,9/1/2015,10109,9568,541,5.4,156733,148826,7907,5
Plaquemines,10/1/2015,10148,9618,530,5.2,157167,149246,7922,5
Plaquemines,11/1/2015,10188,9682,506,5,157463,149463,8000,5.1
Plaquemines,12/1/2015,10203,9735,468,4.6,158035,150128,7907,5
Plaquemines,1/1/2016,10146,9580,566,5.6,158280,150653,7627,4.8
Plaquemines,2/1/2016,10121,9607,514,5.1,158640,150939,7702,4.9
Plaquemines,3/1/2016,10198,9645,553,5.4,159179,151218,7961,5
Plaquemines,4/1/2016,10226,9710,516,5,159141,151074,8067,5.1
Plaquemines,5/1/2016,10266,9762,504,4.9,158784,151132,7652,4.8
Plaquemines,6/1/2016,10367,9781,586,5.7,158967,151223,7744,4.9
Plaquemines,7/1/2016,10352,9774,578,5.6,159194,151554,7641,4.8
Plaquemines,8/1/2016,10221,9653,568,5.6,159562,151779,7784,4.9
Plaquemines,9/1/2016,10152,9565,587,5.8,159714,151761,7953,5
Plaquemines,10/1/2016,10054,9512,542,5.4,159605,151793,7811,4.9
Plaquemines,11/1/2016,10103,9596,507,5,159506,151954,7553,4.7
Plaquemines,12/1/2016,9982,9498,484,4.8,159678,152157,7521,4.7
Plaquemines,1/1/2017,9925,9376,549,5.5,159620,152152,7468,4.7
Plaquemines,2/1/2017,9972,9475,497,5,159859,152480,7379,4.6
Plaquemines,3/1/2017,9976,9513,463,4.6,160137,153065,7073,4.4
Plaquemines,4/1/2017,10041,9589,452,4.5,160345,153255,7089,4.4
Plaquemines,5/1/2017,10088,9644,444,4.4,160068,153069,7000,4.4
Plaquemines,6/1/2017,10217,9711,506,5,160192,153318,6873,4.3
Plaquemines,7/1/2017,10154,9651,503,5,160462,153569,6892,4.3
Plaquemines,8/1/2017,9990,9495,495,5,160586,153503,7082,4.4
Plaquemines,9/1/2017,9933,9479,454,4.6,161140,154286,6854,4.3
Plaquemines,10/1/2017,9887,9480,407,4.1,160309,153609,6700,4.2
Plaquemines,11/1/2017,9915,9505,410,4.1,160579,153805,6774,4.2
Plaquemines,12/1/2017,9891,9488,403,4.1,160535,153904,6632,4.1
Plaquemines,1/1/2018,9979,9515,464,4.6,160914,154425,6489,4
Plaquemines,2/1/2018,10008,9578,430,4.3,161778,155197,6581,4.1
Plaquemines,3/1/2018,10087,9636,451,4.5,161686,155214,6472,4
Plaquemines,4/1/2018,10135,9683,452,4.5,161771,155312,6459,4
Plaquemines,5/1/2018,10135,9677,458,4.5,161848,155652,6196,3.8
Plaquemines,6/1/2018,10238,9649,589,5.8,162210,155762,6447,4
Plaquemines,7/1/2018,10192,9646,546,5.4,162341,156146,6195,3.8
Plaquemines,8/1/2018,9977,9494,483,4.8,161660,155504,6156,3.8
Plaquemines,9/1/2018,9940,9480,460,4.6,162087,156015,6073,3.7
Plaquemines,10/1/2018,10019,9595,424,4.2,162602,156391,6211,3.8
Plaquemines,11/1/2018,9977,9584,393,3.9,162836,156721,6115,3.8
Plaquemines,12/1/2018,9892,9515,377,3.8,163206,156817,6389,3.9
Plaquemines,1/1/2019,9850,9396,454,4.6,162963,156487,6475,4
Plaquemines,2/1/2019,9938,9553,385,3.9,162999,156863,6136,3.8
Plaquemines,3/1/2019,9898,9533,365,3.7,162904,156701,6202,3.8
Plaquemines,4/1/2019,9926,9585,341,3.4,162586,156625,5961,3.7
Plaquemines,5/1/2019,9969,9584,385,3.9,162751,156821,5930,3.6
Plaquemines,6/1/2019,10070,9585,485,4.8,163168,157232,5935,3.6
Plaquemines,7/1/2019,10039,9561,478,4.8,163590,157529,6061,3.7
Plaquemines,8/1/2019,10048,9592,456,4.5,163774,157829,5945,3.6
Plaquemines,9/1/2019,10072,9639,433,4.3,164092,158339,5753,3.5
Plaquemines,10/1/2019,10073,9647,426,4.2,164416,158545,5871,3.6
Plaquemines,11/1/2019,10032,9620,412,4.1,164496,158629,5868,3.6
Plaquemines,12/1/2019,9938,9556,382,3.8,164699,158845,5853,3.6
Plaquemines,1/1/2020,9886,9457,429,4.3,164377,158508,5869,3.6
Plaquemines,2/1/2020,9880,9554,326,3.3,164467,158714,5753,3.5
Plaquemines,3/1/2020,9917,9345,572,5.8,162559,155353,7206,4.4
Plaquemines,4/1/2020,9046,7818,1228,13.6,156269,133185,23084,14.8
Plaquemines,5/1/2020,9123,8033,1090,11.9,158101,137173,20929,13.2
Plaquemines,6/1/2020,9350,8382,968,10.4,159994,142342,17652,11
Plaquemines,7/1/2020,9296,8432,864,9.3,160132,143779,16352,10.2
Plaquemines,8/1/2020,9356,8674,682,7.3,160706,147245,13461,8.4
Plaquemines,9/1/2020,9399,8726,673,7.2,160174,147620,12554,7.8
Plaquemines,10/1/2020,9530,8960,570,6,161003,149931,11072,6.9
Plaquemines,11/1/2020,9415,8917,498,5.3,160629,149934,10694,6.7
Plaquemines,12/1/2020,9408,8908,500,5.3,160745,149975,10770,6.7
Plaquemines,1/1/2021,9336,8806,530,5.7,160088,149852,10236,6.4
Plaquemines,2/1/2021,9414,8924,490,5.2,160184,150189,9995,6.2
Plaquemines,3/1/2021,9431,8957,474,5,160400,150644,9756,6.1
Plaquemines,4/1/2021,9560,9095,465,4.9,160843,151081,9762,6.1
Plaquemines,5/1/2021,9496,9055,441,4.6,160800,151535,9266,5.8
Plaquemines,6/1/2021,9621,9104,517,5.4,161197,151734,9462,5.9
Plaquemines,7/1/2021,9611,9165,446,4.6,161504,152773,8731,5.4
Plaquemines,8/1/2021,9535,9138,397,4.2,161527,153250,8276,5.1
Plaquemines,9/1/2021,9328,8877,451,4.8,161495,153843,7652,4.7
Plaquemines,10/1/2021,9463,9107,356,3.8,161754,154475,7279,4.5
Plaquemines,11/1/2021,9502,9194,308,3.2,162281,155530,6751,4.2
Plaquemines,12/1/2021,9526,9256,270,2.8,162497,156099,6398,3.9
Plaquemines,1/1/2022,9541,9206,335,3.5,163627,157115,6512,4
Plaquemines,2/1/2022,9636,9328,308,3.2,163899,157598,6301,3.8
Plaquemines,3/1/2022,9669,9367,302,3.1,164220,158206,6014,3.7
Plaquemines,4/1/2022,9740,9473,267,2.7,163893,157891,6002,3.7
Plaquemines,5/1/2022,9723,9428,295,3,164362,158378,5983,3.6
Plaquemines,6/1/2022,9846,9459,387,3.9,164046,158094,5951,3.6
Plaquemines,7/1/2022,9843,9496,347,3.5,164026,158258,5768,3.5
Plaquemines,8/1/2022,9662,9335,327,3.4,164654,158735,5919,3.6
Plaquemines,9/1/2022,9686,9365,321,3.3,164602,158810,5792,3.5
Plaquemines,10/1/2022,9704,9408,296,3.1,164648,158684,5964,3.6
Plaquemines,11/1/2022,9682,9396,286,3,164450,158507,5943,3.6
Plaquemines,12/1/2022,9699,9413,286,2.9,165025,159259,5766,3.5
Plaquemines,1/1/2023,9674,9346,328,3.4,165964,160217,5747,3.5
Plaquemines,2/1/2023,9703,9395,308,3.2,166358,160395,5962,3.6
Plaquemines,3/1/2023,9728,9445,283,2.9,166651,160812,5839,3.5
Plaquemines,4/1/2023,9800,9543,257,2.6,166725,160974,5751,3.4
Plaquemines,5/1/2023,9758,9460,298,3.1,166886,160796,6089,3.6
Plaquemines,6/1/2023,9856,9504,352,3.6,166937,160979,5958,3.6
Plaquemines,7/1/2023,9815,9502,313,3.2,167103,161183,5920,3.5
Plaquemines,8/1/2023,9702,9371,331,3.4,167759,161475,6284,3.7
Plaquemines,9/1/2023,9720,9368,352,3.6,167767,161442,6326,3.8
Plaquemines,10/1/2023,9715,9363,352,3.6,167690,161211,6479,3.9
Plaquemines,11/1/2023,9725,9394,331,3.4,168140,161886,6254,3.7
Plaquemines,12/1/2023,9685,9336,349,3.6,167439,161124,6315,3.8
Plaquemines,1/1/2024,9622,9250,372,3.9,167339,161190,6149,3.7
Plaquemines,2/1/2024,9592,9210,382,4,167475,161013,6462,3.9
Plaquemines,3/1/2024,9655,9292,363,3.8,167922,161425,6497,3.9
Plaquemines,4/1/2024,9735,9423,312,3.2,167988,161495,6492,3.9
Plaquemines,5/1/2024,9639,9291,348,3.6,167799,161164,6635,4
Plaquemines,6/1/2024,9856,9412,444,4.5,168005,161155,6849,4.1
Plaquemines,7/1/2024,9936,9493,443,4.5,168315,161219,7097,4.2
Plaquemines,8/1/2024,9804,9348,456,4.7,168496,161425,7071,4.2
Plaquemines,9/1/2024,9810,9361,449,4.6,168703,161802,6901,4.1
Plaquemines,10/1/2024,9862,9413,449,4.6,168428,161456,6972,4.1
Plaquemines,11/1/2024,9833,9376,457,4.6,168304,161183,7121,4.2
Plaquemines,12/1/2024,9759,9340,419,4.3,168547,161661,6886,4.1
Plaquemines,1/1/2025,10189,9763,426,4.2,170744,163895,6849,4
Plaquemines,2/1/2025,10148,9745,403,4,170359,163307,7052,4.1
Pointe Coupee,1/1/1990,9028,8114,914,10.1,125833,119081,6752,5.4
Pointe Coupee,2/1/1990,8710,7958,752,8.6,125710,119059,6651,5.3
Pointe Coupee,3/1/1990,8781,8077,704,8,125801,119203,6598,5.2
Pointe Coupee,4/1/1990,8866,8170,696,7.9,125649,118852,6797,5.4
Pointe Coupee,5/1/1990,8912,8258,654,7.3,125893,119151,6742,5.4
Pointe Coupee,6/1/1990,8912,8051,861,9.7,125573,118983,6590,5.2
Pointe Coupee,7/1/1990,9014,8091,923,10.2,125732,118810,6922,5.5
Pointe Coupee,8/1/1990,8978,7963,1015,11.3,125990,118802,7188,5.7
Pointe Coupee,9/1/1990,9153,8177,976,10.7,125892,118524,7368,5.9
Pointe Coupee,10/1/1990,8950,8109,841,9.4,125995,118536,7459,5.9
Pointe Coupee,11/1/1990,9208,8325,883,9.6,126070,118306,7764,6.2
Pointe Coupee,12/1/1990,8802,7794,1008,11.5,126142,118241,7901,6.3
Pointe Coupee,1/1/1991,8876,7685,1191,13.4,125955,117940,8015,6.4
Pointe Coupee,2/1/1991,8784,7732,1052,12,126020,117755,8265,6.6
Pointe Coupee,3/1/1991,8827,7977,850,9.6,126238,117652,8586,6.8
Pointe Coupee,4/1/1991,8987,8146,841,9.4,126548,118109,8439,6.7
Pointe Coupee,5/1/1991,9102,8032,1070,11.8,126176,117440,8736,6.9
Pointe Coupee,6/1/1991,9352,7987,1365,14.6,126331,117639,8692,6.9
Pointe Coupee,7/1/1991,9309,8078,1231,13.2,126154,117568,8586,6.8
Pointe Coupee,8/1/1991,9176,7974,1202,13.1,126150,117484,8666,6.9
Pointe Coupee,9/1/1991,9104,8106,998,11,126650,117928,8722,6.9
Pointe Coupee,10/1/1991,9418,8556,862,9.2,126642,117800,8842,7
Pointe Coupee,11/1/1991,9412,8583,829,8.8,126701,117770,8931,7
Pointe Coupee,12/1/1991,9284,8464,820,8.8,126664,117466,9198,7.3
Pointe Coupee,1/1/1992,8662,7606,1056,12.2,127261,117978,9283,7.3
Pointe Coupee,2/1/1992,8568,7751,817,9.5,127207,117753,9454,7.4
Pointe Coupee,3/1/1992,8649,7866,783,9.1,127604,118144,9460,7.4
Pointe Coupee,4/1/1992,8839,8179,660,7.5,127841,118426,9415,7.4
Pointe Coupee,5/1/1992,8844,8161,683,7.7,128119,118375,9744,7.6
Pointe Coupee,6/1/1992,9270,8208,1062,11.5,128459,118419,10040,7.8
Pointe Coupee,7/1/1992,9607,8537,1070,11.1,128563,118713,9850,7.7
Pointe Coupee,8/1/1992,9535,8533,1002,10.5,128613,118826,9787,7.6
Pointe Coupee,9/1/1992,9540,8687,853,8.9,128501,118720,9781,7.6
Pointe Coupee,10/1/1992,9567,8818,749,7.8,128026,118628,9398,7.3
Pointe Coupee,11/1/1992,9619,8812,807,8.4,128441,118876,9565,7.4
Pointe Coupee,12/1/1992,9456,8664,792,8.4,128554,118997,9557,7.4
Pointe Coupee,1/1/1993,9588,8604,984,10.3,128400,119075,9325,7.3
Pointe Coupee,2/1/1993,9466,8702,764,8.1,128458,119275,9183,7.1
Pointe Coupee,3/1/1993,9708,8897,811,8.4,128598,119542,9056,7
Pointe Coupee,4/1/1993,9595,8837,758,7.9,128584,119474,9110,7.1
Pointe Coupee,5/1/1993,9573,8796,777,8.1,129264,120115,9149,7.1
Pointe Coupee,6/1/1993,9866,8897,969,9.8,129411,120290,9121,7
Pointe Coupee,7/1/1993,9794,8759,1035,10.6,129397,120467,8930,6.9
Pointe Coupee,8/1/1993,9801,8805,996,10.2,129619,120856,8763,6.8
Pointe Coupee,9/1/1993,9657,8739,918,9.5,129268,120554,8714,6.7
Pointe Coupee,10/1/1993,9995,9104,891,8.9,129573,120823,8750,6.8
Pointe Coupee,11/1/1993,9913,9095,818,8.3,129711,121169,8542,6.6
Pointe Coupee,12/1/1993,9987,9164,823,8.2,129941,121464,8477,6.5
Pointe Coupee,1/1/1994,9937,8863,1074,10.8,130596,121966,8630,6.6
Pointe Coupee,2/1/1994,9877,8893,984,10,130669,122086,8583,6.6
Pointe Coupee,3/1/1994,9938,8952,986,9.9,130400,121930,8470,6.5
Pointe Coupee,4/1/1994,9852,8900,952,9.7,130621,122290,8331,6.4
Pointe Coupee,5/1/1994,9792,8845,947,9.7,130779,122864,7915,6.1
Pointe Coupee,6/1/1994,9983,8665,1318,13.2,130561,122634,7927,6.1
Pointe Coupee,7/1/1994,9887,8606,1281,13,130652,122706,7946,6.1
Pointe Coupee,8/1/1994,9905,8548,1357,13.7,131275,123342,7933,6
Pointe Coupee,9/1/1994,9701,8608,1093,11.3,131421,123687,7734,5.9
Pointe Coupee,10/1/1994,10042,9033,1009,10,131744,124112,7632,5.8
Pointe Coupee,11/1/1994,9899,9068,831,8.4,131891,124516,7375,5.6
Pointe Coupee,12/1/1994,9843,8999,844,8.6,131951,124721,7230,5.5
Pointe Coupee,1/1/1995,9487,8384,1103,11.6,132038,124663,7375,5.6
Pointe Coupee,2/1/1995,9207,8324,883,9.6,132115,124928,7187,5.4
Pointe Coupee,3/1/1995,9246,8392,854,9.2,132108,124955,7153,5.4
Pointe Coupee,4/1/1995,9456,8598,858,9.1,132590,124945,7645,5.8
Pointe Coupee,5/1/1995,9386,8478,908,9.7,131851,124421,7430,5.6
Pointe Coupee,6/1/1995,9625,8503,1122,11.7,131949,124522,7427,5.6
Pointe Coupee,7/1/1995,9412,8487,925,9.8,132343,124816,7527,5.7
Pointe Coupee,8/1/1995,9392,8448,944,10.1,132336,124852,7484,5.7
Pointe Coupee,9/1/1995,9465,8592,873,9.2,132611,125133,7478,5.6
Pointe Coupee,10/1/1995,9326,8624,702,7.5,132716,125388,7328,5.5
Pointe Coupee,11/1/1995,9066,8443,623,6.9,132614,125188,7426,5.6
Pointe Coupee,12/1/1995,8976,8314,662,7.4,132511,125088,7423,5.6
Pointe Coupee,1/1/1996,8997,8116,881,9.8,132616,125125,7491,5.6
Pointe Coupee,2/1/1996,8901,8230,671,7.5,132952,125639,7313,5.5
Pointe Coupee,3/1/1996,8962,8369,593,6.6,133180,125862,7318,5.5
Pointe Coupee,4/1/1996,9177,8539,638,7,133409,125994,7415,5.6
Pointe Coupee,5/1/1996,8967,8333,634,7.1,133667,126244,7423,5.6
Pointe Coupee,6/1/1996,9328,8406,922,9.9,133697,126602,7095,5.3
Pointe Coupee,7/1/1996,9546,8563,983,10.3,134284,126947,7337,5.5
Pointe Coupee,8/1/1996,9343,8505,838,9,134054,127172,6882,5.1
Pointe Coupee,9/1/1996,9384,8627,757,8.1,134515,127536,6979,5.2
Pointe Coupee,10/1/1996,9582,8877,705,7.4,134921,127890,7031,5.2
Pointe Coupee,11/1/1996,9257,8735,522,5.6,135007,127771,7236,5.4
Pointe Coupee,12/1/1996,9278,8694,584,6.3,135113,127860,7253,5.4
Pointe Coupee,1/1/1997,9184,8412,772,8.4,135456,128298,7158,5.3
Pointe Coupee,2/1/1997,9039,8394,645,7.1,135400,128298,7102,5.2
Pointe Coupee,3/1/1997,9186,8495,691,7.5,135891,128891,7000,5.2
Pointe Coupee,4/1/1997,9099,8484,615,6.8,136016,129143,6873,5.1
Pointe Coupee,5/1/1997,9362,8688,674,7.2,136119,129464,6655,4.9
Pointe Coupee,6/1/1997,9622,8510,1112,11.6,136211,129412,6799,5
Pointe Coupee,7/1/1997,9381,8421,960,10.2,136477,129822,6655,4.9
Pointe Coupee,8/1/1997,9191,8374,817,8.9,136618,130010,6608,4.8
Pointe Coupee,9/1/1997,9520,8795,725,7.6,136675,130019,6656,4.9
Pointe Coupee,10/1/1997,9437,8826,611,6.5,136633,130179,6454,4.7
Pointe Coupee,11/1/1997,9416,8861,555,5.9,136961,130653,6308,4.6
Pointe Coupee,12/1/1997,9409,8761,648,6.9,137155,130679,6476,4.7
Pointe Coupee,1/1/1998,9271,8487,784,8.5,137095,130726,6368,4.6
Pointe Coupee,2/1/1998,9074,8486,588,6.5,137112,130807,6306,4.6
Pointe Coupee,3/1/1998,9275,8661,614,6.6,137236,130814,6422,4.7
Pointe Coupee,4/1/1998,9372,8772,600,6.4,137150,131209,5941,4.3
Pointe Coupee,5/1/1998,9398,8728,670,7.1,137372,131325,6047,4.4
Pointe Coupee,6/1/1998,9717,8815,902,9.3,137455,131244,6212,4.5
Pointe Coupee,7/1/1998,9348,8537,811,8.7,137588,131329,6259,4.5
Pointe Coupee,8/1/1998,9153,8412,741,8.1,137570,131390,6179,4.5
Pointe Coupee,9/1/1998,9487,8777,710,7.5,138286,131986,6300,4.6
Pointe Coupee,10/1/1998,9746,9140,606,6.2,138279,131999,6280,4.5
Pointe Coupee,11/1/1998,9564,9087,477,5,138381,132280,6100,4.4
Pointe Coupee,12/1/1998,9575,9104,471,4.9,138634,132602,6032,4.4
Pointe Coupee,1/1/1999,9268,8687,581,6.3,139003,133027,5976,4.3
Pointe Coupee,2/1/1999,9154,8647,507,5.5,138967,132856,6111,4.4
Pointe Coupee,3/1/1999,9182,8753,429,4.7,138730,132947,5783,4.2
Pointe Coupee,4/1/1999,9239,8805,434,4.7,138959,132955,6004,4.3
Pointe Coupee,5/1/1999,9359,8873,486,5.2,139107,133311,5796,4.2
Pointe Coupee,6/1/1999,9774,9080,694,7.1,139329,133378,5951,4.3
Pointe Coupee,7/1/1999,9953,9204,749,7.5,139439,133414,6025,4.3
Pointe Coupee,8/1/1999,9881,9166,715,7.2,139430,133591,5838,4.2
Pointe Coupee,9/1/1999,9539,8902,637,6.7,139622,133707,5915,4.2
Pointe Coupee,10/1/1999,9802,9251,551,5.6,139771,133993,5778,4.1
Pointe Coupee,11/1/1999,9621,9140,481,5,140025,134309,5716,4.1
Pointe Coupee,12/1/1999,9608,9098,510,5.3,140177,134523,5653,4
Pointe Coupee,1/1/2000,9802,9085,717,7.3,142267,136559,5708,4
Pointe Coupee,2/1/2000,9771,9187,584,6,142456,136598,5858,4.1
Pointe Coupee,3/1/2000,9744,9222,522,5.4,142434,136701,5733,4
Pointe Coupee,4/1/2000,9766,9324,442,4.5,142751,137270,5481,3.8
Pointe Coupee,5/1/2000,9653,9147,506,5.2,142388,136630,5758,4
Pointe Coupee,6/1/2000,9920,9217,703,7.1,142591,136940,5651,4
Pointe Coupee,7/1/2000,9673,9019,654,6.8,142278,136531,5747,4
Pointe Coupee,8/1/2000,9668,9010,658,6.8,142514,136662,5853,4.1
Pointe Coupee,9/1/2000,9613,9009,604,6.3,142518,136893,5625,3.9
Pointe Coupee,10/1/2000,9606,9037,569,5.9,142622,137088,5534,3.9
Pointe Coupee,11/1/2000,9635,9059,576,6,142962,137322,5639,3.9
Pointe Coupee,12/1/2000,9632,9050,582,6,143248,137614,5634,3.9
Pointe Coupee,1/1/2001,9570,8887,683,7.1,143800,137778,6023,4.2
Pointe Coupee,2/1/2001,9462,8897,565,6,143701,137612,6089,4.2
Pointe Coupee,3/1/2001,9489,8890,599,6.3,143924,137783,6141,4.3
Pointe Coupee,4/1/2001,9531,8946,585,6.1,143569,137299,6271,4.4
Pointe Coupee,5/1/2001,9493,8910,583,6.1,143318,137092,6226,4.3
Pointe Coupee,6/1/2001,9718,8939,779,8,143357,136873,6484,4.5
Pointe Coupee,7/1/2001,9540,8862,678,7.1,143654,137071,6583,4.6
Pointe Coupee,8/1/2001,9428,8789,639,6.8,143284,136241,7042,4.9
Pointe Coupee,9/1/2001,9484,8826,658,6.9,143989,136846,7142,5
Pointe Coupee,10/1/2001,9603,8961,642,6.7,144086,136392,7694,5.3
Pointe Coupee,11/1/2001,9566,8947,619,6.5,144240,136238,8003,5.5
Pointe Coupee,12/1/2001,9581,8912,669,7,144305,136047,8258,5.7
Pointe Coupee,1/1/2002,9370,8621,749,8,143883,135701,8182,5.7
Pointe Coupee,2/1/2002,9322,8731,591,6.3,144653,136438,8215,5.7
Pointe Coupee,3/1/2002,9324,8714,610,6.5,144481,136177,8304,5.7
Pointe Coupee,4/1/2002,9365,8802,563,6,144725,136126,8599,5.9
Pointe Coupee,5/1/2002,9297,8719,578,6.2,144938,136539,8399,5.8
Pointe Coupee,6/1/2002,9564,8784,780,8.2,144808,136415,8393,5.8
Pointe Coupee,7/1/2002,9439,8748,691,7.3,144803,136413,8390,5.8
Pointe Coupee,8/1/2002,9370,8735,635,6.8,145009,136705,8304,5.7
Pointe Coupee,9/1/2002,9415,8795,620,6.6,145552,137302,8251,5.7
Pointe Coupee,10/1/2002,9476,8868,608,6.4,145314,137008,8307,5.7
Pointe Coupee,11/1/2002,9384,8807,577,6.1,145041,136521,8520,5.9
Pointe Coupee,12/1/2002,9402,8741,661,7,145066,136426,8640,6
Pointe Coupee,1/1/2003,9312,8563,749,8,145937,137417,8520,5.8
Pointe Coupee,2/1/2003,9347,8717,630,6.7,146100,137482,8618,5.9
Pointe Coupee,3/1/2003,9356,8700,656,7,146022,137434,8588,5.9
Pointe Coupee,4/1/2003,9457,8818,639,6.8,146474,137633,8842,6
Pointe Coupee,5/1/2003,9373,8715,658,7,146500,137544,8957,6.1
Pointe Coupee,6/1/2003,9660,8701,959,9.9,147056,137790,9266,6.3
Pointe Coupee,7/1/2003,9629,8764,865,9,146485,137474,9011,6.2
Pointe Coupee,8/1/2003,9478,8701,777,8.2,146445,137549,8896,6.1
Pointe Coupee,9/1/2003,9403,8715,688,7.3,146530,137609,8921,6.1
Pointe Coupee,10/1/2003,9485,8846,639,6.7,146716,137984,8732,6
Pointe Coupee,11/1/2003,9389,8824,565,6,147000,138424,8576,5.8
Pointe Coupee,12/1/2003,9360,8764,596,6.4,146729,138411,8317,5.7
Pointe Coupee,1/1/2004,9340,8602,738,7.9,146842,138472,8370,5.7
Pointe Coupee,2/1/2004,9334,8739,595,6.4,146709,138542,8167,5.6
Pointe Coupee,3/1/2004,9424,8804,620,6.6,146944,138453,8491,5.8
Pointe Coupee,4/1/2004,9500,8827,673,7.1,146850,138680,8170,5.6
Pointe Coupee,5/1/2004,9394,8705,689,7.3,147065,138852,8212,5.6
Pointe Coupee,6/1/2004,9658,8793,865,9,147460,139174,8286,5.6
Pointe Coupee,7/1/2004,9603,8837,766,8,147692,139556,8136,5.5
Pointe Coupee,8/1/2004,9517,8806,711,7.5,147564,139573,7990,5.4
Pointe Coupee,9/1/2004,9453,8804,649,6.9,147415,139487,7927,5.4
Pointe Coupee,10/1/2004,9501,8888,613,6.5,147793,139732,8061,5.5
Pointe Coupee,11/1/2004,9596,8948,648,6.8,148162,140231,7932,5.4
Pointe Coupee,12/1/2004,9521,8892,629,6.6,148059,140125,7934,5.4
Pointe Coupee,1/1/2005,9357,8628,729,7.8,148029,140245,7784,5.3
Pointe Coupee,2/1/2005,9445,8746,699,7.4,148364,140385,7980,5.4
Pointe Coupee,3/1/2005,9502,8816,686,7.2,148391,140654,7737,5.2
Pointe Coupee,4/1/2005,9571,8954,617,6.4,148926,141254,7672,5.2
Pointe Coupee,5/1/2005,9469,8816,653,6.9,149261,141609,7651,5.1
Pointe Coupee,6/1/2005,9689,8847,842,8.7,149238,141714,7524,5
Pointe Coupee,7/1/2005,9685,8900,785,8.1,149432,142026,7406,5
Pointe Coupee,8/1/2005,9565,8900,665,7,149779,142434,7345,4.9
Pointe Coupee,9/1/2005,11178,9587,1591,14.2,149954,142401,7553,5
Pointe Coupee,10/1/2005,11117,9759,1358,12.2,150001,142548,7453,5
Pointe Coupee,11/1/2005,11044,9770,1274,11.5,150065,142499,7566,5
Pointe Coupee,12/1/2005,10338,9655,683,6.6,150030,142752,7279,4.9
Pointe Coupee,1/1/2006,9686,9143,543,5.6,150214,143150,7064,4.7
Pointe Coupee,2/1/2006,9676,9258,418,4.3,150641,143457,7184,4.8
Pointe Coupee,3/1/2006,9702,9281,421,4.3,150813,143741,7072,4.7
Pointe Coupee,4/1/2006,9617,9243,374,3.9,150881,143761,7120,4.7
Pointe Coupee,5/1/2006,9582,9171,411,4.3,151069,144089,6980,4.6
Pointe Coupee,6/1/2006,9695,9116,579,6,151354,144353,7001,4.6
Pointe Coupee,7/1/2006,9560,9031,529,5.5,151377,144202,7175,4.7
Pointe Coupee,8/1/2006,9521,9060,461,4.8,151716,144625,7091,4.7
Pointe Coupee,9/1/2006,9502,9069,433,4.6,151662,144815,6847,4.5
Pointe Coupee,10/1/2006,9572,9184,388,4.1,152041,145314,6727,4.4
Pointe Coupee,11/1/2006,9593,9182,411,4.3,152406,145534,6872,4.5
Pointe Coupee,12/1/2006,9595,9192,403,4.2,152732,145970,6762,4.4
Pointe Coupee,1/1/2007,9353,8863,490,5.2,153144,146028,7116,4.6
Pointe Coupee,2/1/2007,9356,8965,391,4.2,152983,146057,6927,4.5
Pointe Coupee,3/1/2007,9470,9065,405,4.3,153051,146320,6731,4.4
Pointe Coupee,4/1/2007,9500,9087,413,4.3,152435,145586,6850,4.5
Pointe Coupee,5/1/2007,9476,9066,410,4.3,152670,145903,6766,4.4
Pointe Coupee,6/1/2007,9680,9130,550,5.7,153041,146063,6979,4.6
Pointe Coupee,7/1/2007,9736,9200,536,5.5,153054,145905,7149,4.7
Pointe Coupee,8/1/2007,9528,9106,422,4.4,152749,145682,7067,4.6
Pointe Coupee,9/1/2007,9601,9165,436,4.5,153414,146244,7170,4.7
Pointe Coupee,10/1/2007,9598,9240,358,3.7,153183,145946,7237,4.7
Pointe Coupee,11/1/2007,9650,9285,365,3.8,153835,146595,7240,4.7
Pointe Coupee,12/1/2007,9627,9232,395,4.1,153918,146273,7645,5
Pointe Coupee,1/1/2008,9389,8944,445,4.7,154063,146378,7685,5
Pointe Coupee,2/1/2008,9369,9019,350,3.7,153653,146156,7497,4.9
Pointe Coupee,3/1/2008,9463,9084,379,4,153908,146086,7822,5.1
Pointe Coupee,4/1/2008,9528,9169,359,3.8,153769,146132,7637,5
Pointe Coupee,5/1/2008,9535,9108,427,4.5,154303,145908,8395,5.4
Pointe Coupee,6/1/2008,9811,9207,604,6.2,154313,145737,8575,5.6
Pointe Coupee,7/1/2008,9801,9213,588,6,154469,145532,8937,5.8
Pointe Coupee,8/1/2008,9634,9116,518,5.4,154641,145203,9438,6.1
Pointe Coupee,9/1/2008,9741,9134,607,6.2,154570,145076,9494,6.1
Pointe Coupee,10/1/2008,9765,9246,519,5.3,154876,144802,10074,6.5
Pointe Coupee,11/1/2008,9733,9240,493,5.1,154639,144100,10538,6.8
Pointe Coupee,12/1/2008,9711,9194,517,5.3,154655,143369,11286,7.3
Pointe Coupee,1/1/2009,9420,8824,596,6.3,154210,142152,12058,7.8
Pointe Coupee,2/1/2009,9482,8901,581,6.1,154538,141640,12898,8.3
Pointe Coupee,3/1/2009,9536,8942,594,6.2,154133,140707,13426,8.7
Pointe Coupee,4/1/2009,9555,8994,561,5.9,154509,140656,13853,9
Pointe Coupee,5/1/2009,9532,8908,624,6.5,154747,140248,14499,9.4
Pointe Coupee,6/1/2009,9706,8928,778,8,154716,140009,14707,9.5
Pointe Coupee,7/1/2009,9756,9027,729,7.5,154502,139901,14601,9.5
Pointe Coupee,8/1/2009,9632,8953,679,7,154307,139492,14814,9.6
Pointe Coupee,9/1/2009,9680,8983,697,7.2,153827,138818,15009,9.8
Pointe Coupee,10/1/2009,9620,8956,664,6.9,153784,138432,15352,10
Pointe Coupee,11/1/2009,9627,8985,642,6.7,153878,138659,15219,9.9
Pointe Coupee,12/1/2009,9508,8842,666,7,153111,138013,15098,9.9
Pointe Coupee,1/1/2010,9655,8902,753,7.8,153484,138438,15046,9.8
Pointe Coupee,2/1/2010,9786,9105,681,7,153694,138581,15113,9.8
Pointe Coupee,3/1/2010,9879,9184,695,7,153954,138751,15202,9.9
Pointe Coupee,4/1/2010,10002,9307,695,6.9,154622,139297,15325,9.9
Pointe Coupee,5/1/2010,10025,9238,787,7.9,154091,139241,14849,9.6
Pointe Coupee,6/1/2010,10179,9271,908,8.9,153616,139141,14474,9.4
Pointe Coupee,7/1/2010,10253,9350,903,8.8,153691,139179,14512,9.4
Pointe Coupee,8/1/2010,10187,9313,874,8.6,154086,139438,14648,9.5
Pointe Coupee,9/1/2010,10113,9239,874,8.6,153975,139396,14579,9.5
Pointe Coupee,10/1/2010,10107,9275,832,8.2,153635,139119,14516,9.4
Pointe Coupee,11/1/2010,10052,9197,855,8.5,154125,139044,15081,9.8
Pointe Coupee,12/1/2010,9915,9057,858,8.7,153650,139301,14348,9.3
Pointe Coupee,1/1/2011,9882,8921,961,9.7,153263,139250,14013,9.1
Pointe Coupee,2/1/2011,9946,9065,881,8.9,153214,139394,13820,9
Pointe Coupee,3/1/2011,9897,9084,813,8.2,153376,139639,13737,9
Pointe Coupee,4/1/2011,10002,9194,808,8.1,153543,139586,13957,9.1
Pointe Coupee,5/1/2011,10025,9175,850,8.5,153479,139624,13855,9
Pointe Coupee,6/1/2011,10110,9137,973,9.6,153346,139384,13962,9.1
Pointe Coupee,7/1/2011,10188,9258,930,9.1,153288,139524,13763,9
Pointe Coupee,8/1/2011,10082,9178,904,9,153760,139942,13818,9
Pointe Coupee,9/1/2011,10077,9207,870,8.6,154131,140183,13948,9
Pointe Coupee,10/1/2011,10073,9264,809,8,153961,140368,13594,8.8
Pointe Coupee,11/1/2011,10047,9277,770,7.7,154128,140826,13302,8.6
Pointe Coupee,12/1/2011,9941,9185,756,7.6,153995,140902,13093,8.5
Pointe Coupee,1/1/2012,9757,8882,875,9,154381,141584,12797,8.3
Pointe Coupee,2/1/2012,9832,9058,774,7.9,154671,141858,12813,8.3
Pointe Coupee,3/1/2012,9835,9076,759,7.7,154749,142036,12713,8.2
Pointe Coupee,4/1/2012,9841,9140,701,7.1,154545,141899,12646,8.2
Pointe Coupee,5/1/2012,9916,9154,762,7.7,154866,142206,12660,8.2
Pointe Coupee,6/1/2012,10103,9162,941,9.3,155083,142391,12692,8.2
Pointe Coupee,7/1/2012,10143,9237,906,8.9,154948,142292,12656,8.2
Pointe Coupee,8/1/2012,9966,9177,789,7.9,154763,142291,12471,8.1
Pointe Coupee,9/1/2012,9941,9222,719,7.2,155160,143044,12115,7.8
Pointe Coupee,10/1/2012,9996,9305,691,6.9,155554,143431,12124,7.8
Pointe Coupee,11/1/2012,9946,9306,640,6.4,155338,143333,12005,7.7
Pointe Coupee,12/1/2012,9922,9229,693,7,155628,143330,12298,7.9
Pointe Coupee,1/1/2013,9720,8914,806,8.3,155763,143292,12471,8
Pointe Coupee,2/1/2013,9768,9052,716,7.3,155312,143362,11950,7.7
Pointe Coupee,3/1/2013,9715,9033,682,7,155005,143316,11689,7.5
Pointe Coupee,4/1/2013,9826,9135,691,7,155394,143635,11760,7.6
Pointe Coupee,5/1/2013,9934,9191,743,7.5,155536,143882,11654,7.5
Pointe Coupee,6/1/2013,10085,9215,870,8.6,155749,143999,11751,7.5
Pointe Coupee,7/1/2013,10191,9353,838,8.2,155599,144264,11335,7.3
Pointe Coupee,8/1/2013,10037,9294,743,7.4,155605,144326,11279,7.2
Pointe Coupee,9/1/2013,10025,9315,710,7.1,155687,144418,11270,7.2
Pointe Coupee,10/1/2013,9905,9252,653,6.6,154673,143537,11136,7.2
Pointe Coupee,11/1/2013,9886,9282,604,6.1,155265,144479,10787,6.9
Pointe Coupee,12/1/2013,9803,9235,568,5.8,155182,144778,10404,6.7
Pointe Coupee,1/1/2014,9677,9049,628,6.5,155352,145150,10202,6.6
Pointe Coupee,2/1/2014,9790,9189,601,6.1,155483,145134,10349,6.7
Pointe Coupee,3/1/2014,9815,9214,601,6.1,156028,145648,10380,6.7
Pointe Coupee,4/1/2014,9833,9260,573,5.8,155369,145667,9702,6.2
Pointe Coupee,5/1/2014,9908,9264,644,6.5,155684,145825,9859,6.3
Pointe Coupee,6/1/2014,10102,9336,766,7.6,155707,146247,9460,6.1
Pointe Coupee,7/1/2014,10306,9477,829,8,156007,146399,9608,6.2
Pointe Coupee,8/1/2014,10239,9449,790,7.7,156130,146530,9599,6.1
Pointe Coupee,9/1/2014,10280,9535,745,7.2,156040,146778,9262,5.9
Pointe Coupee,10/1/2014,10275,9554,721,7,156417,147427,8990,5.7
Pointe Coupee,11/1/2014,10222,9490,732,7.2,156494,147404,9090,5.8
Pointe Coupee,12/1/2014,10151,9468,683,6.7,156332,147615,8717,5.6
Pointe Coupee,1/1/2015,10030,9265,765,7.6,157030,148145,8885,5.7
Pointe Coupee,2/1/2015,10020,9355,665,6.6,156644,148045,8599,5.5
Pointe Coupee,3/1/2015,10043,9384,659,6.6,156643,148128,8515,5.4
Pointe Coupee,4/1/2015,10018,9380,638,6.4,157060,148511,8550,5.4
Pointe Coupee,5/1/2015,10117,9448,669,6.6,157651,148817,8834,5.6
Pointe Coupee,6/1/2015,10255,9504,751,7.3,157062,148816,8247,5.3
Pointe Coupee,7/1/2015,10285,9547,738,7.2,156997,148830,8167,5.2
Pointe Coupee,8/1/2015,10127,9468,659,6.5,157172,149181,7992,5.1
Pointe Coupee,9/1/2015,10008,9388,620,6.2,156733,148826,7907,5
Pointe Coupee,10/1/2015,9991,9396,595,6,157167,149246,7922,5
Pointe Coupee,11/1/2015,10030,9441,589,5.9,157463,149463,8000,5.1
Pointe Coupee,12/1/2015,9970,9413,557,5.6,158035,150128,7907,5
Pointe Coupee,1/1/2016,9841,9206,635,6.5,158280,150653,7627,4.8
Pointe Coupee,2/1/2016,9883,9309,574,5.8,158640,150939,7702,4.9
Pointe Coupee,3/1/2016,9991,9387,604,6,159179,151218,7961,5
Pointe Coupee,4/1/2016,10023,9403,620,6.2,159141,151074,8067,5.1
Pointe Coupee,5/1/2016,10060,9430,630,6.3,158784,151132,7652,4.8
Pointe Coupee,6/1/2016,10201,9466,735,7.2,158967,151223,7744,4.9
Pointe Coupee,7/1/2016,10179,9457,722,7.1,159194,151554,7641,4.8
Pointe Coupee,8/1/2016,9950,9244,706,7.1,159562,151779,7784,4.9
Pointe Coupee,9/1/2016,9942,9227,715,7.2,159714,151761,7953,5
Pointe Coupee,10/1/2016,9861,9242,619,6.3,159605,151793,7811,4.9
Pointe Coupee,11/1/2016,9843,9261,582,5.9,159506,151954,7553,4.7
Pointe Coupee,12/1/2016,9705,9137,568,5.9,159678,152157,7521,4.7
Pointe Coupee,1/1/2017,9887,9218,669,6.8,159620,152152,7468,4.7
Pointe Coupee,2/1/2017,9962,9361,601,6,159859,152480,7379,4.6
Pointe Coupee,3/1/2017,9978,9435,543,5.4,160137,153065,7073,4.4
Pointe Coupee,4/1/2017,10014,9470,544,5.4,160345,153255,7089,4.4
Pointe Coupee,5/1/2017,10028,9495,533,5.3,160068,153069,7000,4.4
Pointe Coupee,6/1/2017,10192,9564,628,6.2,160192,153318,6873,4.3
Pointe Coupee,7/1/2017,10158,9550,608,6,160462,153569,6892,4.3
Pointe Coupee,8/1/2017,10027,9430,597,6,160586,153503,7082,4.4
Pointe Coupee,9/1/2017,9967,9422,545,5.5,161140,154286,6854,4.3
Pointe Coupee,10/1/2017,9916,9429,487,4.9,160309,153609,6700,4.2
Pointe Coupee,11/1/2017,9888,9417,471,4.8,160579,153805,6774,4.2
Pointe Coupee,12/1/2017,9813,9354,459,4.7,160535,153904,6632,4.1
Pointe Coupee,1/1/2018,9693,9157,536,5.5,160914,154425,6489,4
Pointe Coupee,2/1/2018,9800,9292,508,5.2,161778,155197,6581,4.1
Pointe Coupee,3/1/2018,9944,9443,501,5,161686,155214,6472,4
Pointe Coupee,4/1/2018,9905,9416,489,4.9,161771,155312,6459,4
Pointe Coupee,5/1/2018,9906,9417,489,4.9,161848,155652,6196,3.8
Pointe Coupee,6/1/2018,10088,9438,650,6.4,162210,155762,6447,4
Pointe Coupee,7/1/2018,10092,9472,620,6.1,162341,156146,6195,3.8
Pointe Coupee,8/1/2018,9897,9323,574,5.8,161660,155504,6156,3.8
Pointe Coupee,9/1/2018,9862,9343,519,5.3,162087,156015,6073,3.7
Pointe Coupee,10/1/2018,9928,9437,491,4.9,162602,156391,6211,3.8
Pointe Coupee,11/1/2018,9894,9438,456,4.6,162836,156721,6115,3.8
Pointe Coupee,12/1/2018,9832,9347,485,4.9,163206,156817,6389,3.9
Pointe Coupee,1/1/2019,9711,9134,577,5.9,162963,156487,6475,4
Pointe Coupee,2/1/2019,9781,9311,470,4.8,162999,156863,6136,3.8
Pointe Coupee,3/1/2019,9814,9367,447,4.6,162904,156701,6202,3.8
Pointe Coupee,4/1/2019,9698,9292,406,4.2,162586,156625,5961,3.7
Pointe Coupee,5/1/2019,9720,9263,457,4.7,162751,156821,5930,3.6
Pointe Coupee,6/1/2019,9818,9236,582,5.9,163168,157232,5935,3.6
Pointe Coupee,7/1/2019,9803,9210,593,6,163590,157529,6061,3.7
Pointe Coupee,8/1/2019,9811,9260,551,5.6,163774,157829,5945,3.6
Pointe Coupee,9/1/2019,9850,9334,516,5.2,164092,158339,5753,3.5
Pointe Coupee,10/1/2019,9799,9295,504,5.1,164416,158545,5871,3.6
Pointe Coupee,11/1/2019,9723,9249,474,4.9,164496,158629,5868,3.6
Pointe Coupee,12/1/2019,9599,9121,478,5,164699,158845,5853,3.6
Pointe Coupee,1/1/2020,9367,8872,495,5.3,164377,158508,5869,3.6
Pointe Coupee,2/1/2020,9429,9031,398,4.2,164467,158714,5753,3.5
Pointe Coupee,3/1/2020,9649,8947,702,7.3,162559,155353,7206,4.4
Pointe Coupee,4/1/2020,8804,7773,1031,11.7,156269,133185,23084,14.8
Pointe Coupee,5/1/2020,9046,8004,1042,11.5,158101,137173,20929,13.2
Pointe Coupee,6/1/2020,9297,8262,1035,11.1,159994,142342,17652,11
Pointe Coupee,7/1/2020,9329,8342,987,10.6,160132,143779,16352,10.2
Pointe Coupee,8/1/2020,9426,8618,808,8.6,160706,147245,13461,8.4
Pointe Coupee,9/1/2020,9606,8769,837,8.7,160174,147620,12554,7.8
Pointe Coupee,10/1/2020,9677,8958,719,7.4,161003,149931,11072,6.9
Pointe Coupee,11/1/2020,9507,8855,652,6.9,160629,149934,10694,6.7
Pointe Coupee,12/1/2020,9475,8816,659,7,160745,149975,10770,6.7
Pointe Coupee,1/1/2021,9422,8728,694,7.4,160088,149852,10236,6.4
Pointe Coupee,2/1/2021,9489,8840,649,6.8,160184,150189,9995,6.2
Pointe Coupee,3/1/2021,9550,8939,611,6.4,160400,150644,9756,6.1
Pointe Coupee,4/1/2021,9617,9018,599,6.2,160843,151081,9762,6.1
Pointe Coupee,5/1/2021,9563,8958,605,6.3,160800,151535,9266,5.8
Pointe Coupee,6/1/2021,9593,8881,712,7.4,161197,151734,9462,5.9
Pointe Coupee,7/1/2021,9530,8885,645,6.8,161504,152773,8731,5.4
Pointe Coupee,8/1/2021,9469,8913,556,5.9,161527,153250,8276,5.1
Pointe Coupee,9/1/2021,9662,9189,473,4.9,161495,153843,7652,4.7
Pointe Coupee,10/1/2021,9652,9230,422,4.4,161754,154475,7279,4.5
Pointe Coupee,11/1/2021,9609,9226,383,4,162281,155530,6751,4.2
Pointe Coupee,12/1/2021,9563,9228,335,3.5,162497,156099,6398,3.9
Pointe Coupee,1/1/2022,9660,9230,430,4.5,163627,157115,6512,4
Pointe Coupee,2/1/2022,9768,9381,387,4,163899,157598,6301,3.8
Pointe Coupee,3/1/2022,9800,9444,356,3.6,164220,158206,6014,3.7
Pointe Coupee,4/1/2022,9810,9474,336,3.4,163893,157891,6002,3.7
Pointe Coupee,5/1/2022,9761,9407,354,3.6,164362,158378,5983,3.6
Pointe Coupee,6/1/2022,9806,9332,474,4.8,164046,158094,5951,3.6
Pointe Coupee,7/1/2022,9847,9391,456,4.6,164026,158258,5768,3.5
Pointe Coupee,8/1/2022,9724,9292,432,4.4,164654,158735,5919,3.6
Pointe Coupee,9/1/2022,9706,9349,357,3.7,164602,158810,5792,3.5
Pointe Coupee,10/1/2022,9698,9373,325,3.4,164648,158684,5964,3.6
Pointe Coupee,11/1/2022,9652,9340,312,3.2,164450,158507,5943,3.6
Pointe Coupee,12/1/2022,9623,9306,317,3.3,165025,159259,5766,3.5
Pointe Coupee,1/1/2023,9653,9263,390,4,165964,160217,5747,3.5
Pointe Coupee,2/1/2023,9700,9360,340,3.5,166358,160395,5962,3.6
Pointe Coupee,3/1/2023,9759,9449,310,3.2,166651,160812,5839,3.5
Pointe Coupee,4/1/2023,9759,9480,279,2.9,166725,160974,5751,3.4
Pointe Coupee,5/1/2023,9726,9379,347,3.6,166886,160796,6089,3.6
Pointe Coupee,6/1/2023,9780,9346,434,4.4,166937,160979,5958,3.6
Pointe Coupee,7/1/2023,9826,9413,413,4.2,167103,161183,5920,3.5
Pointe Coupee,8/1/2023,9766,9352,414,4.2,167759,161475,6284,3.7
Pointe Coupee,9/1/2023,9834,9441,393,4,167767,161442,6326,3.8
Pointe Coupee,10/1/2023,9852,9461,391,4,167690,161211,6479,3.9
Pointe Coupee,11/1/2023,9892,9513,379,3.8,168140,161886,6254,3.7
Pointe Coupee,12/1/2023,9807,9439,368,3.8,167439,161124,6315,3.8
Pointe Coupee,1/1/2024,9804,9375,429,4.4,167339,161190,6149,3.7
Pointe Coupee,2/1/2024,9756,9353,403,4.1,167475,161013,6462,3.9
Pointe Coupee,3/1/2024,9857,9488,369,3.7,167922,161425,6497,3.9
Pointe Coupee,4/1/2024,9864,9532,332,3.4,167988,161495,6492,3.9
Pointe Coupee,5/1/2024,9810,9446,364,3.7,167799,161164,6635,4
Pointe Coupee,6/1/2024,9936,9454,482,4.9,168005,161155,6849,4.1
Pointe Coupee,7/1/2024,9995,9495,500,5,168315,161219,7097,4.2
Pointe Coupee,8/1/2024,9897,9436,461,4.7,168496,161425,7071,4.2
Pointe Coupee,9/1/2024,9866,9425,441,4.5,168703,161802,6901,4.1
Pointe Coupee,10/1/2024,9912,9473,439,4.4,168428,161456,6972,4.1
Pointe Coupee,11/1/2024,9869,9417,452,4.6,168304,161183,7121,4.2
Pointe Coupee,12/1/2024,9841,9405,436,4.4,168547,161661,6886,4.1
Pointe Coupee,1/1/2025,8681,8230,451,5.2,170744,163895,6849,4
Pointe Coupee,2/1/2025,8707,8306,401,4.6,170359,163307,7052,4.1
Rapides,1/1/1990,54752,51409,3343,6.1,125833,119081,6752,5.4
Rapides,2/1/1990,54661,51510,3151,5.8,125710,119059,6651,5.3
Rapides,3/1/1990,55295,52319,2976,5.4,125801,119203,6598,5.2
Rapides,4/1/1990,54405,51516,2889,5.3,125649,118852,6797,5.4
Rapides,5/1/1990,54298,51345,2953,5.4,125893,119151,6742,5.4
Rapides,6/1/1990,55866,52242,3624,6.5,125573,118983,6590,5.2
Rapides,7/1/1990,56610,53178,3432,6.1,125732,118810,6922,5.5
Rapides,8/1/1990,56556,52697,3859,6.8,125990,118802,7188,5.7
Rapides,9/1/1990,55741,52107,3634,6.5,125892,118524,7368,5.9
Rapides,10/1/1990,56054,52575,3479,6.2,125995,118536,7459,5.9
Rapides,11/1/1990,55852,52444,3408,6.1,126070,118306,7764,6.2
Rapides,12/1/1990,55502,52217,3285,5.9,126142,118241,7901,6.3
Rapides,1/1/1991,54987,50641,4346,7.9,125955,117940,8015,6.4
Rapides,2/1/1991,55146,51216,3930,7.1,126020,117755,8265,6.6
Rapides,3/1/1991,55174,51729,3445,6.2,126238,117652,8586,6.8
Rapides,4/1/1991,56014,52651,3363,6,126548,118109,8439,6.7
Rapides,5/1/1991,55586,52017,3569,6.4,126176,117440,8736,6.9
Rapides,6/1/1991,57146,52981,4165,7.3,126331,117639,8692,6.9
Rapides,7/1/1991,57197,53454,3743,6.5,126154,117568,8586,6.8
Rapides,8/1/1991,56707,52560,4147,7.3,126150,117484,8666,6.9
Rapides,9/1/1991,56273,52380,3893,6.9,126650,117928,8722,6.9
Rapides,10/1/1991,56236,52608,3628,6.5,126642,117800,8842,7
Rapides,11/1/1991,56102,52734,3368,6,126701,117770,8931,7
Rapides,12/1/1991,55673,52249,3424,6.2,126664,117466,9198,7.3
Rapides,1/1/1992,55521,51473,4048,7.3,127261,117978,9283,7.3
Rapides,2/1/1992,55005,51360,3645,6.6,127207,117753,9454,7.4
Rapides,3/1/1992,55407,51858,3549,6.4,127604,118144,9460,7.4
Rapides,4/1/1992,55783,52415,3368,6,127841,118426,9415,7.4
Rapides,5/1/1992,55394,52047,3347,6,128119,118375,9744,7.6
Rapides,6/1/1992,56876,52664,4212,7.4,128459,118419,10040,7.8
Rapides,7/1/1992,58630,54550,4080,7,128563,118713,9850,7.7
Rapides,8/1/1992,57711,53867,3844,6.7,128613,118826,9787,7.6
Rapides,9/1/1992,56703,53220,3483,6.1,128501,118720,9781,7.6
Rapides,10/1/1992,56585,53541,3044,5.4,128026,118628,9398,7.3
Rapides,11/1/1992,56209,53327,2882,5.1,128441,118876,9565,7.4
Rapides,12/1/1992,54972,52019,2953,5.4,128554,118997,9557,7.4
Rapides,1/1/1993,54813,51227,3586,6.5,128400,119075,9325,7.3
Rapides,2/1/1993,54875,51716,3159,5.8,128458,119275,9183,7.1
Rapides,3/1/1993,55401,52330,3071,5.5,128598,119542,9056,7
Rapides,4/1/1993,55650,52645,3005,5.4,128584,119474,9110,7.1
Rapides,5/1/1993,55820,52817,3003,5.4,129264,120115,9149,7.1
Rapides,6/1/1993,57061,53414,3647,6.4,129411,120290,9121,7
Rapides,7/1/1993,57675,54121,3554,6.2,129397,120467,8930,6.9
Rapides,8/1/1993,56677,53170,3507,6.2,129619,120856,8763,6.8
Rapides,9/1/1993,55767,52548,3219,5.8,129268,120554,8714,6.7
Rapides,10/1/1993,56366,53061,3305,5.9,129573,120823,8750,6.8
Rapides,11/1/1993,56766,53711,3055,5.4,129711,121169,8542,6.6
Rapides,12/1/1993,56122,53174,2948,5.3,129941,121464,8477,6.5
Rapides,1/1/1994,55605,51672,3933,7.1,130596,121966,8630,6.6
Rapides,2/1/1994,55512,51971,3541,6.4,130669,122086,8583,6.6
Rapides,3/1/1994,55779,52182,3597,6.4,130400,121930,8470,6.5
Rapides,4/1/1994,56288,52767,3521,6.3,130621,122290,8331,6.4
Rapides,5/1/1994,56752,53422,3330,5.9,130779,122864,7915,6.1
Rapides,6/1/1994,57708,53907,3801,6.6,130561,122634,7927,6.1
Rapides,7/1/1994,58620,54691,3929,6.7,130652,122706,7946,6.1
Rapides,8/1/1994,57793,54101,3692,6.4,131275,123342,7933,6
Rapides,9/1/1994,57416,53805,3611,6.3,131421,123687,7734,5.9
Rapides,10/1/1994,57634,54190,3444,6,131744,124112,7632,5.8
Rapides,11/1/1994,57771,54594,3177,5.5,131891,124516,7375,5.6
Rapides,12/1/1994,57512,54420,3092,5.4,131951,124721,7230,5.5
Rapides,1/1/1995,56926,53180,3746,6.6,132038,124663,7375,5.6
Rapides,2/1/1995,57349,54100,3249,5.7,132115,124928,7187,5.4
Rapides,3/1/1995,57616,54327,3289,5.7,132108,124955,7153,5.4
Rapides,4/1/1995,58330,55001,3329,5.7,132590,124945,7645,5.8
Rapides,5/1/1995,57973,54716,3257,5.6,131851,124421,7430,5.6
Rapides,6/1/1995,59126,55017,4109,6.9,131949,124522,7427,5.6
Rapides,7/1/1995,59682,55456,4226,7.1,132343,124816,7527,5.7
Rapides,8/1/1995,58628,54742,3886,6.6,132336,124852,7484,5.7
Rapides,9/1/1995,57865,54385,3480,6,132611,125133,7478,5.6
Rapides,10/1/1995,57803,54429,3374,5.8,132716,125388,7328,5.5
Rapides,11/1/1995,57715,54688,3027,5.2,132614,125188,7426,5.6
Rapides,12/1/1995,57244,54255,2989,5.2,132511,125088,7423,5.6
Rapides,1/1/1996,56910,53141,3769,6.6,132616,125125,7491,5.6
Rapides,2/1/1996,56711,53555,3156,5.6,132952,125639,7313,5.5
Rapides,3/1/1996,57620,54679,2941,5.1,133180,125862,7318,5.5
Rapides,4/1/1996,57627,54327,3300,5.7,133409,125994,7415,5.6
Rapides,5/1/1996,57710,54147,3563,6.2,133667,126244,7423,5.6
Rapides,6/1/1996,58551,54559,3992,6.8,133697,126602,7095,5.3
Rapides,7/1/1996,59511,55242,4269,7.2,134284,126947,7337,5.5
Rapides,8/1/1996,58856,54872,3984,6.8,134054,127172,6882,5.1
Rapides,9/1/1996,58072,54437,3635,6.3,134515,127536,6979,5.2
Rapides,10/1/1996,57822,54352,3470,6,134921,127890,7031,5.2
Rapides,11/1/1996,57784,54511,3273,5.7,135007,127771,7236,5.4
Rapides,12/1/1996,57680,54513,3167,5.5,135113,127860,7253,5.4
Rapides,1/1/1997,57093,53343,3750,6.6,135456,128298,7158,5.3
Rapides,2/1/1997,56395,53271,3124,5.5,135400,128298,7102,5.2
Rapides,3/1/1997,57067,53795,3272,5.7,135891,128891,7000,5.2
Rapides,4/1/1997,56854,53905,2949,5.2,136016,129143,6873,5.1
Rapides,5/1/1997,56720,53673,3047,5.4,136119,129464,6655,4.9
Rapides,6/1/1997,58200,54274,3926,6.7,136211,129412,6799,5
Rapides,7/1/1997,58920,54889,4031,6.8,136477,129822,6655,4.9
Rapides,8/1/1997,57973,54431,3542,6.1,136618,130010,6608,4.8
Rapides,9/1/1997,57252,53896,3356,5.9,136675,130019,6656,4.9
Rapides,10/1/1997,57184,54143,3041,5.3,136633,130179,6454,4.7
Rapides,11/1/1997,57508,54676,2832,4.9,136961,130653,6308,4.6
Rapides,12/1/1997,57350,54592,2758,4.8,137155,130679,6476,4.7
Rapides,1/1/1998,56540,53263,3277,5.8,137095,130726,6368,4.6
Rapides,2/1/1998,56205,53722,2483,4.4,137112,130807,6306,4.6
Rapides,3/1/1998,56834,54010,2824,5,137236,130814,6422,4.7
Rapides,4/1/1998,57433,54863,2570,4.5,137150,131209,5941,4.3
Rapides,5/1/1998,57467,54569,2898,5,137372,131325,6047,4.4
Rapides,6/1/1998,58900,55232,3668,6.2,137455,131244,6212,4.5
Rapides,7/1/1998,59320,55763,3557,6,137588,131329,6259,4.5
Rapides,8/1/1998,59111,55719,3392,5.7,137570,131390,6179,4.5
Rapides,9/1/1998,58859,55726,3133,5.3,138286,131986,6300,4.6
Rapides,10/1/1998,58846,56154,2692,4.6,138279,131999,6280,4.5
Rapides,11/1/1998,58665,56206,2459,4.2,138381,132280,6100,4.4
Rapides,12/1/1998,58812,56449,2363,4,138634,132602,6032,4.4
Rapides,1/1/1999,58528,55695,2833,4.8,139003,133027,5976,4.3
Rapides,2/1/1999,58552,56150,2402,4.1,138967,132856,6111,4.4
Rapides,3/1/1999,58673,56445,2228,3.8,138730,132947,5783,4.2
Rapides,4/1/1999,59135,56947,2188,3.7,138959,132955,6004,4.3
Rapides,5/1/1999,59054,56829,2225,3.8,139107,133311,5796,4.2
Rapides,6/1/1999,60408,57521,2887,4.8,139329,133378,5951,4.3
Rapides,7/1/1999,60728,57758,2970,4.9,139439,133414,6025,4.3
Rapides,8/1/1999,60035,57304,2731,4.5,139430,133591,5838,4.2
Rapides,9/1/1999,59900,57147,2753,4.6,139622,133707,5915,4.2
Rapides,10/1/1999,60034,57546,2488,4.1,139771,133993,5778,4.1
Rapides,11/1/1999,59969,57678,2291,3.8,140025,134309,5716,4.1
Rapides,12/1/1999,59623,57403,2220,3.7,140177,134523,5653,4
Rapides,1/1/2000,55013,52118,2895,5.3,142267,136559,5708,4
Rapides,2/1/2000,54614,52042,2572,4.7,142456,136598,5858,4.1
Rapides,3/1/2000,54908,52170,2738,5,142434,136701,5733,4
Rapides,4/1/2000,55548,53134,2414,4.3,142751,137270,5481,3.8
Rapides,5/1/2000,55148,52401,2747,5,142388,136630,5758,4
Rapides,6/1/2000,55956,52536,3420,6.1,142591,136940,5651,4
Rapides,7/1/2000,56227,53006,3221,5.7,142278,136531,5747,4
Rapides,8/1/2000,55946,52712,3234,5.8,142514,136662,5853,4.1
Rapides,9/1/2000,55417,52333,3084,5.6,142518,136893,5625,3.9
Rapides,10/1/2000,55734,52831,2903,5.2,142622,137088,5534,3.9
Rapides,11/1/2000,55552,52646,2906,5.2,142962,137322,5639,3.9
Rapides,12/1/2000,55608,52791,2817,5.1,143248,137614,5634,3.9
Rapides,1/1/2001,54722,51266,3456,6.3,143800,137778,6023,4.2
Rapides,2/1/2001,54463,51473,2990,5.5,143701,137612,6089,4.2
Rapides,3/1/2001,54917,51733,3184,5.8,143924,137783,6141,4.3
Rapides,4/1/2001,55334,52331,3003,5.4,143569,137299,6271,4.4
Rapides,5/1/2001,55148,52144,3004,5.4,143318,137092,6226,4.3
Rapides,6/1/2001,56339,52632,3707,6.6,143357,136873,6484,4.5
Rapides,7/1/2001,56872,53526,3346,5.9,143654,137071,6583,4.6
Rapides,8/1/2001,56337,53089,3248,5.8,143284,136241,7042,4.9
Rapides,9/1/2001,55996,52706,3290,5.9,143989,136846,7142,5
Rapides,10/1/2001,55854,52636,3218,5.8,144086,136392,7694,5.3
Rapides,11/1/2001,56045,52701,3344,6,144240,136238,8003,5.5
Rapides,12/1/2001,55916,52642,3274,5.9,144305,136047,8258,5.7
Rapides,1/1/2002,54922,51275,3647,6.6,143883,135701,8182,5.7
Rapides,2/1/2002,54966,51860,3106,5.7,144653,136438,8215,5.7
Rapides,3/1/2002,55441,52256,3185,5.7,144481,136177,8304,5.7
Rapides,4/1/2002,55914,52790,3124,5.6,144725,136126,8599,5.9
Rapides,5/1/2002,55748,52588,3160,5.7,144938,136539,8399,5.8
Rapides,6/1/2002,57030,53149,3881,6.8,144808,136415,8393,5.8
Rapides,7/1/2002,57259,53691,3568,6.2,144803,136413,8390,5.8
Rapides,8/1/2002,57205,53826,3379,5.9,145009,136705,8304,5.7
Rapides,9/1/2002,56340,53030,3310,5.9,145552,137302,8251,5.7
Rapides,10/1/2002,56636,53496,3140,5.5,145314,137008,8307,5.7
Rapides,11/1/2002,56488,53226,3262,5.8,145041,136521,8520,5.9
Rapides,12/1/2002,56398,53142,3256,5.8,145066,136426,8640,6
Rapides,1/1/2003,55639,51984,3655,6.6,145937,137417,8520,5.8
Rapides,2/1/2003,55299,51993,3306,6,146100,137482,8618,5.9
Rapides,3/1/2003,55668,52120,3548,6.4,146022,137434,8588,5.9
Rapides,4/1/2003,56617,53246,3371,6,146474,137633,8842,6
Rapides,5/1/2003,56469,52951,3518,6.2,146500,137544,8957,6.1
Rapides,6/1/2003,57998,53376,4622,8,147056,137790,9266,6.3
Rapides,7/1/2003,56984,52777,4207,7.4,146485,137474,9011,6.2
Rapides,8/1/2003,56503,52708,3795,6.7,146445,137549,8896,6.1
Rapides,9/1/2003,55894,52410,3484,6.2,146530,137609,8921,6.1
Rapides,10/1/2003,56189,53059,3130,5.6,146716,137984,8732,6
Rapides,11/1/2003,56252,53232,3020,5.4,147000,138424,8576,5.8
Rapides,12/1/2003,55671,52771,2900,5.2,146729,138411,8317,5.7
Rapides,1/1/2004,54357,51003,3354,6.2,146842,138472,8370,5.7
Rapides,2/1/2004,54010,51071,2939,5.4,146709,138542,8167,5.6
Rapides,3/1/2004,54208,51180,3028,5.6,146944,138453,8491,5.8
Rapides,4/1/2004,55781,53005,2776,5,146850,138680,8170,5.6
Rapides,5/1/2004,55901,52946,2955,5.3,147065,138852,8212,5.6
Rapides,6/1/2004,57401,53710,3691,6.4,147460,139174,8286,5.6
Rapides,7/1/2004,57487,54138,3349,5.8,147692,139556,8136,5.5
Rapides,8/1/2004,57405,54560,2845,5,147564,139573,7990,5.4
Rapides,9/1/2004,57182,54272,2910,5.1,147415,139487,7927,5.4
Rapides,10/1/2004,57541,54751,2790,4.8,147793,139732,8061,5.5
Rapides,11/1/2004,57841,55056,2785,4.8,148162,140231,7932,5.4
Rapides,12/1/2004,57703,54959,2744,4.8,148059,140125,7934,5.4
Rapides,1/1/2005,57287,54028,3259,5.7,148029,140245,7784,5.3
Rapides,2/1/2005,56672,53644,3028,5.3,148364,140385,7980,5.4
Rapides,3/1/2005,56501,53628,2873,5.1,148391,140654,7737,5.2
Rapides,4/1/2005,57217,54532,2685,4.7,148926,141254,7672,5.2
Rapides,5/1/2005,57312,54417,2895,5.1,149261,141609,7651,5.1
Rapides,6/1/2005,58247,54622,3625,6.2,149238,141714,7524,5
Rapides,7/1/2005,58642,55301,3341,5.7,149432,142026,7406,5
Rapides,8/1/2005,58220,55032,3188,5.5,149779,142434,7345,4.9
Rapides,9/1/2005,64446,58926,5520,8.6,149954,142401,7553,5
Rapides,10/1/2005,65007,59960,5047,7.8,150001,142548,7453,5
Rapides,11/1/2005,64544,59479,5065,7.8,150065,142499,7566,5
Rapides,12/1/2005,61888,58943,2945,4.8,150030,142752,7279,4.9
Rapides,1/1/2006,60140,57671,2469,4.1,150214,143150,7064,4.7
Rapides,2/1/2006,59632,57648,1984,3.3,150641,143457,7184,4.8
Rapides,3/1/2006,60066,58032,2034,3.4,150813,143741,7072,4.7
Rapides,4/1/2006,60448,58449,1999,3.3,150881,143761,7120,4.7
Rapides,5/1/2006,60327,58144,2183,3.6,151069,144089,6980,4.6
Rapides,6/1/2006,61573,58764,2809,4.6,151354,144353,7001,4.6
Rapides,7/1/2006,61542,59104,2438,4,151377,144202,7175,4.7
Rapides,8/1/2006,60556,58114,2442,4,151716,144625,7091,4.7
Rapides,9/1/2006,60398,58079,2319,3.8,151662,144815,6847,4.5
Rapides,10/1/2006,60395,58105,2290,3.8,152041,145314,6727,4.4
Rapides,11/1/2006,60031,57728,2303,3.8,152406,145534,6872,4.5
Rapides,12/1/2006,59474,57306,2168,3.6,152732,145970,6762,4.4
Rapides,1/1/2007,59753,57107,2646,4.4,153144,146028,7116,4.6
Rapides,2/1/2007,59215,56962,2253,3.8,152983,146057,6927,4.5
Rapides,3/1/2007,59870,57616,2254,3.8,153051,146320,6731,4.4
Rapides,4/1/2007,59708,57495,2213,3.7,152435,145586,6850,4.5
Rapides,5/1/2007,59670,57226,2444,4.1,152670,145903,6766,4.4
Rapides,6/1/2007,60544,57580,2964,4.9,153041,146063,6979,4.6
Rapides,7/1/2007,60713,57904,2809,4.6,153054,145905,7149,4.7
Rapides,8/1/2007,60030,57518,2512,4.2,152749,145682,7067,4.6
Rapides,9/1/2007,59995,57518,2477,4.1,153414,146244,7170,4.7
Rapides,10/1/2007,60338,58231,2107,3.5,153183,145946,7237,4.7
Rapides,11/1/2007,60718,58549,2169,3.6,153835,146595,7240,4.7
Rapides,12/1/2007,60318,58071,2247,3.7,153918,146273,7645,5
Rapides,1/1/2008,61415,58849,2566,4.2,154063,146378,7685,5
Rapides,2/1/2008,61064,58880,2184,3.6,153653,146156,7497,4.9
Rapides,3/1/2008,61873,59493,2380,3.8,153908,146086,7822,5.1
Rapides,4/1/2008,61673,59584,2089,3.4,153769,146132,7637,5
Rapides,5/1/2008,61925,59495,2430,3.9,154303,145908,8395,5.4
Rapides,6/1/2008,62979,59834,3145,5,154313,145737,8575,5.6
Rapides,7/1/2008,63245,60213,3032,4.8,154469,145532,8937,5.8
Rapides,8/1/2008,62462,59435,3027,4.8,154641,145203,9438,6.1
Rapides,9/1/2008,61967,59325,2642,4.3,154570,145076,9494,6.1
Rapides,10/1/2008,62179,59202,2977,4.8,154876,144802,10074,6.5
Rapides,11/1/2008,62242,59249,2993,4.8,154639,144100,10538,6.8
Rapides,12/1/2008,61485,58359,3126,5.1,154655,143369,11286,7.3
Rapides,1/1/2009,60706,57075,3631,6,154210,142152,12058,7.8
Rapides,2/1/2009,60544,56910,3634,6,154538,141640,12898,8.3
Rapides,3/1/2009,60719,56976,3743,6.2,154133,140707,13426,8.7
Rapides,4/1/2009,61209,57734,3475,5.7,154509,140656,13853,9
Rapides,5/1/2009,61466,57782,3684,6,154747,140248,14499,9.4
Rapides,6/1/2009,62725,58207,4518,7.2,154716,140009,14707,9.5
Rapides,7/1/2009,62779,58474,4305,6.9,154502,139901,14601,9.5
Rapides,8/1/2009,61660,57541,4119,6.7,154307,139492,14814,9.6
Rapides,9/1/2009,61032,57147,3885,6.4,153827,138818,15009,9.8
Rapides,10/1/2009,60831,57109,3722,6.1,153784,138432,15352,10
Rapides,11/1/2009,60693,57165,3528,5.8,153878,138659,15219,9.9
Rapides,12/1/2009,60150,56465,3685,6.1,153111,138013,15098,9.9
Rapides,1/1/2010,57854,53689,4165,7.2,153484,138438,15046,9.8
Rapides,2/1/2010,57803,54066,3737,6.5,153694,138581,15113,9.8
Rapides,3/1/2010,58311,54479,3832,6.6,153954,138751,15202,9.9
Rapides,4/1/2010,59144,55388,3756,6.4,154622,139297,15325,9.9
Rapides,5/1/2010,58664,54658,4006,6.8,154091,139241,14849,9.6
Rapides,6/1/2010,59547,54906,4641,7.8,153616,139141,14474,9.4
Rapides,7/1/2010,59713,55191,4522,7.6,153691,139179,14512,9.4
Rapides,8/1/2010,59444,54879,4565,7.7,154086,139438,14648,9.5
Rapides,9/1/2010,59176,54838,4338,7.3,153975,139396,14579,9.5
Rapides,10/1/2010,59435,55179,4256,7.2,153635,139119,14516,9.4
Rapides,11/1/2010,59369,55142,4227,7.1,154125,139044,15081,9.8
Rapides,12/1/2010,58821,54737,4084,6.9,153650,139301,14348,9.3
Rapides,1/1/2011,58185,53688,4497,7.7,153263,139250,14013,9.1
Rapides,2/1/2011,58042,53893,4149,7.1,153214,139394,13820,9
Rapides,3/1/2011,58096,53968,4128,7.1,153376,139639,13737,9
Rapides,4/1/2011,58656,54741,3915,6.7,153543,139586,13957,9.1
Rapides,5/1/2011,58382,54304,4078,7,153479,139624,13855,9
Rapides,6/1/2011,59258,54492,4766,8,153346,139384,13962,9.1
Rapides,7/1/2011,59097,54496,4601,7.8,153288,139524,13763,9
Rapides,8/1/2011,58552,54284,4268,7.3,153760,139942,13818,9
Rapides,9/1/2011,58543,54322,4221,7.2,154131,140183,13948,9
Rapides,10/1/2011,58543,54428,4115,7,153961,140368,13594,8.8
Rapides,11/1/2011,58484,54634,3850,6.6,154128,140826,13302,8.6
Rapides,12/1/2011,58282,54492,3790,6.5,153995,140902,13093,8.5
Rapides,1/1/2012,57452,53225,4227,7.4,154381,141584,12797,8.3
Rapides,2/1/2012,57394,53452,3942,6.9,154671,141858,12813,8.3
Rapides,3/1/2012,57698,53878,3820,6.6,154749,142036,12713,8.2
Rapides,4/1/2012,57768,54182,3586,6.2,154545,141899,12646,8.2
Rapides,5/1/2012,57713,53844,3869,6.7,154866,142206,12660,8.2
Rapides,6/1/2012,58711,54177,4534,7.7,155083,142391,12692,8.2
Rapides,7/1/2012,58591,54238,4353,7.4,154948,142292,12656,8.2
Rapides,8/1/2012,57276,53366,3910,6.8,154763,142291,12471,8.1
Rapides,9/1/2012,57031,53495,3536,6.2,155160,143044,12115,7.8
Rapides,10/1/2012,57348,53881,3467,6,155554,143431,12124,7.8
Rapides,11/1/2012,56852,53673,3179,5.6,155338,143333,12005,7.7
Rapides,12/1/2012,56920,53311,3609,6.3,155628,143330,12298,7.9
Rapides,1/1/2013,56863,52560,4303,7.6,155763,143292,12471,8
Rapides,2/1/2013,56654,52958,3696,6.5,155312,143362,11950,7.7
Rapides,3/1/2013,56896,53282,3614,6.4,155005,143316,11689,7.5
Rapides,4/1/2013,57214,53647,3567,6.2,155394,143635,11760,7.6
Rapides,5/1/2013,57359,53529,3830,6.7,155536,143882,11654,7.5
Rapides,6/1/2013,58259,53727,4532,7.8,155749,143999,11751,7.5
Rapides,7/1/2013,58240,54018,4222,7.2,155599,144264,11335,7.3
Rapides,8/1/2013,57430,53509,3921,6.8,155605,144326,11279,7.2
Rapides,9/1/2013,57303,53593,3710,6.5,155687,144418,11270,7.2
Rapides,10/1/2013,56821,53332,3489,6.1,154673,143537,11136,7.2
Rapides,11/1/2013,56852,53665,3187,5.6,155265,144479,10787,6.9
Rapides,12/1/2013,56776,53833,2943,5.2,155182,144778,10404,6.7
Rapides,1/1/2014,56451,53146,3305,5.9,155352,145150,10202,6.6
Rapides,2/1/2014,56478,53344,3134,5.5,155483,145134,10349,6.7
Rapides,3/1/2014,57063,53805,3258,5.7,156028,145648,10380,6.7
Rapides,4/1/2014,57178,54102,3076,5.4,155369,145667,9702,6.2
Rapides,5/1/2014,57492,53895,3597,6.3,155684,145825,9859,6.3
Rapides,6/1/2014,58426,54255,4171,7.1,155707,146247,9460,6.1
Rapides,7/1/2014,58618,54263,4355,7.4,156007,146399,9608,6.2
Rapides,8/1/2014,58235,53893,4342,7.5,156130,146530,9599,6.1
Rapides,9/1/2014,58110,53950,4160,7.2,156040,146778,9262,5.9
Rapides,10/1/2014,58176,54164,4012,6.9,156417,147427,8990,5.7
Rapides,11/1/2014,58406,54369,4037,6.9,156494,147404,9090,5.8
Rapides,12/1/2014,58060,54217,3843,6.6,156332,147615,8717,5.6
Rapides,1/1/2015,58093,53825,4268,7.3,157030,148145,8885,5.7
Rapides,2/1/2015,58061,54198,3863,6.7,156644,148045,8599,5.5
Rapides,3/1/2015,58243,54441,3802,6.5,156643,148128,8515,5.4
Rapides,4/1/2015,58316,54710,3606,6.2,157060,148511,8550,5.4
Rapides,5/1/2015,58285,54417,3868,6.6,157651,148817,8834,5.6
Rapides,6/1/2015,58866,54715,4151,7.1,157062,148816,8247,5.3
Rapides,7/1/2015,58499,54580,3919,6.7,156997,148830,8167,5.2
Rapides,8/1/2015,57618,53952,3666,6.4,157172,149181,7992,5.1
Rapides,9/1/2015,57260,53674,3586,6.3,156733,148826,7907,5
Rapides,10/1/2015,57340,53885,3455,6,157167,149246,7922,5
Rapides,11/1/2015,57129,53935,3194,5.6,157463,149463,8000,5.1
Rapides,12/1/2015,57088,54043,3045,5.3,158035,150128,7907,5
Rapides,1/1/2016,57321,53808,3513,6.1,158280,150653,7627,4.8
Rapides,2/1/2016,57347,54059,3288,5.7,158640,150939,7702,4.9
Rapides,3/1/2016,57732,54350,3382,5.9,159179,151218,7961,5
Rapides,4/1/2016,57705,54505,3200,5.5,159141,151074,8067,5.1
Rapides,5/1/2016,57515,54148,3367,5.9,158784,151132,7652,4.8
Rapides,6/1/2016,58424,54377,4047,6.9,158967,151223,7744,4.9
Rapides,7/1/2016,58380,54392,3988,6.8,159194,151554,7641,4.8
Rapides,8/1/2016,57245,53467,3778,6.6,159562,151779,7784,4.9
Rapides,9/1/2016,56987,53241,3746,6.6,159714,151761,7953,5
Rapides,10/1/2016,56528,53109,3419,6,159605,151793,7811,4.9
Rapides,11/1/2016,56199,52960,3239,5.8,159506,151954,7553,4.7
Rapides,12/1/2016,55726,52526,3200,5.7,159678,152157,7521,4.7
Rapides,1/1/2017,55527,51908,3619,6.5,159620,152152,7468,4.7
Rapides,2/1/2017,55525,52146,3379,6.1,159859,152480,7379,4.6
Rapides,3/1/2017,55762,52552,3210,5.8,160137,153065,7073,4.4
Rapides,4/1/2017,56286,53156,3130,5.6,160345,153255,7089,4.4
Rapides,5/1/2017,55787,52601,3186,5.7,160068,153069,7000,4.4
Rapides,6/1/2017,56655,53105,3550,6.3,160192,153318,6873,4.3
Rapides,7/1/2017,56861,53412,3449,6.1,160462,153569,6892,4.3
Rapides,8/1/2017,56229,52914,3315,5.9,160586,153503,7082,4.4
Rapides,9/1/2017,56429,53381,3048,5.4,161140,154286,6854,4.3
Rapides,10/1/2017,55817,53183,2634,4.7,160309,153609,6700,4.2
Rapides,11/1/2017,55740,53132,2608,4.7,160579,153805,6774,4.2
Rapides,12/1/2017,55561,53001,2560,4.6,160535,153904,6632,4.1
Rapides,1/1/2018,55076,52194,2882,5.2,160914,154425,6489,4
Rapides,2/1/2018,55331,52627,2704,4.9,161778,155197,6581,4.1
Rapides,3/1/2018,55490,52735,2755,5,161686,155214,6472,4
Rapides,4/1/2018,55828,53179,2649,4.7,161771,155312,6459,4
Rapides,5/1/2018,55483,52685,2798,5,161848,155652,6196,3.8
Rapides,6/1/2018,56391,52836,3555,6.3,162210,155762,6447,4
Rapides,7/1/2018,56482,53148,3334,5.9,162341,156146,6195,3.8
Rapides,8/1/2018,55226,52143,3083,5.6,161660,155504,6156,3.8
Rapides,9/1/2018,54906,52041,2865,5.2,162087,156015,6073,3.7
Rapides,10/1/2018,55010,52225,2785,5.1,162602,156391,6211,3.8
Rapides,11/1/2018,54995,52351,2644,4.8,162836,156721,6115,3.8
Rapides,12/1/2018,54650,52025,2625,4.8,163206,156817,6389,3.9
Rapides,1/1/2019,54608,51581,3027,5.5,162963,156487,6475,4
Rapides,2/1/2019,54596,52074,2522,4.6,162999,156863,6136,3.8
Rapides,3/1/2019,54628,52259,2369,4.3,162904,156701,6202,3.8
Rapides,4/1/2019,54751,52567,2184,4,162586,156625,5961,3.7
Rapides,5/1/2019,54610,52135,2475,4.5,162751,156821,5930,3.6
Rapides,6/1/2019,55564,52495,3069,5.5,163168,157232,5935,3.6
Rapides,7/1/2019,55782,52710,3072,5.5,163590,157529,6061,3.7
Rapides,8/1/2019,55199,52271,2928,5.3,163774,157829,5945,3.6
Rapides,9/1/2019,55207,52470,2737,5,164092,158339,5753,3.5
Rapides,10/1/2019,55039,52355,2684,4.9,164416,158545,5871,3.6
Rapides,11/1/2019,54961,52350,2611,4.8,164496,158629,5868,3.6
Rapides,12/1/2019,54657,52145,2512,4.6,164699,158845,5853,3.6
Rapides,1/1/2020,54257,51512,2745,5.1,164377,158508,5869,3.6
Rapides,2/1/2020,53848,51680,2168,4,164467,158714,5753,3.5
Rapides,3/1/2020,54739,51055,3684,6.7,162559,155353,7206,4.4
Rapides,4/1/2020,51429,46918,4511,8.8,156269,133185,23084,14.8
Rapides,5/1/2020,52615,47942,4673,8.9,158101,137173,20929,13.2
Rapides,6/1/2020,54394,49891,4503,8.3,159994,142342,17652,11
Rapides,7/1/2020,55195,50802,4393,8,160132,143779,16352,10.2
Rapides,8/1/2020,54622,50986,3636,6.7,160706,147245,13461,8.4
Rapides,9/1/2020,54913,51219,3694,6.7,160174,147620,12554,7.8
Rapides,10/1/2020,55730,52406,3324,6,161003,149931,11072,6.9
Rapides,11/1/2020,55179,52267,2912,5.3,160629,149934,10694,6.7
Rapides,12/1/2020,54997,52048,2949,5.4,160745,149975,10770,6.7
Rapides,1/1/2021,54557,51612,2945,5.4,160088,149852,10236,6.4
Rapides,2/1/2021,54630,51941,2689,4.9,160184,150189,9995,6.2
Rapides,3/1/2021,54778,52263,2515,4.6,160400,150644,9756,6.1
Rapides,4/1/2021,54874,52486,2388,4.4,160843,151081,9762,6.1
Rapides,5/1/2021,54703,52245,2458,4.5,160800,151535,9266,5.8
Rapides,6/1/2021,55501,52640,2861,5.2,161197,151734,9462,5.9
Rapides,7/1/2021,55781,53249,2532,4.5,161504,152773,8731,5.4
Rapides,8/1/2021,54673,52405,2268,4.1,161527,153250,8276,5.1
Rapides,9/1/2021,55867,53833,2034,3.6,161495,153843,7652,4.7
Rapides,10/1/2021,54680,52812,1868,3.4,161754,154475,7279,4.5
Rapides,11/1/2021,54806,53123,1683,3.1,162281,155530,6751,4.2
Rapides,12/1/2021,54703,53205,1498,2.7,162497,156099,6398,3.9
Rapides,1/1/2022,54374,52487,1887,3.5,163627,157115,6512,4
Rapides,2/1/2022,54643,52942,1701,3.1,163899,157598,6301,3.8
Rapides,3/1/2022,55201,53548,1653,3,164220,158206,6014,3.7
Rapides,4/1/2022,55124,53570,1554,2.8,163893,157891,6002,3.7
Rapides,5/1/2022,54812,53115,1697,3.1,164362,158378,5983,3.6
Rapides,6/1/2022,55906,53651,2255,4,164046,158094,5951,3.6
Rapides,7/1/2022,56950,54882,2068,3.6,164026,158258,5768,3.5
Rapides,8/1/2022,55273,53320,1953,3.5,164654,158735,5919,3.6
Rapides,9/1/2022,55073,53245,1828,3.3,164602,158810,5792,3.5
Rapides,10/1/2022,54696,53006,1690,3.1,164648,158684,5964,3.6
Rapides,11/1/2022,54560,52932,1628,3,164450,158507,5943,3.6
Rapides,12/1/2022,54617,52966,1651,3,165025,159259,5766,3.5
Rapides,1/1/2023,53759,51862,1897,3.5,165964,160217,5747,3.5
Rapides,2/1/2023,53959,52162,1797,3.3,166358,160395,5962,3.6
Rapides,3/1/2023,54480,52798,1682,3.1,166651,160812,5839,3.5
Rapides,4/1/2023,54372,52820,1552,2.9,166725,160974,5751,3.4
Rapides,5/1/2023,54258,52428,1830,3.4,166886,160796,6089,3.6
Rapides,6/1/2023,54954,52752,2202,4,166937,160979,5958,3.6
Rapides,7/1/2023,55346,53495,1851,3.3,167103,161183,5920,3.5
Rapides,8/1/2023,54582,52631,1951,3.6,167759,161475,6284,3.7
Rapides,9/1/2023,54779,52658,2121,3.9,167767,161442,6326,3.8
Rapides,10/1/2023,54891,52758,2133,3.9,167690,161211,6479,3.9
Rapides,11/1/2023,54829,52802,2027,3.7,168140,161886,6254,3.7
Rapides,12/1/2023,54537,52470,2067,3.8,167439,161124,6315,3.8
Rapides,1/1/2024,54507,52243,2264,4.2,167339,161190,6149,3.7
Rapides,2/1/2024,54620,52394,2226,4.1,167475,161013,6462,3.9
Rapides,3/1/2024,54990,52881,2109,3.8,167922,161425,6497,3.9
Rapides,4/1/2024,54982,53100,1882,3.4,167988,161495,6492,3.9
Rapides,5/1/2024,54497,52514,1983,3.6,167799,161164,6635,4
Rapides,6/1/2024,55519,52957,2562,4.6,168005,161155,6849,4.1
Rapides,7/1/2024,55953,53503,2450,4.4,168315,161219,7097,4.2
Rapides,8/1/2024,55244,52712,2532,4.6,168496,161425,7071,4.2
Rapides,9/1/2024,55231,52770,2461,4.5,168703,161802,6901,4.1
Rapides,10/1/2024,55212,52749,2463,4.5,168428,161456,6972,4.1
Rapides,11/1/2024,55076,52728,2348,4.3,168304,161183,7121,4.2
Rapides,12/1/2024,54902,52717,2185,4,168547,161661,6886,4.1
Rapides,1/1/2025,54811,52653,2158,3.9,170744,163895,6849,4
Rapides,2/1/2025,54917,52818,2099,3.8,170359,163307,7052,4.1
Red River,1/1/1990,3630,3128,502,13.8,125833,119081,6752,5.4
Red River,2/1/1990,3429,3130,299,8.7,125710,119059,6651,5.3
Red River,3/1/1990,3629,3341,288,7.9,125801,119203,6598,5.2
Red River,4/1/1990,3609,3300,309,8.6,125649,118852,6797,5.4
Red River,5/1/1990,3635,3313,322,8.9,125893,119151,6742,5.4
Red River,6/1/1990,3610,3261,349,9.7,125573,118983,6590,5.2
Red River,7/1/1990,3772,3472,300,8,125732,118810,6922,5.5
Red River,8/1/1990,3758,3445,313,8.3,125990,118802,7188,5.7
Red River,9/1/1990,3796,3521,275,7.2,125892,118524,7368,5.9
Red River,10/1/1990,3824,3565,259,6.8,125995,118536,7459,5.9
Red River,11/1/1990,3730,3510,220,5.9,126070,118306,7764,6.2
Red River,12/1/1990,3629,3384,245,6.8,126142,118241,7901,6.3
Red River,1/1/1991,3944,3353,591,15,125955,117940,8015,6.4
Red River,2/1/1991,3660,3341,319,8.7,126020,117755,8265,6.6
Red River,3/1/1991,3721,3380,341,9.2,126238,117652,8586,6.8
Red River,4/1/1991,3730,3443,287,7.7,126548,118109,8439,6.7
Red River,5/1/1991,3842,3201,641,16.7,126176,117440,8736,6.9
Red River,6/1/1991,3829,3182,647,16.9,126331,117639,8692,6.9
Red River,7/1/1991,3840,3244,596,15.5,126154,117568,8586,6.8
Red River,8/1/1991,3828,3274,554,14.5,126150,117484,8666,6.9
Red River,9/1/1991,3797,3287,510,13.4,126650,117928,8722,6.9
Red River,10/1/1991,3723,3286,437,11.7,126642,117800,8842,7
Red River,11/1/1991,3671,3284,387,10.5,126701,117770,8931,7
Red River,12/1/1991,3631,3236,395,10.9,126664,117466,9198,7.3
Red River,1/1/1992,3707,3206,501,13.5,127261,117978,9283,7.3
Red River,2/1/1992,3698,3197,501,13.5,127207,117753,9454,7.4
Red River,3/1/1992,3761,3263,498,13.2,127604,118144,9460,7.4
Red River,4/1/1992,3571,3177,394,11,127841,118426,9415,7.4
Red River,5/1/1992,3592,3224,368,10.2,128119,118375,9744,7.6
Red River,6/1/1992,3750,3305,445,11.9,128459,118419,10040,7.8
Red River,7/1/1992,3885,3541,344,8.9,128563,118713,9850,7.7
Red River,8/1/1992,3820,3472,348,9.1,128613,118826,9787,7.6
Red River,9/1/1992,3905,3537,368,9.4,128501,118720,9781,7.6
Red River,10/1/1992,3824,3505,319,8.3,128026,118628,9398,7.3
Red River,11/1/1992,3881,3585,296,7.6,128441,118876,9565,7.4
Red River,12/1/1992,3774,3482,292,7.7,128554,118997,9557,7.4
Red River,1/1/1993,3551,3178,373,10.5,128400,119075,9325,7.3
Red River,2/1/1993,3645,3313,332,9.1,128458,119275,9183,7.1
Red River,3/1/1993,3700,3371,329,8.9,128598,119542,9056,7
Red River,4/1/1993,3691,3361,330,8.9,128584,119474,9110,7.1
Red River,5/1/1993,3732,3412,320,8.6,129264,120115,9149,7.1
Red River,6/1/1993,3779,3431,348,9.2,129411,120290,9121,7
Red River,7/1/1993,3799,3470,329,8.7,129397,120467,8930,6.9
Red River,8/1/1993,3780,3477,303,8,129619,120856,8763,6.8
Red River,9/1/1993,3786,3486,300,7.9,129268,120554,8714,6.7
Red River,10/1/1993,3827,3510,317,8.3,129573,120823,8750,6.8
Red River,11/1/1993,3836,3518,318,8.3,129711,121169,8542,6.6
Red River,12/1/1993,3818,3516,302,7.9,129941,121464,8477,6.5
Red River,1/1/1994,3868,3481,387,10,130596,121966,8630,6.6
Red River,2/1/1994,3833,3486,347,9.1,130669,122086,8583,6.6
Red River,3/1/1994,3900,3546,354,9.1,130400,121930,8470,6.5
Red River,4/1/1994,3820,3493,327,8.6,130621,122290,8331,6.4
Red River,5/1/1994,3810,3483,327,8.6,130779,122864,7915,6.1
Red River,6/1/1994,3850,3463,387,10.1,130561,122634,7927,6.1
Red River,7/1/1994,3753,3391,362,9.6,130652,122706,7946,6.1
Red River,8/1/1994,3788,3431,357,9.4,131275,123342,7933,6
Red River,9/1/1994,3806,3454,352,9.2,131421,123687,7734,5.9
Red River,10/1/1994,3831,3505,326,8.5,131744,124112,7632,5.8
Red River,11/1/1994,3839,3520,319,8.3,131891,124516,7375,5.6
Red River,12/1/1994,3797,3491,306,8.1,131951,124721,7230,5.5
Red River,1/1/1995,3712,3382,330,8.9,132038,124663,7375,5.6
Red River,2/1/1995,3756,3430,326,8.7,132115,124928,7187,5.4
Red River,3/1/1995,3786,3440,346,9.1,132108,124955,7153,5.4
Red River,4/1/1995,4305,3413,892,20.7,132590,124945,7645,5.8
Red River,5/1/1995,3719,3397,322,8.7,131851,124421,7430,5.6
Red River,6/1/1995,3771,3430,341,9,131949,124522,7427,5.6
Red River,7/1/1995,3778,3483,295,7.8,132343,124816,7527,5.7
Red River,8/1/1995,3735,3460,275,7.4,132336,124852,7484,5.7
Red River,9/1/1995,3746,3445,301,8,132611,125133,7478,5.6
Red River,10/1/1995,3837,3537,300,7.8,132716,125388,7328,5.5
Red River,11/1/1995,3811,3484,327,8.6,132614,125188,7426,5.6
Red River,12/1/1995,3734,3376,358,9.6,132511,125088,7423,5.6
Red River,1/1/1996,3714,3223,491,13.2,132616,125125,7491,5.6
Red River,2/1/1996,3653,3236,417,11.4,132952,125639,7313,5.5
Red River,3/1/1996,4300,3274,1026,23.9,133180,125862,7318,5.5
Red River,4/1/1996,3684,3285,399,10.8,133409,125994,7415,5.6
Red River,5/1/1996,3685,3274,411,11.2,133667,126244,7423,5.6
Red River,6/1/1996,3746,3324,422,11.3,133697,126602,7095,5.3
Red River,7/1/1996,3723,3321,402,10.8,134284,126947,7337,5.5
Red River,8/1/1996,3623,3258,365,10.1,134054,127172,6882,5.1
Red River,9/1/1996,3726,3335,391,10.5,134515,127536,6979,5.2
Red River,10/1/1996,3981,3395,586,14.7,134921,127890,7031,5.2
Red River,11/1/1996,3690,3372,318,8.6,135007,127771,7236,5.4
Red River,12/1/1996,3540,3259,281,7.9,135113,127860,7253,5.4
Red River,1/1/1997,3151,2826,325,10.3,135456,128298,7158,5.3
Red River,2/1/1997,3225,2531,694,21.5,135400,128298,7102,5.2
Red River,3/1/1997,3412,2642,770,22.6,135891,128891,7000,5.2
Red River,4/1/1997,3482,2724,758,21.8,136016,129143,6873,5.1
Red River,5/1/1997,3622,2733,889,24.5,136119,129464,6655,4.9
Red River,6/1/1997,3827,2746,1081,28.2,136211,129412,6799,5
Red River,7/1/1997,3824,2892,932,24.4,136477,129822,6655,4.9
Red River,8/1/1997,3706,2834,872,23.5,136618,130010,6608,4.8
Red River,9/1/1997,3680,2801,879,23.9,136675,130019,6656,4.9
Red River,10/1/1997,3552,2784,768,21.6,136633,130179,6454,4.7
Red River,11/1/1997,3467,2773,694,20,136961,130653,6308,4.6
Red River,12/1/1997,3369,2741,628,18.6,137155,130679,6476,4.7
Red River,1/1/1998,3418,2751,667,19.5,137095,130726,6368,4.6
Red River,2/1/1998,3260,2742,518,15.9,137112,130807,6306,4.6
Red River,3/1/1998,3269,2739,530,16.2,137236,130814,6422,4.7
Red River,4/1/1998,3334,2895,439,13.2,137150,131209,5941,4.3
Red River,5/1/1998,3358,2934,424,12.6,137372,131325,6047,4.4
Red River,6/1/1998,3411,2954,457,13.4,137455,131244,6212,4.5
Red River,7/1/1998,3325,2937,388,11.7,137588,131329,6259,4.5
Red River,8/1/1998,3272,2897,375,11.5,137570,131390,6179,4.5
Red River,9/1/1998,3236,2876,360,11.1,138286,131986,6300,4.6
Red River,10/1/1998,3236,2915,321,9.9,138279,131999,6280,4.5
Red River,11/1/1998,3229,2952,277,8.6,138381,132280,6100,4.4
Red River,12/1/1998,3185,2898,287,9,138634,132602,6032,4.4
Red River,1/1/1999,3267,2935,332,10.2,139003,133027,5976,4.3
Red River,2/1/1999,3193,2900,293,9.2,138967,132856,6111,4.4
Red River,3/1/1999,3184,2909,275,8.6,138730,132947,5783,4.2
Red River,4/1/1999,3250,2978,272,8.4,138959,132955,6004,4.3
Red River,5/1/1999,3304,3029,275,8.3,139107,133311,5796,4.2
Red River,6/1/1999,3352,3063,289,8.6,139329,133378,5951,4.3
Red River,7/1/1999,3381,3141,240,7.1,139439,133414,6025,4.3
Red River,8/1/1999,3348,3126,222,6.6,139430,133591,5838,4.2
Red River,9/1/1999,3320,3079,241,7.3,139622,133707,5915,4.2
Red River,10/1/1999,3301,3093,208,6.3,139771,133993,5778,4.1
Red River,11/1/1999,3245,3065,180,5.5,140025,134309,5716,4.1
Red River,12/1/1999,3229,3043,186,5.8,140177,134523,5653,4
Red River,1/1/2000,3451,3233,218,6.3,142267,136559,5708,4
Red River,2/1/2000,3394,3197,197,5.8,142456,136598,5858,4.1
Red River,3/1/2000,3444,3233,211,6.1,142434,136701,5733,4
Red River,4/1/2000,3483,3287,196,5.6,142751,137270,5481,3.8
Red River,5/1/2000,3512,3294,218,6.2,142388,136630,5758,4
Red River,6/1/2000,3550,3280,270,7.6,142591,136940,5651,4
Red River,7/1/2000,3621,3370,251,6.9,142278,136531,5747,4
Red River,8/1/2000,3602,3352,250,6.9,142514,136662,5853,4.1
Red River,9/1/2000,3547,3281,266,7.5,142518,136893,5625,3.9
Red River,10/1/2000,3607,3361,246,6.8,142622,137088,5534,3.9
Red River,11/1/2000,3623,3324,299,8.3,142962,137322,5639,3.9
Red River,12/1/2000,3555,3325,230,6.5,143248,137614,5634,3.9
Red River,1/1/2001,3614,3239,375,10.4,143800,137778,6023,4.2
Red River,2/1/2001,3517,3279,238,6.8,143701,137612,6089,4.2
Red River,3/1/2001,3586,3318,268,7.5,143924,137783,6141,4.3
Red River,4/1/2001,3607,3323,284,7.9,143569,137299,6271,4.4
Red River,5/1/2001,3552,3286,266,7.5,143318,137092,6226,4.3
Red River,6/1/2001,3608,3318,290,8,143357,136873,6484,4.5
Red River,7/1/2001,3616,3350,266,7.4,143654,137071,6583,4.6
Red River,8/1/2001,3597,3344,253,7,143284,136241,7042,4.9
Red River,9/1/2001,3622,3343,279,7.7,143989,136846,7142,5
Red River,10/1/2001,3633,3349,284,7.8,144086,136392,7694,5.3
Red River,11/1/2001,3584,3322,262,7.3,144240,136238,8003,5.5
Red River,12/1/2001,3574,3252,322,9,144305,136047,8258,5.7
Red River,1/1/2002,3622,3292,330,9.1,143883,135701,8182,5.7
Red River,2/1/2002,3589,3322,267,7.4,144653,136438,8215,5.7
Red River,3/1/2002,3611,3338,273,7.6,144481,136177,8304,5.7
Red River,4/1/2002,3607,3322,285,7.9,144725,136126,8599,5.9
Red River,5/1/2002,3600,3322,278,7.7,144938,136539,8399,5.8
Red River,6/1/2002,3641,3326,315,8.7,144808,136415,8393,5.8
Red River,7/1/2002,3699,3414,285,7.7,144803,136413,8390,5.8
Red River,8/1/2002,3729,3446,283,7.6,145009,136705,8304,5.7
Red River,9/1/2002,3658,3394,264,7.2,145552,137302,8251,5.7
Red River,10/1/2002,3729,3459,270,7.2,145314,137008,8307,5.7
Red River,11/1/2002,3646,3342,304,8.3,145041,136521,8520,5.9
Red River,12/1/2002,3710,3339,371,10,145066,136426,8640,6
Red River,1/1/2003,3615,3273,342,9.5,145937,137417,8520,5.8
Red River,2/1/2003,3558,3239,319,9,146100,137482,8618,5.9
Red River,3/1/2003,3662,3279,383,10.5,146022,137434,8588,5.9
Red River,4/1/2003,3632,3310,322,8.9,146474,137633,8842,6
Red River,5/1/2003,3625,3295,330,9.1,146500,137544,8957,6.1
Red River,6/1/2003,3726,3312,414,11.1,147056,137790,9266,6.3
Red River,7/1/2003,3704,3321,383,10.3,146485,137474,9011,6.2
Red River,8/1/2003,3769,3356,413,11,146445,137549,8896,6.1
Red River,9/1/2003,3652,3332,320,8.8,146530,137609,8921,6.1
Red River,10/1/2003,3731,3427,304,8.1,146716,137984,8732,6
Red River,11/1/2003,3690,3393,297,8,147000,138424,8576,5.8
Red River,12/1/2003,3616,3321,295,8.2,146729,138411,8317,5.7
Red River,1/1/2004,3553,3191,362,10.2,146842,138472,8370,5.7
Red River,2/1/2004,3519,3209,310,8.8,146709,138542,8167,5.6
Red River,3/1/2004,3520,3168,352,10,146944,138453,8491,5.8
Red River,4/1/2004,3615,3290,325,9,146850,138680,8170,5.6
Red River,5/1/2004,3526,3174,352,10,147065,138852,8212,5.6
Red River,6/1/2004,3560,3159,401,11.3,147460,139174,8286,5.6
Red River,7/1/2004,3597,3231,366,10.2,147692,139556,8136,5.5
Red River,8/1/2004,3539,3224,315,8.9,147564,139573,7990,5.4
Red River,9/1/2004,3542,3205,337,9.5,147415,139487,7927,5.4
Red River,10/1/2004,3595,3248,347,9.7,147793,139732,8061,5.5
Red River,11/1/2004,3530,3210,320,9.1,148162,140231,7932,5.4
Red River,12/1/2004,3519,3219,300,8.5,148059,140125,7934,5.4
Red River,1/1/2005,3350,3005,345,10.3,148029,140245,7784,5.3
Red River,2/1/2005,3239,2949,290,9,148364,140385,7980,5.4
Red River,3/1/2005,3220,2938,282,8.8,148391,140654,7737,5.2
Red River,4/1/2005,3253,2990,263,8.1,148926,141254,7672,5.2
Red River,5/1/2005,3278,3006,272,8.3,149261,141609,7651,5.1
Red River,6/1/2005,3321,3019,302,9.1,149238,141714,7524,5
Red River,7/1/2005,3348,3048,300,9,149432,142026,7406,5
Red River,8/1/2005,3297,3010,287,8.7,149779,142434,7345,4.9
Red River,9/1/2005,3533,3208,325,9.2,149954,142401,7553,5
Red River,10/1/2005,3630,3331,299,8.2,150001,142548,7453,5
Red River,11/1/2005,3491,3205,286,8.2,150065,142499,7566,5
Red River,12/1/2005,3385,3156,229,6.8,150030,142752,7279,4.9
Red River,1/1/2006,3317,3112,205,6.2,150214,143150,7064,4.7
Red River,2/1/2006,3263,3097,166,5.1,150641,143457,7184,4.8
Red River,3/1/2006,3287,3120,167,5.1,150813,143741,7072,4.7
Red River,4/1/2006,3293,3122,171,5.2,150881,143761,7120,4.7
Red River,5/1/2006,3276,3101,175,5.3,151069,144089,6980,4.6
Red River,6/1/2006,3340,3124,216,6.5,151354,144353,7001,4.6
Red River,7/1/2006,3331,3129,202,6.1,151377,144202,7175,4.7
Red River,8/1/2006,3297,3100,197,6,151716,144625,7091,4.7
Red River,9/1/2006,3283,3091,192,5.8,151662,144815,6847,4.5
Red River,10/1/2006,3297,3104,193,5.9,152041,145314,6727,4.4
Red River,11/1/2006,3279,3092,187,5.7,152406,145534,6872,4.5
Red River,12/1/2006,3169,2930,239,7.5,152732,145970,6762,4.4
Red River,1/1/2007,3397,3169,228,6.7,153144,146028,7116,4.6
Red River,2/1/2007,3391,3199,192,5.7,152983,146057,6927,4.5
Red River,3/1/2007,3418,3231,187,5.5,153051,146320,6731,4.4
Red River,4/1/2007,3415,3227,188,5.5,152435,145586,6850,4.5
Red River,5/1/2007,3406,3204,202,5.9,152670,145903,6766,4.4
Red River,6/1/2007,3427,3199,228,6.7,153041,146063,6979,4.6
Red River,7/1/2007,3482,3242,240,6.9,153054,145905,7149,4.7
Red River,8/1/2007,3536,3306,230,6.5,152749,145682,7067,4.6
Red River,9/1/2007,3596,3359,237,6.6,153414,146244,7170,4.7
Red River,10/1/2007,3593,3372,221,6.2,153183,145946,7237,4.7
Red River,11/1/2007,3549,3310,239,6.7,153835,146595,7240,4.7
Red River,12/1/2007,3528,3272,256,7.3,153918,146273,7645,5
Red River,1/1/2008,3531,3292,239,6.8,154063,146378,7685,5
Red River,2/1/2008,3498,3306,192,5.5,153653,146156,7497,4.9
Red River,3/1/2008,3565,3364,201,5.6,153908,146086,7822,5.1
Red River,4/1/2008,3495,3321,174,5,153769,146132,7637,5
Red River,5/1/2008,3524,3293,231,6.6,154303,145908,8395,5.4
Red River,6/1/2008,3461,3169,292,8.4,154313,145737,8575,5.6
Red River,7/1/2008,3495,3171,324,9.3,154469,145532,8937,5.8
Red River,8/1/2008,3470,3179,291,8.4,154641,145203,9438,6.1
Red River,9/1/2008,3465,3186,279,8.1,154570,145076,9494,6.1
Red River,10/1/2008,3454,3177,277,8,154876,144802,10074,6.5
Red River,11/1/2008,3451,3184,267,7.7,154639,144100,10538,6.8
Red River,12/1/2008,3437,3101,336,9.8,154655,143369,11286,7.3
Red River,1/1/2009,3493,3102,391,11.2,154210,142152,12058,7.8
Red River,2/1/2009,3458,3110,348,10.1,154538,141640,12898,8.3
Red River,3/1/2009,3512,3150,362,10.3,154133,140707,13426,8.7
Red River,4/1/2009,3563,3219,344,9.7,154509,140656,13853,9
Red River,5/1/2009,3548,3210,338,9.5,154747,140248,14499,9.4
Red River,6/1/2009,3601,3241,360,10,154716,140009,14707,9.5
Red River,7/1/2009,3624,3265,359,9.9,154502,139901,14601,9.5
Red River,8/1/2009,3535,3219,316,8.9,154307,139492,14814,9.6
Red River,9/1/2009,3548,3251,297,8.4,153827,138818,15009,9.8
Red River,10/1/2009,3524,3243,281,8,153784,138432,15352,10
Red River,11/1/2009,3562,3272,290,8.1,153878,138659,15219,9.9
Red River,12/1/2009,3544,3252,292,8.2,153111,138013,15098,9.9
Red River,1/1/2010,3767,3438,329,8.7,153484,138438,15046,9.8
Red River,2/1/2010,3805,3511,294,7.7,153694,138581,15113,9.8
Red River,3/1/2010,3897,3614,283,7.3,153954,138751,15202,9.9
Red River,4/1/2010,4041,3761,280,6.9,154622,139297,15325,9.9
Red River,5/1/2010,4061,3762,299,7.4,154091,139241,14849,9.6
Red River,6/1/2010,4110,3772,338,8.2,153616,139141,14474,9.4
Red River,7/1/2010,4164,3819,345,8.3,153691,139179,14512,9.4
Red River,8/1/2010,4119,3788,331,8,154086,139438,14648,9.5
Red River,9/1/2010,4052,3709,343,8.5,153975,139396,14579,9.5
Red River,10/1/2010,4163,3834,329,7.9,153635,139119,14516,9.4
Red River,11/1/2010,4083,3754,329,8.1,154125,139044,15081,9.8
Red River,12/1/2010,4045,3729,316,7.8,153650,139301,14348,9.3
Red River,1/1/2011,4057,3726,331,8.2,153263,139250,14013,9.1
Red River,2/1/2011,4064,3763,301,7.4,153214,139394,13820,9
Red River,3/1/2011,4033,3738,295,7.3,153376,139639,13737,9
Red River,4/1/2011,4079,3804,275,6.7,153543,139586,13957,9.1
Red River,5/1/2011,4075,3790,285,7,153479,139624,13855,9
Red River,6/1/2011,4118,3781,337,8.2,153346,139384,13962,9.1
Red River,7/1/2011,4156,3855,301,7.2,153288,139524,13763,9
Red River,8/1/2011,4111,3815,296,7.2,153760,139942,13818,9
Red River,9/1/2011,4071,3788,283,7,154131,140183,13948,9
Red River,10/1/2011,4052,3771,281,6.9,153961,140368,13594,8.8
Red River,11/1/2011,4035,3759,276,6.8,154128,140826,13302,8.6
Red River,12/1/2011,3995,3719,276,6.9,153995,140902,13093,8.5
Red River,1/1/2012,3920,3639,281,7.2,154381,141584,12797,8.3
Red River,2/1/2012,3933,3670,263,6.7,154671,141858,12813,8.3
Red River,3/1/2012,3929,3670,259,6.6,154749,142036,12713,8.2
Red River,4/1/2012,3995,3739,256,6.4,154545,141899,12646,8.2
Red River,5/1/2012,4056,3772,284,7,154866,142206,12660,8.2
Red River,6/1/2012,4081,3755,326,8,155083,142391,12692,8.2
Red River,7/1/2012,4127,3811,316,7.7,154948,142292,12656,8.2
Red River,8/1/2012,3978,3701,277,7,154763,142291,12471,8.1
Red River,9/1/2012,3908,3630,278,7.1,155160,143044,12115,7.8
Red River,10/1/2012,3897,3642,255,6.5,155554,143431,12124,7.8
Red River,11/1/2012,3889,3647,242,6.2,155338,143333,12005,7.7
Red River,12/1/2012,3907,3635,272,7,155628,143330,12298,7.9
Red River,1/1/2013,3829,3515,314,8.2,155763,143292,12471,8
Red River,2/1/2013,3776,3491,285,7.5,155312,143362,11950,7.7
Red River,3/1/2013,3753,3483,270,7.2,155005,143316,11689,7.5
Red River,4/1/2013,3796,3538,258,6.8,155394,143635,11760,7.6
Red River,5/1/2013,3831,3559,272,7.1,155536,143882,11654,7.5
Red River,6/1/2013,3890,3582,308,7.9,155749,143999,11751,7.5
Red River,7/1/2013,3985,3688,297,7.5,155599,144264,11335,7.3
Red River,8/1/2013,3987,3705,282,7.1,155605,144326,11279,7.2
Red River,9/1/2013,3896,3609,287,7.4,155687,144418,11270,7.2
Red River,10/1/2013,3865,3588,277,7.2,154673,143537,11136,7.2
Red River,11/1/2013,3844,3584,260,6.8,155265,144479,10787,6.9
Red River,12/1/2013,3837,3605,232,6,155182,144778,10404,6.7
Red River,1/1/2014,3962,3709,253,6.4,155352,145150,10202,6.6
Red River,2/1/2014,3942,3703,239,6.1,155483,145134,10349,6.7
Red River,3/1/2014,3897,3651,246,6.3,156028,145648,10380,6.7
Red River,4/1/2014,3888,3661,227,5.8,155369,145667,9702,6.2
Red River,5/1/2014,3902,3649,253,6.5,155684,145825,9859,6.3
Red River,6/1/2014,4000,3720,280,7,155707,146247,9460,6.1
Red River,7/1/2014,4085,3786,299,7.3,156007,146399,9608,6.2
Red River,8/1/2014,4067,3753,314,7.7,156130,146530,9599,6.1
Red River,9/1/2014,4035,3706,329,8.2,156040,146778,9262,5.9
Red River,10/1/2014,3939,3625,314,8,156417,147427,8990,5.7
Red River,11/1/2014,3951,3637,314,7.9,156494,147404,9090,5.8
Red River,12/1/2014,3973,3673,300,7.6,156332,147615,8717,5.6
Red River,1/1/2015,3929,3620,309,7.9,157030,148145,8885,5.7
Red River,2/1/2015,3927,3645,282,7.2,156644,148045,8599,5.5
Red River,3/1/2015,3952,3663,289,7.3,156643,148128,8515,5.4
Red River,4/1/2015,3946,3678,268,6.8,157060,148511,8550,5.4
Red River,5/1/2015,3994,3714,280,7,157651,148817,8834,5.6
Red River,6/1/2015,4039,3746,293,7.3,157062,148816,8247,5.3
Red River,7/1/2015,3975,3683,292,7.3,156997,148830,8167,5.2
Red River,8/1/2015,3895,3629,266,6.8,157172,149181,7992,5.1
Red River,9/1/2015,3815,3562,253,6.6,156733,148826,7907,5
Red River,10/1/2015,3815,3572,243,6.4,157167,149246,7922,5
Red River,11/1/2015,3746,3524,222,5.9,157463,149463,8000,5.1
Red River,12/1/2015,3721,3517,204,5.5,158035,150128,7907,5
Red River,1/1/2016,3807,3575,232,6.1,158280,150653,7627,4.8
Red River,2/1/2016,3788,3566,222,5.9,158640,150939,7702,4.9
Red River,3/1/2016,3828,3608,220,5.7,159179,151218,7961,5
Red River,4/1/2016,3764,3558,206,5.5,159141,151074,8067,5.1
Red River,5/1/2016,3793,3588,205,5.4,158784,151132,7652,4.8
Red River,6/1/2016,3897,3651,246,6.3,158967,151223,7744,4.9
Red River,7/1/2016,3871,3629,242,6.3,159194,151554,7641,4.8
Red River,8/1/2016,3825,3580,245,6.4,159562,151779,7784,4.9
Red River,9/1/2016,3842,3587,255,6.6,159714,151761,7953,5
Red River,10/1/2016,3766,3527,239,6.3,159605,151793,7811,4.9
Red River,11/1/2016,3773,3555,218,5.8,159506,151954,7553,4.7
Red River,12/1/2016,3736,3528,208,5.6,159678,152157,7521,4.7
Red River,1/1/2017,3834,3605,229,6,159620,152152,7468,4.7
Red River,2/1/2017,3773,3560,213,5.6,159859,152480,7379,4.6
Red River,3/1/2017,3822,3616,206,5.4,160137,153065,7073,4.4
Red River,4/1/2017,3856,3656,200,5.2,160345,153255,7089,4.4
Red River,5/1/2017,3846,3659,187,4.9,160068,153069,7000,4.4
Red River,6/1/2017,3955,3741,214,5.4,160192,153318,6873,4.3
Red River,7/1/2017,3940,3725,215,5.5,160462,153569,6892,4.3
Red River,8/1/2017,3867,3665,202,5.2,160586,153503,7082,4.4
Red River,9/1/2017,3896,3688,208,5.3,161140,154286,6854,4.3
Red River,10/1/2017,3849,3664,185,4.8,160309,153609,6700,4.2
Red River,11/1/2017,3807,3632,175,4.6,160579,153805,6774,4.2
Red River,12/1/2017,3801,3633,168,4.4,160535,153904,6632,4.1
Red River,1/1/2018,3897,3704,193,5,160914,154425,6489,4
Red River,2/1/2018,3959,3777,182,4.6,161778,155197,6581,4.1
Red River,3/1/2018,3995,3827,168,4.2,161686,155214,6472,4
Red River,4/1/2018,4020,3857,163,4.1,161771,155312,6459,4
Red River,5/1/2018,3994,3822,172,4.3,161848,155652,6196,3.8
Red River,6/1/2018,4115,3894,221,5.4,162210,155762,6447,4
Red River,7/1/2018,4062,3861,201,4.9,162341,156146,6195,3.8
Red River,8/1/2018,4021,3836,185,4.6,161660,155504,6156,3.8
Red River,9/1/2018,4061,3889,172,4.2,162087,156015,6073,3.7
Red River,10/1/2018,4239,4076,163,3.8,162602,156391,6211,3.8
Red River,11/1/2018,4036,3883,153,3.8,162836,156721,6115,3.8
Red River,12/1/2018,4150,3985,165,4,163206,156817,6389,3.9
Red River,1/1/2019,3695,3509,186,5,162963,156487,6475,4
Red River,2/1/2019,3714,3557,157,4.2,162999,156863,6136,3.8
Red River,3/1/2019,3739,3589,150,4,162904,156701,6202,3.8
Red River,4/1/2019,3679,3534,145,3.9,162586,156625,5961,3.7
Red River,5/1/2019,3710,3543,167,4.5,162751,156821,5930,3.6
Red River,6/1/2019,3785,3574,211,5.6,163168,157232,5935,3.6
Red River,7/1/2019,3808,3585,223,5.9,163590,157529,6061,3.7
Red River,8/1/2019,3813,3603,210,5.5,163774,157829,5945,3.6
Red River,9/1/2019,3789,3603,186,4.9,164092,158339,5753,3.5
Red River,10/1/2019,3759,3563,196,5.2,164416,158545,5871,3.6
Red River,11/1/2019,3714,3527,187,5,164496,158629,5868,3.6
Red River,12/1/2019,3709,3519,190,5.1,164699,158845,5853,3.6
Red River,1/1/2020,3601,3400,201,5.6,164377,158508,5869,3.6
Red River,2/1/2020,3588,3415,173,4.8,164467,158714,5753,3.5
Red River,3/1/2020,3718,3423,295,7.9,162559,155353,7206,4.4
Red River,4/1/2020,3340,3124,216,6.5,156269,133185,23084,14.8
Red River,5/1/2020,3429,3178,251,7.3,158101,137173,20929,13.2
Red River,6/1/2020,3549,3283,266,7.5,159994,142342,17652,11
Red River,7/1/2020,3521,3256,265,7.5,160132,143779,16352,10.2
Red River,8/1/2020,3606,3358,248,6.9,160706,147245,13461,8.4
Red River,9/1/2020,3596,3341,255,7.1,160174,147620,12554,7.8
Red River,10/1/2020,3645,3424,221,6.1,161003,149931,11072,6.9
Red River,11/1/2020,3551,3342,209,5.9,160629,149934,10694,6.7
Red River,12/1/2020,3575,3364,211,5.9,160745,149975,10770,6.7
Red River,1/1/2021,3556,3342,214,6,160088,149852,10236,6.4
Red River,2/1/2021,3581,3379,202,5.6,160184,150189,9995,6.2
Red River,3/1/2021,3620,3426,194,5.4,160400,150644,9756,6.1
Red River,4/1/2021,3639,3469,170,4.7,160843,151081,9762,6.1
Red River,5/1/2021,3582,3415,167,4.7,160800,151535,9266,5.8
Red River,6/1/2021,3677,3478,199,5.4,161197,151734,9462,5.9
Red River,7/1/2021,3670,3491,179,4.9,161504,152773,8731,5.4
Red River,8/1/2021,3677,3524,153,4.2,161527,153250,8276,5.1
Red River,9/1/2021,3748,3607,141,3.8,161495,153843,7652,4.7
Red River,10/1/2021,3699,3565,134,3.6,161754,154475,7279,4.5
Red River,11/1/2021,3677,3564,113,3.1,162281,155530,6751,4.2
Red River,12/1/2021,3705,3599,106,2.9,162497,156099,6398,3.9
Red River,1/1/2022,3721,3588,133,3.6,163627,157115,6512,4
Red River,2/1/2022,3719,3595,124,3.3,163899,157598,6301,3.8
Red River,3/1/2022,3712,3593,119,3.2,164220,158206,6014,3.7
Red River,4/1/2022,3711,3605,106,2.9,163893,157891,6002,3.7
Red River,5/1/2022,3704,3588,116,3.1,164362,158378,5983,3.6
Red River,6/1/2022,3783,3627,156,4.1,164046,158094,5951,3.6
Red River,7/1/2022,3796,3658,138,3.6,164026,158258,5768,3.5
Red River,8/1/2022,3744,3611,133,3.6,164654,158735,5919,3.6
Red River,9/1/2022,3770,3640,130,3.4,164602,158810,5792,3.5
Red River,10/1/2022,3722,3596,126,3.4,164648,158684,5964,3.6
Red River,11/1/2022,3690,3571,119,3.2,164450,158507,5943,3.6
Red River,12/1/2022,3710,3596,114,3.1,165025,159259,5766,3.5
Red River,1/1/2023,3757,3617,140,3.7,165964,160217,5747,3.5
Red River,2/1/2023,3754,3622,132,3.5,166358,160395,5962,3.6
Red River,3/1/2023,3761,3647,114,3,166651,160812,5839,3.5
Red River,4/1/2023,3750,3641,109,2.9,166725,160974,5751,3.4
Red River,5/1/2023,3741,3618,123,3.3,166886,160796,6089,3.6
Red River,6/1/2023,3811,3667,144,3.8,166937,160979,5958,3.6
Red River,7/1/2023,3805,3668,137,3.6,167103,161183,5920,3.5
Red River,8/1/2023,3792,3657,135,3.6,167759,161475,6284,3.7
Red River,9/1/2023,3803,3658,145,3.8,167767,161442,6326,3.8
Red River,10/1/2023,3796,3657,139,3.7,167690,161211,6479,3.9
Red River,11/1/2023,3787,3648,139,3.7,168140,161886,6254,3.7
Red River,12/1/2023,3802,3652,150,3.9,167439,161124,6315,3.8
Red River,1/1/2024,3817,3663,154,4,167339,161190,6149,3.7
Red River,2/1/2024,3758,3609,149,4,167475,161013,6462,3.9
Red River,3/1/2024,3717,3571,146,3.9,167922,161425,6497,3.9
Red River,4/1/2024,3739,3601,138,3.7,167988,161495,6492,3.9
Red River,5/1/2024,3708,3553,155,4.2,167799,161164,6635,4
Red River,6/1/2024,3779,3608,171,4.5,168005,161155,6849,4.1
Red River,7/1/2024,3801,3621,180,4.7,168315,161219,7097,4.2
Red River,8/1/2024,3762,3584,178,4.7,168496,161425,7071,4.2
Red River,9/1/2024,3715,3537,178,4.8,168703,161802,6901,4.1
Red River,10/1/2024,3706,3529,177,4.8,168428,161456,6972,4.1
Red River,11/1/2024,3645,3467,178,4.9,168304,161183,7121,4.2
Red River,12/1/2024,3637,3482,155,4.3,168547,161661,6886,4.1
Red River,1/1/2025,2937,2782,155,5.3,170744,163895,6849,4
Red River,2/1/2025,2921,2766,155,5.3,170359,163307,7052,4.1
Richland,1/1/1990,8159,7361,798,9.8,125833,119081,6752,5.4
Richland,2/1/1990,8044,7293,751,9.3,125710,119059,6651,5.3
Richland,3/1/1990,8110,7447,663,8.2,125801,119203,6598,5.2
Richland,4/1/1990,8054,7427,627,7.8,125649,118852,6797,5.4
Richland,5/1/1990,8282,7620,662,8,125893,119151,6742,5.4
Richland,6/1/1990,8549,7746,803,9.4,125573,118983,6590,5.2
Richland,7/1/1990,8336,7621,715,8.6,125732,118810,6922,5.5
Richland,8/1/1990,8508,7639,869,10.2,125990,118802,7188,5.7
Richland,9/1/1990,8629,7728,901,10.4,125892,118524,7368,5.9
Richland,10/1/1990,8513,7892,621,7.3,125995,118536,7459,5.9
Richland,11/1/1990,8465,7728,737,8.7,126070,118306,7764,6.2
Richland,12/1/1990,8461,7530,931,11,126142,118241,7901,6.3
Richland,1/1/1991,8310,7026,1284,15.5,125955,117940,8015,6.4
Richland,2/1/1991,8276,7133,1143,13.8,126020,117755,8265,6.6
Richland,3/1/1991,8366,7323,1043,12.5,126238,117652,8586,6.8
Richland,4/1/1991,8333,7321,1012,12.1,126548,118109,8439,6.7
Richland,5/1/1991,8356,7310,1046,12.5,126176,117440,8736,6.9
Richland,6/1/1991,8563,7516,1047,12.2,126331,117639,8692,6.9
Richland,7/1/1991,8520,7551,969,11.4,126154,117568,8586,6.8
Richland,8/1/1991,8409,7546,863,10.3,126150,117484,8666,6.9
Richland,9/1/1991,8245,7434,811,9.8,126650,117928,8722,6.9
Richland,10/1/1991,8644,7916,728,8.4,126642,117800,8842,7
Richland,11/1/1991,8691,7988,703,8.1,126701,117770,8931,7
Richland,12/1/1991,8507,7706,801,9.4,126664,117466,9198,7.3
Richland,1/1/1992,8681,7491,1190,13.7,127261,117978,9283,7.3
Richland,2/1/1992,8493,7462,1031,12.1,127207,117753,9454,7.4
Richland,3/1/1992,8761,7615,1146,13.1,127604,118144,9460,7.4
Richland,4/1/1992,8620,7573,1047,12.1,127841,118426,9415,7.4
Richland,5/1/1992,8601,7593,1008,11.7,128119,118375,9744,7.6
Richland,6/1/1992,8857,7752,1105,12.5,128459,118419,10040,7.8
Richland,7/1/1992,8913,7931,982,11,128563,118713,9850,7.7
Richland,8/1/1992,8664,7735,929,10.7,128613,118826,9787,7.6
Richland,9/1/1992,8601,7775,826,9.6,128501,118720,9781,7.6
Richland,10/1/1992,8794,8049,745,8.5,128026,118628,9398,7.3
Richland,11/1/1992,8726,8016,710,8.1,128441,118876,9565,7.4
Richland,12/1/1992,8619,7773,846,9.8,128554,118997,9557,7.4
Richland,1/1/1993,8601,7602,999,11.6,128400,119075,9325,7.3
Richland,2/1/1993,8446,7564,882,10.4,128458,119275,9183,7.1
Richland,3/1/1993,8557,7696,861,10.1,128598,119542,9056,7
Richland,4/1/1993,8336,7531,805,9.7,128584,119474,9110,7.1
Richland,5/1/1993,8439,7632,807,9.6,129264,120115,9149,7.1
Richland,6/1/1993,8677,7749,928,10.7,129411,120290,9121,7
Richland,7/1/1993,8315,7504,811,9.8,129397,120467,8930,6.9
Richland,8/1/1993,8329,7581,748,9,129619,120856,8763,6.8
Richland,9/1/1993,8283,7555,728,8.8,129268,120554,8714,6.7
Richland,10/1/1993,8402,7740,662,7.9,129573,120823,8750,6.8
Richland,11/1/1993,8246,7599,647,7.8,129711,121169,8542,6.6
Richland,12/1/1993,8413,7617,796,9.5,129941,121464,8477,6.5
Richland,1/1/1994,8270,7100,1170,14.1,130596,121966,8630,6.6
Richland,2/1/1994,8332,7247,1085,13,130669,122086,8583,6.6
Richland,3/1/1994,8634,7561,1073,12.4,130400,121930,8470,6.5
Richland,4/1/1994,8566,7629,937,10.9,130621,122290,8331,6.4
Richland,5/1/1994,8559,7685,874,10.2,130779,122864,7915,6.1
Richland,6/1/1994,8511,7562,949,11.2,130561,122634,7927,6.1
Richland,7/1/1994,8193,7229,964,11.8,130652,122706,7946,6.1
Richland,8/1/1994,8122,7168,954,11.7,131275,123342,7933,6
Richland,9/1/1994,8013,7194,819,10.2,131421,123687,7734,5.9
Richland,10/1/1994,8186,7470,716,8.7,131744,124112,7632,5.8
Richland,11/1/1994,8235,7478,757,9.2,131891,124516,7375,5.6
Richland,12/1/1994,8149,7279,870,10.7,131951,124721,7230,5.5
Richland,1/1/1995,8354,7266,1088,13,132038,124663,7375,5.6
Richland,2/1/1995,8145,7250,895,11,132115,124928,7187,5.4
Richland,3/1/1995,8107,7266,841,10.4,132108,124955,7153,5.4
Richland,4/1/1995,8207,7454,753,9.2,132590,124945,7645,5.8
Richland,5/1/1995,8073,7351,722,8.9,131851,124421,7430,5.6
Richland,6/1/1995,8440,7591,849,10.1,131949,124522,7427,5.6
Richland,7/1/1995,8230,7433,797,9.7,132343,124816,7527,5.7
Richland,8/1/1995,8192,7368,824,10.1,132336,124852,7484,5.7
Richland,9/1/1995,8177,7455,722,8.8,132611,125133,7478,5.6
Richland,10/1/1995,8091,7411,680,8.4,132716,125388,7328,5.5
Richland,11/1/1995,7782,7057,725,9.3,132614,125188,7426,5.6
Richland,12/1/1995,7776,6966,810,10.4,132511,125088,7423,5.6
Richland,1/1/1996,7997,6975,1022,12.8,132616,125125,7491,5.6
Richland,2/1/1996,7865,6988,877,11.2,132952,125639,7313,5.5
Richland,3/1/1996,7853,7089,764,9.7,133180,125862,7318,5.5
Richland,4/1/1996,8218,7442,776,9.4,133409,125994,7415,5.6
Richland,5/1/1996,7961,7209,752,9.4,133667,126244,7423,5.6
Richland,6/1/1996,8108,7322,786,9.7,133697,126602,7095,5.3
Richland,7/1/1996,8126,7377,749,9.2,134284,126947,7337,5.5
Richland,8/1/1996,7760,7092,668,8.6,134054,127172,6882,5.1
Richland,9/1/1996,7869,7250,619,7.9,134515,127536,6979,5.2
Richland,10/1/1996,7781,7161,620,8,134921,127890,7031,5.2
Richland,11/1/1996,7615,7002,613,8,135007,127771,7236,5.4
Richland,12/1/1996,7517,6719,798,10.6,135113,127860,7253,5.4
Richland,1/1/1997,7985,6973,1012,12.7,135456,128298,7158,5.3
Richland,2/1/1997,7907,7068,839,10.6,135400,128298,7102,5.2
Richland,3/1/1997,7996,7124,872,10.9,135891,128891,7000,5.2
Richland,4/1/1997,8160,7425,735,9,136016,129143,6873,5.1
Richland,5/1/1997,8090,7370,720,8.9,136119,129464,6655,4.9
Richland,6/1/1997,8448,7506,942,11.2,136211,129412,6799,5
Richland,7/1/1997,8384,7518,866,10.3,136477,129822,6655,4.9
Richland,8/1/1997,8189,7357,832,10.2,136618,130010,6608,4.8
Richland,9/1/1997,8037,7297,740,9.2,136675,130019,6656,4.9
Richland,10/1/1997,7963,7355,608,7.6,136633,130179,6454,4.7
Richland,11/1/1997,7805,7152,653,8.4,136961,130653,6308,4.6
Richland,12/1/1997,7757,6979,778,10,137155,130679,6476,4.7
Richland,1/1/1998,8146,7078,1068,13.1,137095,130726,6368,4.6
Richland,2/1/1998,7880,7084,796,10.1,137112,130807,6306,4.6
Richland,3/1/1998,7964,7089,875,11,137236,130814,6422,4.7
Richland,4/1/1998,7938,7127,811,10.2,137150,131209,5941,4.3
Richland,5/1/1998,7924,7102,822,10.4,137372,131325,6047,4.4
Richland,6/1/1998,8102,7261,841,10.4,137455,131244,6212,4.5
Richland,7/1/1998,8202,7394,808,9.9,137588,131329,6259,4.5
Richland,8/1/1998,8050,7280,770,9.6,137570,131390,6179,4.5
Richland,9/1/1998,7925,7239,686,8.7,138286,131986,6300,4.6
Richland,10/1/1998,8150,7547,603,7.4,138279,131999,6280,4.5
Richland,11/1/1998,8097,7473,624,7.7,138381,132280,6100,4.4
Richland,12/1/1998,8076,7369,707,8.8,138634,132602,6032,4.4
Richland,1/1/1999,8168,7258,910,11.1,139003,133027,5976,4.3
Richland,2/1/1999,7885,7155,730,9.3,138967,132856,6111,4.4
Richland,3/1/1999,7949,7319,630,7.9,138730,132947,5783,4.2
Richland,4/1/1999,7917,7388,529,6.7,138959,132955,6004,4.3
Richland,5/1/1999,7897,7401,496,6.3,139107,133311,5796,4.2
Richland,6/1/1999,8229,7640,589,7.2,139329,133378,5951,4.3
Richland,7/1/1999,8387,7853,534,6.4,139439,133414,6025,4.3
Richland,8/1/1999,8343,7811,532,6.4,139430,133591,5838,4.2
Richland,9/1/1999,8122,7610,512,6.3,139622,133707,5915,4.2
Richland,10/1/1999,8447,7860,587,6.9,139771,133993,5778,4.1
Richland,11/1/1999,8346,7703,643,7.7,140025,134309,5716,4.1
Richland,12/1/1999,8128,7390,738,9.1,140177,134523,5653,4
Richland,1/1/2000,8659,7944,715,8.3,142267,136559,5708,4
Richland,2/1/2000,8527,7910,617,7.2,142456,136598,5858,4.1
Richland,3/1/2000,8520,7935,585,6.9,142434,136701,5733,4
Richland,4/1/2000,8503,8012,491,5.8,142751,137270,5481,3.8
Richland,5/1/2000,8485,7968,517,6.1,142388,136630,5758,4
Richland,6/1/2000,8625,8010,615,7.1,142591,136940,5651,4
Richland,7/1/2000,8712,8153,559,6.4,142278,136531,5747,4
Richland,8/1/2000,8712,8142,570,6.5,142514,136662,5853,4.1
Richland,9/1/2000,8648,8107,541,6.3,142518,136893,5625,3.9
Richland,10/1/2000,8789,8274,515,5.9,142622,137088,5534,3.9
Richland,11/1/2000,8694,8111,583,6.7,142962,137322,5639,3.9
Richland,12/1/2000,8727,8108,619,7.1,143248,137614,5634,3.9
Richland,1/1/2001,8535,7721,814,9.5,143800,137778,6023,4.2
Richland,2/1/2001,8510,7836,674,7.9,143701,137612,6089,4.2
Richland,3/1/2001,8649,7955,694,8,143924,137783,6141,4.3
Richland,4/1/2001,8531,7974,557,6.5,143569,137299,6271,4.4
Richland,5/1/2001,8464,7933,531,6.3,143318,137092,6226,4.3
Richland,6/1/2001,8600,7969,631,7.3,143357,136873,6484,4.5
Richland,7/1/2001,8685,8094,591,6.8,143654,137071,6583,4.6
Richland,8/1/2001,8719,8109,610,7,143284,136241,7042,4.9
Richland,9/1/2001,8702,8082,620,7.1,143989,136846,7142,5
Richland,10/1/2001,8615,8032,583,6.8,144086,136392,7694,5.3
Richland,11/1/2001,8528,7899,629,7.4,144240,136238,8003,5.5
Richland,12/1/2001,8536,7834,702,8.2,144305,136047,8258,5.7
Richland,1/1/2002,8395,7566,829,9.9,143883,135701,8182,5.7
Richland,2/1/2002,8314,7640,674,8.1,144653,136438,8215,5.7
Richland,3/1/2002,8426,7721,705,8.4,144481,136177,8304,5.7
Richland,4/1/2002,8342,7677,665,8,144725,136126,8599,5.9
Richland,5/1/2002,8304,7679,625,7.5,144938,136539,8399,5.8
Richland,6/1/2002,8369,7665,704,8.4,144808,136415,8393,5.8
Richland,7/1/2002,8511,7826,685,8,144803,136413,8390,5.8
Richland,8/1/2002,8557,7882,675,7.9,145009,136705,8304,5.7
Richland,9/1/2002,8416,7787,629,7.5,145552,137302,8251,5.7
Richland,10/1/2002,8617,8019,598,6.9,145314,137008,8307,5.7
Richland,11/1/2002,8527,7883,644,7.6,145041,136521,8520,5.9
Richland,12/1/2002,8528,7834,694,8.1,145066,136426,8640,6
Richland,1/1/2003,8861,7952,909,10.3,145937,137417,8520,5.8
Richland,2/1/2003,8685,7837,848,9.8,146100,137482,8618,5.9
Richland,3/1/2003,8819,7963,856,9.7,146022,137434,8588,5.9
Richland,4/1/2003,8769,8033,736,8.4,146474,137633,8842,6
Richland,5/1/2003,8688,7966,722,8.3,146500,137544,8957,6.1
Richland,6/1/2003,8865,8014,851,9.6,147056,137790,9266,6.3
Richland,7/1/2003,8806,8033,773,8.8,146485,137474,9011,6.2
Richland,8/1/2003,8818,8116,702,8,146445,137549,8896,6.1
Richland,9/1/2003,8685,8022,663,7.6,146530,137609,8921,6.1
Richland,10/1/2003,8839,8217,622,7,146716,137984,8732,6
Richland,11/1/2003,8745,8121,624,7.1,147000,138424,8576,5.8
Richland,12/1/2003,8578,7925,653,7.6,146729,138411,8317,5.7
Richland,1/1/2004,8538,7687,851,10,146842,138472,8370,5.7
Richland,2/1/2004,8380,7655,725,8.7,146709,138542,8167,5.6
Richland,3/1/2004,8390,7642,748,8.9,146944,138453,8491,5.8
Richland,4/1/2004,8292,7645,647,7.8,146850,138680,8170,5.6
Richland,5/1/2004,8255,7628,627,7.6,147065,138852,8212,5.6
Richland,6/1/2004,8455,7706,749,8.9,147460,139174,8286,5.6
Richland,7/1/2004,8564,7886,678,7.9,147692,139556,8136,5.5
Richland,8/1/2004,8548,7931,617,7.2,147564,139573,7990,5.4
Richland,9/1/2004,8488,7876,612,7.2,147415,139487,7927,5.4
Richland,10/1/2004,8601,8001,600,7,147793,139732,8061,5.5
Richland,11/1/2004,8512,7911,601,7.1,148162,140231,7932,5.4
Richland,12/1/2004,8340,7725,615,7.4,148059,140125,7934,5.4
Richland,1/1/2005,8423,7664,759,9,148029,140245,7784,5.3
Richland,2/1/2005,8289,7607,682,8.2,148364,140385,7980,5.4
Richland,3/1/2005,8249,7601,648,7.9,148391,140654,7737,5.2
Richland,4/1/2005,8358,7756,602,7.2,148926,141254,7672,5.2
Richland,5/1/2005,8330,7754,576,6.9,149261,141609,7651,5.1
Richland,6/1/2005,8495,7836,659,7.8,149238,141714,7524,5
Richland,7/1/2005,8519,7906,613,7.2,149432,142026,7406,5
Richland,8/1/2005,8383,7800,583,7,149779,142434,7345,4.9
Richland,9/1/2005,9170,8405,765,8.3,149954,142401,7553,5
Richland,10/1/2005,9306,8602,704,7.6,150001,142548,7453,5
Richland,11/1/2005,9160,8442,718,7.8,150065,142499,7566,5
Richland,12/1/2005,8699,8170,529,6.1,150030,142752,7279,4.9
Richland,1/1/2006,8613,8133,480,5.6,150214,143150,7064,4.7
Richland,2/1/2006,8542,8133,409,4.8,150641,143457,7184,4.8
Richland,3/1/2006,8639,8241,398,4.6,150813,143741,7072,4.7
Richland,4/1/2006,8679,8293,386,4.4,150881,143761,7120,4.7
Richland,5/1/2006,8517,8116,401,4.7,151069,144089,6980,4.6
Richland,6/1/2006,8711,8205,506,5.8,151354,144353,7001,4.6
Richland,7/1/2006,8655,8228,427,4.9,151377,144202,7175,4.7
Richland,8/1/2006,8587,8157,430,5,151716,144625,7091,4.7
Richland,9/1/2006,8809,8405,404,4.6,151662,144815,6847,4.5
Richland,10/1/2006,8910,8516,394,4.4,152041,145314,6727,4.4
Richland,11/1/2006,8829,8408,421,4.8,152406,145534,6872,4.5
Richland,12/1/2006,8707,8274,433,5,152732,145970,6762,4.4
Richland,1/1/2007,8807,8188,619,7,153144,146028,7116,4.6
Richland,2/1/2007,8805,8239,566,6.4,152983,146057,6927,4.5
Richland,3/1/2007,8747,8250,497,5.7,153051,146320,6731,4.4
Richland,4/1/2007,8616,8096,520,6,152435,145586,6850,4.5
Richland,5/1/2007,8483,7972,511,6,152670,145903,6766,4.4
Richland,6/1/2007,8628,8005,623,7.2,153041,146063,6979,4.6
Richland,7/1/2007,8674,8069,605,7,153054,145905,7149,4.7
Richland,8/1/2007,8671,8143,528,6.1,152749,145682,7067,4.6
Richland,9/1/2007,8896,8386,510,5.7,153414,146244,7170,4.7
Richland,10/1/2007,8807,8373,434,4.9,153183,145946,7237,4.7
Richland,11/1/2007,8862,8425,437,4.9,153835,146595,7240,4.7
Richland,12/1/2007,8807,8320,487,5.5,153918,146273,7645,5
Richland,1/1/2008,8745,8182,563,6.4,154063,146378,7685,5
Richland,2/1/2008,8671,8188,483,5.6,153653,146156,7497,4.9
Richland,3/1/2008,8923,8436,487,5.5,153908,146086,7822,5.1
Richland,4/1/2008,8863,8427,436,4.9,153769,146132,7637,5
Richland,5/1/2008,8837,8359,478,5.4,154303,145908,8395,5.4
Richland,6/1/2008,8931,8330,601,6.7,154313,145737,8575,5.6
Richland,7/1/2008,9006,8378,628,7,154469,145532,8937,5.8
Richland,8/1/2008,8871,8263,608,6.9,154641,145203,9438,6.1
Richland,9/1/2008,8886,8356,530,6,154570,145076,9494,6.1
Richland,10/1/2008,8975,8426,549,6.1,154876,144802,10074,6.5
Richland,11/1/2008,8885,8292,593,6.7,154639,144100,10538,6.8
Richland,12/1/2008,8723,8080,643,7.4,154655,143369,11286,7.3
Richland,1/1/2009,8834,8008,826,9.4,154210,142152,12058,7.8
Richland,2/1/2009,8773,7986,787,9,154538,141640,12898,8.3
Richland,3/1/2009,8853,8033,820,9.3,154133,140707,13426,8.7
Richland,4/1/2009,8988,8166,822,9.1,154509,140656,13853,9
Richland,5/1/2009,9115,8219,896,9.8,154747,140248,14499,9.4
Richland,6/1/2009,9286,8298,988,10.6,154716,140009,14707,9.5
Richland,7/1/2009,9178,8184,994,10.8,154502,139901,14601,9.5
Richland,8/1/2009,8998,8105,893,9.9,154307,139492,14814,9.6
Richland,9/1/2009,8807,7954,853,9.7,153827,138818,15009,9.8
Richland,10/1/2009,8850,8052,798,9,153784,138432,15352,10
Richland,11/1/2009,9000,8225,775,8.6,153878,138659,15219,9.9
Richland,12/1/2009,8940,8100,840,9.4,153111,138013,15098,9.9
Richland,1/1/2010,8376,7418,958,11.4,153484,138438,15046,9.8
Richland,2/1/2010,8551,7651,900,10.5,153694,138581,15113,9.8
Richland,3/1/2010,8703,7820,883,10.1,153954,138751,15202,9.9
Richland,4/1/2010,8824,8010,814,9.2,154622,139297,15325,9.9
Richland,5/1/2010,8935,8072,863,9.7,154091,139241,14849,9.6
Richland,6/1/2010,9014,8063,951,10.6,153616,139141,14474,9.4
Richland,7/1/2010,9121,8172,949,10.4,153691,139179,14512,9.4
Richland,8/1/2010,9013,8114,899,10,154086,139438,14648,9.5
Richland,9/1/2010,8908,8011,897,10.1,153975,139396,14579,9.5
Richland,10/1/2010,8800,7906,894,10.2,153635,139119,14516,9.4
Richland,11/1/2010,8725,7797,928,10.6,154125,139044,15081,9.8
Richland,12/1/2010,8652,7684,968,11.2,153650,139301,14348,9.3
Richland,1/1/2011,8621,7547,1074,12.5,153263,139250,14013,9.1
Richland,2/1/2011,8713,7696,1017,11.7,153214,139394,13820,9
Richland,3/1/2011,8748,7791,957,10.9,153376,139639,13737,9
Richland,4/1/2011,8804,7929,875,9.9,153543,139586,13957,9.1
Richland,5/1/2011,8812,7937,875,9.9,153479,139624,13855,9
Richland,6/1/2011,9019,8017,1002,11.1,153346,139384,13962,9.1
Richland,7/1/2011,9050,8117,933,10.3,153288,139524,13763,9
Richland,8/1/2011,8937,8044,893,10,153760,139942,13818,9
Richland,9/1/2011,8918,8066,852,9.6,154131,140183,13948,9
Richland,10/1/2011,8866,8042,824,9.3,153961,140368,13594,8.8
Richland,11/1/2011,8788,7979,809,9.2,154128,140826,13302,8.6
Richland,12/1/2011,8694,7877,817,9.4,153995,140902,13093,8.5
Richland,1/1/2012,8433,7524,909,10.8,154381,141584,12797,8.3
Richland,2/1/2012,8587,7723,864,10.1,154671,141858,12813,8.3
Richland,3/1/2012,8593,7762,831,9.7,154749,142036,12713,8.2
Richland,4/1/2012,8537,7776,761,8.9,154545,141899,12646,8.2
Richland,5/1/2012,8611,7827,784,9.1,154866,142206,12660,8.2
Richland,6/1/2012,8857,7956,901,10.2,155083,142391,12692,8.2
Richland,7/1/2012,9064,8169,895,9.9,154948,142292,12656,8.2
Richland,8/1/2012,8847,8019,828,9.4,154763,142291,12471,8.1
Richland,9/1/2012,8755,7999,756,8.6,155160,143044,12115,7.8
Richland,10/1/2012,8795,8077,718,8.2,155554,143431,12124,7.8
Richland,11/1/2012,8699,8000,699,8,155338,143333,12005,7.7
Richland,12/1/2012,8699,7953,746,8.6,155628,143330,12298,7.9
Richland,1/1/2013,8512,7585,927,10.9,155763,143292,12471,8
Richland,2/1/2013,8642,7750,892,10.3,155312,143362,11950,7.7
Richland,3/1/2013,8577,7726,851,9.9,155005,143316,11689,7.5
Richland,4/1/2013,8676,7869,807,9.3,155394,143635,11760,7.6
Richland,5/1/2013,8694,7880,814,9.4,155536,143882,11654,7.5
Richland,6/1/2013,8891,7958,933,10.5,155749,143999,11751,7.5
Richland,7/1/2013,8883,8021,862,9.7,155599,144264,11335,7.3
Richland,8/1/2013,8757,7979,778,8.9,155605,144326,11279,7.2
Richland,9/1/2013,8691,7923,768,8.8,155687,144418,11270,7.2
Richland,10/1/2013,8544,7850,694,8.1,154673,143537,11136,7.2
Richland,11/1/2013,8500,7867,633,7.4,155265,144479,10787,6.9
Richland,12/1/2013,8476,7852,624,7.4,155182,144778,10404,6.7
Richland,1/1/2014,8287,7584,703,8.5,155352,145150,10202,6.6
Richland,2/1/2014,8434,7754,680,8.1,155483,145134,10349,6.7
Richland,3/1/2014,8516,7829,687,8.1,156028,145648,10380,6.7
Richland,4/1/2014,8521,7885,636,7.5,155369,145667,9702,6.2
Richland,5/1/2014,8566,7871,695,8.1,155684,145825,9859,6.3
Richland,6/1/2014,8768,7971,797,9.1,155707,146247,9460,6.1
Richland,7/1/2014,9114,8274,840,9.2,156007,146399,9608,6.2
Richland,8/1/2014,8765,7974,791,9,156130,146530,9599,6.1
Richland,9/1/2014,8844,8054,790,8.9,156040,146778,9262,5.9
Richland,10/1/2014,8731,7998,733,8.4,156417,147427,8990,5.7
Richland,11/1/2014,8731,7986,745,8.5,156494,147404,9090,5.8
Richland,12/1/2014,8769,7988,781,8.9,156332,147615,8717,5.6
Richland,1/1/2015,8689,7805,884,10.2,157030,148145,8885,5.7
Richland,2/1/2015,8675,7844,831,9.6,156644,148045,8599,5.5
Richland,3/1/2015,8659,7841,818,9.4,156643,148128,8515,5.4
Richland,4/1/2015,8661,7889,772,8.9,157060,148511,8550,5.4
Richland,5/1/2015,8680,7906,774,8.9,157651,148817,8834,5.6
Richland,6/1/2015,8865,8023,842,9.5,157062,148816,8247,5.3
Richland,7/1/2015,8744,7976,768,8.8,156997,148830,8167,5.2
Richland,8/1/2015,8646,7952,694,8,157172,149181,7992,5.1
Richland,9/1/2015,8497,7821,676,8,156733,148826,7907,5
Richland,10/1/2015,8424,7768,656,7.8,157167,149246,7922,5
Richland,11/1/2015,8427,7814,613,7.3,157463,149463,8000,5.1
Richland,12/1/2015,8461,7839,622,7.4,158035,150128,7907,5
Richland,1/1/2016,8429,7716,713,8.5,158280,150653,7627,4.8
Richland,2/1/2016,8452,7765,687,8.1,158640,150939,7702,4.9
Richland,3/1/2016,8480,7815,665,7.8,159179,151218,7961,5
Richland,4/1/2016,8473,7836,637,7.5,159141,151074,8067,5.1
Richland,5/1/2016,8511,7886,625,7.3,158784,151132,7652,4.8
Richland,6/1/2016,8661,7954,707,8.2,158967,151223,7744,4.9
Richland,7/1/2016,8621,7950,671,7.8,159194,151554,7641,4.8
Richland,8/1/2016,8514,7890,624,7.3,159562,151779,7784,4.9
Richland,9/1/2016,8342,7770,572,6.9,159714,151761,7953,5
Richland,10/1/2016,8260,7735,525,6.4,159605,151793,7811,4.9
Richland,11/1/2016,8297,7779,518,6.2,159506,151954,7553,4.7
Richland,12/1/2016,8267,7723,544,6.6,159678,152157,7521,4.7
Richland,1/1/2017,8281,7640,641,7.7,159620,152152,7468,4.7
Richland,2/1/2017,8243,7671,572,6.9,159859,152480,7379,4.6
Richland,3/1/2017,8289,7732,557,6.7,160137,153065,7073,4.4
Richland,4/1/2017,8293,7783,510,6.1,160345,153255,7089,4.4
Richland,5/1/2017,8349,7860,489,5.9,160068,153069,7000,4.4
Richland,6/1/2017,8588,8027,561,6.5,160192,153318,6873,4.3
Richland,7/1/2017,8570,8031,539,6.3,160462,153569,6892,4.3
Richland,8/1/2017,8317,7820,497,6,160586,153503,7082,4.4
Richland,9/1/2017,8247,7798,449,5.4,161140,154286,6854,4.3
Richland,10/1/2017,8155,7757,398,4.9,160309,153609,6700,4.2
Richland,11/1/2017,8155,7720,435,5.3,160579,153805,6774,4.2
Richland,12/1/2017,8175,7718,457,5.6,160535,153904,6632,4.1
Richland,1/1/2018,8168,7655,513,6.3,160914,154425,6489,4
Richland,2/1/2018,8197,7680,517,6.3,161778,155197,6581,4.1
Richland,3/1/2018,8263,7742,521,6.3,161686,155214,6472,4
Richland,4/1/2018,8308,7826,482,5.8,161771,155312,6459,4
Richland,5/1/2018,8377,7876,501,6,161848,155652,6196,3.8
Richland,6/1/2018,8553,7934,619,7.2,162210,155762,6447,4
Richland,7/1/2018,8584,7986,598,7,162341,156146,6195,3.8
Richland,8/1/2018,8396,7858,538,6.4,161660,155504,6156,3.8
Richland,9/1/2018,8268,7778,490,5.9,162087,156015,6073,3.7
Richland,10/1/2018,8236,7776,460,5.6,162602,156391,6211,3.8
Richland,11/1/2018,8155,7720,435,5.3,162836,156721,6115,3.8
Richland,12/1/2018,8181,7715,466,5.7,163206,156817,6389,3.9
Richland,1/1/2019,8188,7640,548,6.7,162963,156487,6475,4
Richland,2/1/2019,8195,7704,491,6,162999,156863,6136,3.8
Richland,3/1/2019,8237,7776,461,5.6,162904,156701,6202,3.8
Richland,4/1/2019,8172,7752,420,5.1,162586,156625,5961,3.7
Richland,5/1/2019,8213,7764,449,5.5,162751,156821,5930,3.6
Richland,6/1/2019,8381,7835,546,6.5,163168,157232,5935,3.6
Richland,7/1/2019,8267,7731,536,6.5,163590,157529,6061,3.7
Richland,8/1/2019,8248,7739,509,6.2,163774,157829,5945,3.6
Richland,9/1/2019,8275,7792,483,5.8,164092,158339,5753,3.5
Richland,10/1/2019,8185,7690,495,6,164416,158545,5871,3.6
Richland,11/1/2019,8120,7624,496,6.1,164496,158629,5868,3.6
Richland,12/1/2019,8101,7606,495,6.1,164699,158845,5853,3.6
Richland,1/1/2020,8091,7525,566,7,164377,158508,5869,3.6
Richland,2/1/2020,8001,7528,473,5.9,164467,158714,5753,3.5
Richland,3/1/2020,8249,7473,776,9.4,162559,155353,7206,4.4
Richland,4/1/2020,7607,6903,704,9.3,156269,133185,23084,14.8
Richland,5/1/2020,7806,7068,738,9.5,158101,137173,20929,13.2
Richland,6/1/2020,8055,7270,785,9.7,159994,142342,17652,11
Richland,7/1/2020,8133,7356,777,9.6,160132,143779,16352,10.2
Richland,8/1/2020,8172,7504,668,8.2,160706,147245,13461,8.4
Richland,9/1/2020,8155,7481,674,8.3,160174,147620,12554,7.8
Richland,10/1/2020,8184,7608,576,7,161003,149931,11072,6.9
Richland,11/1/2020,8026,7518,508,6.3,160629,149934,10694,6.7
Richland,12/1/2020,8034,7496,538,6.7,160745,149975,10770,6.7
Richland,1/1/2021,7929,7376,553,7,160088,149852,10236,6.4
Richland,2/1/2021,7910,7385,525,6.6,160184,150189,9995,6.2
Richland,3/1/2021,7937,7448,489,6.2,160400,150644,9756,6.1
Richland,4/1/2021,8054,7604,450,5.6,160843,151081,9762,6.1
Richland,5/1/2021,8043,7580,463,5.8,160800,151535,9266,5.8
Richland,6/1/2021,8171,7628,543,6.6,161197,151734,9462,5.9
Richland,7/1/2021,8209,7717,492,6,161504,152773,8731,5.4
Richland,8/1/2021,8091,7666,425,5.3,161527,153250,8276,5.1
Richland,9/1/2021,8278,7911,367,4.4,161495,153843,7652,4.7
Richland,10/1/2021,8111,7770,341,4.2,161754,154475,7279,4.5
Richland,11/1/2021,8114,7807,307,3.8,162281,155530,6751,4.2
Richland,12/1/2021,8149,7871,278,3.4,162497,156099,6398,3.9
Richland,1/1/2022,8132,7775,357,4.4,163627,157115,6512,4
Richland,2/1/2022,8158,7825,333,4.1,163899,157598,6301,3.8
Richland,3/1/2022,8174,7857,317,3.9,164220,158206,6014,3.7
Richland,4/1/2022,8031,7744,287,3.6,163893,157891,6002,3.7
Richland,5/1/2022,8077,7756,321,4,164362,158378,5983,3.6
Richland,6/1/2022,8220,7813,407,5,164046,158094,5951,3.6
Richland,7/1/2022,8312,7929,383,4.6,164026,158258,5768,3.5
Richland,8/1/2022,8195,7827,368,4.5,164654,158735,5919,3.6
Richland,9/1/2022,8214,7880,334,4.1,164602,158810,5792,3.5
Richland,10/1/2022,8114,7815,299,3.7,164648,158684,5964,3.6
Richland,11/1/2022,8070,7769,301,3.7,164450,158507,5943,3.6
Richland,12/1/2022,8096,7807,289,3.6,165025,159259,5766,3.5
Richland,1/1/2023,8094,7725,369,4.6,165964,160217,5747,3.5
Richland,2/1/2023,8052,7694,358,4.4,166358,160395,5962,3.6
Richland,3/1/2023,8112,7760,352,4.3,166651,160812,5839,3.5
Richland,4/1/2023,8098,7778,320,4,166725,160974,5751,3.4
Richland,5/1/2023,8141,7761,380,4.7,166886,160796,6089,3.6
Richland,6/1/2023,8302,7863,439,5.3,166937,160979,5958,3.6
Richland,7/1/2023,8343,7950,393,4.7,167103,161183,5920,3.5
Richland,8/1/2023,8221,7823,398,4.8,167759,161475,6284,3.7
Richland,9/1/2023,8129,7745,384,4.7,167767,161442,6326,3.8
Richland,10/1/2023,8087,7721,366,4.5,167690,161211,6479,3.9
Richland,11/1/2023,8120,7743,377,4.6,168140,161886,6254,3.7
Richland,12/1/2023,8100,7716,384,4.7,167439,161124,6315,3.8
Richland,1/1/2024,8069,7624,445,5.5,167339,161190,6149,3.7
Richland,2/1/2024,7991,7549,442,5.5,167475,161013,6462,3.9
Richland,3/1/2024,8047,7621,426,5.3,167922,161425,6497,3.9
Richland,4/1/2024,8054,7658,396,4.9,167988,161495,6492,3.9
Richland,5/1/2024,8015,7624,391,4.9,167799,161164,6635,4
Richland,6/1/2024,8175,7685,490,6,168005,161155,6849,4.1
Richland,7/1/2024,8280,7782,498,6,168315,161219,7097,4.2
Richland,8/1/2024,8124,7691,433,5.3,168496,161425,7071,4.2
Richland,9/1/2024,8008,7590,418,5.2,168703,161802,6901,4.1
Richland,10/1/2024,7985,7560,425,5.3,168428,161456,6972,4.1
Richland,11/1/2024,7915,7491,424,5.4,168304,161183,7121,4.2
Richland,12/1/2024,7894,7503,391,5,168547,161661,6886,4.1
Richland,1/1/2025,7797,7360,437,5.6,170744,163895,6849,4
Richland,2/1/2025,7701,7293,408,5.3,170359,163307,7052,4.1
Sabine,1/1/1990,8123,7699,424,5.2,125833,119081,6752,5.4
Sabine,2/1/1990,8192,7806,386,4.7,125710,119059,6651,5.3
Sabine,3/1/1990,8320,7971,349,4.2,125801,119203,6598,5.2
Sabine,4/1/1990,8364,8008,356,4.3,125649,118852,6797,5.4
Sabine,5/1/1990,8383,8019,364,4.3,125893,119151,6742,5.4
Sabine,6/1/1990,8525,8106,419,4.9,125573,118983,6590,5.2
Sabine,7/1/1990,8569,8168,401,4.7,125732,118810,6922,5.5
Sabine,8/1/1990,8476,8083,393,4.6,125990,118802,7188,5.7
Sabine,9/1/1990,8400,8028,372,4.4,125892,118524,7368,5.9
Sabine,10/1/1990,8467,8089,378,4.5,125995,118536,7459,5.9
Sabine,11/1/1990,8402,8066,336,4,126070,118306,7764,6.2
Sabine,12/1/1990,8404,8038,366,4.4,126142,118241,7901,6.3
Sabine,1/1/1991,8429,7883,546,6.5,125955,117940,8015,6.4
Sabine,2/1/1991,8674,8064,610,7,126020,117755,8265,6.6
Sabine,3/1/1991,8604,8055,549,6.4,126238,117652,8586,6.8
Sabine,4/1/1991,8724,8146,578,6.6,126548,118109,8439,6.7
Sabine,5/1/1991,8661,8086,575,6.6,126176,117440,8736,6.9
Sabine,6/1/1991,8867,8182,685,7.7,126331,117639,8692,6.9
Sabine,7/1/1991,8879,8302,577,6.5,126154,117568,8586,6.8
Sabine,8/1/1991,8802,8201,601,6.8,126150,117484,8666,6.9
Sabine,9/1/1991,8758,8163,595,6.8,126650,117928,8722,6.9
Sabine,10/1/1991,8723,8130,593,6.8,126642,117800,8842,7
Sabine,11/1/1991,8657,8089,568,6.6,126701,117770,8931,7
Sabine,12/1/1991,8698,8090,608,7,126664,117466,9198,7.3
Sabine,1/1/1992,9015,8224,791,8.8,127261,117978,9283,7.3
Sabine,2/1/1992,9004,8207,797,8.9,127207,117753,9454,7.4
Sabine,3/1/1992,9125,8338,787,8.6,127604,118144,9460,7.4
Sabine,4/1/1992,9193,8514,679,7.4,127841,118426,9415,7.4
Sabine,5/1/1992,9140,8470,670,7.3,128119,118375,9744,7.6
Sabine,6/1/1992,9409,8557,852,9.1,128459,118419,10040,7.8
Sabine,7/1/1992,9709,9016,693,7.1,128563,118713,9850,7.7
Sabine,8/1/1992,9612,8971,641,6.7,128613,118826,9787,7.6
Sabine,9/1/1992,9508,8918,590,6.2,128501,118720,9781,7.6
Sabine,10/1/1992,9300,8747,553,5.9,128026,118628,9398,7.3
Sabine,11/1/1992,9091,8550,541,6,128441,118876,9565,7.4
Sabine,12/1/1992,8899,8326,573,6.4,128554,118997,9557,7.4
Sabine,1/1/1993,8920,8260,660,7.4,128400,119075,9325,7.3
Sabine,2/1/1993,8915,8304,611,6.9,128458,119275,9183,7.1
Sabine,3/1/1993,8974,8429,545,6.1,128598,119542,9056,7
Sabine,4/1/1993,9133,8560,573,6.3,128584,119474,9110,7.1
Sabine,5/1/1993,9017,8496,521,5.8,129264,120115,9149,7.1
Sabine,6/1/1993,9113,8493,620,6.8,129411,120290,9121,7
Sabine,7/1/1993,9175,8610,565,6.2,129397,120467,8930,6.9
Sabine,8/1/1993,9163,8572,591,6.4,129619,120856,8763,6.8
Sabine,9/1/1993,9070,8539,531,5.9,129268,120554,8714,6.7
Sabine,10/1/1993,9010,8487,523,5.8,129573,120823,8750,6.8
Sabine,11/1/1993,8943,8435,508,5.7,129711,121169,8542,6.6
Sabine,12/1/1993,8944,8421,523,5.8,129941,121464,8477,6.5
Sabine,1/1/1994,8939,8333,606,6.8,130596,121966,8630,6.6
Sabine,2/1/1994,8854,8331,523,5.9,130669,122086,8583,6.6
Sabine,3/1/1994,8855,8320,535,6,130400,121930,8470,6.5
Sabine,4/1/1994,8993,8466,527,5.9,130621,122290,8331,6.4
Sabine,5/1/1994,9127,8598,529,5.8,130779,122864,7915,6.1
Sabine,6/1/1994,9104,8529,575,6.3,130561,122634,7927,6.1
Sabine,7/1/1994,9182,8651,531,5.8,130652,122706,7946,6.1
Sabine,8/1/1994,9125,8550,575,6.3,131275,123342,7933,6
Sabine,9/1/1994,9154,8602,552,6,131421,123687,7734,5.9
Sabine,10/1/1994,8874,8385,489,5.5,131744,124112,7632,5.8
Sabine,11/1/1994,8903,8435,468,5.3,131891,124516,7375,5.6
Sabine,12/1/1994,8708,8272,436,5,131951,124721,7230,5.5
Sabine,1/1/1995,8796,8206,590,6.7,132038,124663,7375,5.6
Sabine,2/1/1995,8820,8287,533,6,132115,124928,7187,5.4
Sabine,3/1/1995,9020,8421,599,6.6,132108,124955,7153,5.4
Sabine,4/1/1995,8855,8344,511,5.8,132590,124945,7645,5.8
Sabine,5/1/1995,8806,8293,513,5.8,131851,124421,7430,5.6
Sabine,6/1/1995,9213,8367,846,9.2,131949,124522,7427,5.6
Sabine,7/1/1995,8996,8191,805,8.9,132343,124816,7527,5.7
Sabine,8/1/1995,8751,8288,463,5.3,132336,124852,7484,5.7
Sabine,9/1/1995,8936,8464,472,5.3,132611,125133,7478,5.6
Sabine,10/1/1995,8932,8483,449,5,132716,125388,7328,5.5
Sabine,11/1/1995,8928,8425,503,5.6,132614,125188,7426,5.6
Sabine,12/1/1995,8886,8362,524,5.9,132511,125088,7423,5.6
Sabine,1/1/1996,8987,8334,653,7.3,132616,125125,7491,5.6
Sabine,2/1/1996,9087,8430,657,7.2,132952,125639,7313,5.5
Sabine,3/1/1996,9187,8571,616,6.7,133180,125862,7318,5.5
Sabine,4/1/1996,9153,8572,581,6.3,133409,125994,7415,5.6
Sabine,5/1/1996,9199,8616,583,6.3,133667,126244,7423,5.6
Sabine,6/1/1996,9262,8660,602,6.5,133697,126602,7095,5.3
Sabine,7/1/1996,9433,8776,657,7,134284,126947,7337,5.5
Sabine,8/1/1996,9344,8734,610,6.5,134054,127172,6882,5.1
Sabine,9/1/1996,9362,8735,627,6.7,134515,127536,6979,5.2
Sabine,10/1/1996,8738,8130,608,7,134921,127890,7031,5.2
Sabine,11/1/1996,9120,8543,577,6.3,135007,127771,7236,5.4
Sabine,12/1/1996,8920,8401,519,5.8,135113,127860,7253,5.4
Sabine,1/1/1997,8833,8240,593,6.7,135456,128298,7158,5.3
Sabine,2/1/1997,8780,8259,521,5.9,135400,128298,7102,5.2
Sabine,3/1/1997,8984,8433,551,6.1,135891,128891,7000,5.2
Sabine,4/1/1997,9043,8469,574,6.3,136016,129143,6873,5.1
Sabine,5/1/1997,8937,8443,494,5.5,136119,129464,6655,4.9
Sabine,6/1/1997,8961,8386,575,6.4,136211,129412,6799,5
Sabine,7/1/1997,9137,8623,514,5.6,136477,129822,6655,4.9
Sabine,8/1/1997,9011,8526,485,5.4,136618,130010,6608,4.8
Sabine,9/1/1997,9049,8539,510,5.6,136675,130019,6656,4.9
Sabine,10/1/1997,8919,8465,454,5.1,136633,130179,6454,4.7
Sabine,11/1/1997,8829,8422,407,4.6,136961,130653,6308,4.6
Sabine,12/1/1997,8785,8370,415,4.7,137155,130679,6476,4.7
Sabine,1/1/1998,8887,8351,536,6,137095,130726,6368,4.6
Sabine,2/1/1998,8859,8261,598,6.8,137112,130807,6306,4.6
Sabine,3/1/1998,8847,8351,496,5.6,137236,130814,6422,4.7
Sabine,4/1/1998,9654,8545,1109,11.5,137150,131209,5941,4.3
Sabine,5/1/1998,9138,8214,924,10.1,137372,131325,6047,4.4
Sabine,6/1/1998,9302,8191,1111,11.9,137455,131244,6212,4.5
Sabine,7/1/1998,9506,8557,949,10,137588,131329,6259,4.5
Sabine,8/1/1998,9261,8354,907,9.8,137570,131390,6179,4.5
Sabine,9/1/1998,9047,8456,591,6.5,138286,131986,6300,4.6
Sabine,10/1/1998,8631,8078,553,6.4,138279,131999,6280,4.5
Sabine,11/1/1998,8547,8038,509,6,138381,132280,6100,4.4
Sabine,12/1/1998,8410,7949,461,5.5,138634,132602,6032,4.4
Sabine,1/1/1999,8483,7862,621,7.3,139003,133027,5976,4.3
Sabine,2/1/1999,8470,7872,598,7.1,138967,132856,6111,4.4
Sabine,3/1/1999,8639,8046,593,6.9,138730,132947,5783,4.2
Sabine,4/1/1999,8631,8029,602,7,138959,132955,6004,4.3
Sabine,5/1/1999,8521,7993,528,6.2,139107,133311,5796,4.2
Sabine,6/1/1999,8683,8078,605,7,139329,133378,5951,4.3
Sabine,7/1/1999,8423,7906,517,6.1,139439,133414,6025,4.3
Sabine,8/1/1999,8323,7825,498,6,139430,133591,5838,4.2
Sabine,9/1/1999,8357,7880,477,5.7,139622,133707,5915,4.2
Sabine,10/1/1999,8363,7951,412,4.9,139771,133993,5778,4.1
Sabine,11/1/1999,8320,7930,390,4.7,140025,134309,5716,4.1
Sabine,12/1/1999,8233,7883,350,4.3,140177,134523,5653,4
Sabine,1/1/2000,9189,8722,467,5.1,142267,136559,5708,4
Sabine,2/1/2000,9076,8674,402,4.4,142456,136598,5858,4.1
Sabine,3/1/2000,9193,8755,438,4.8,142434,136701,5733,4
Sabine,4/1/2000,9241,8817,424,4.6,142751,137270,5481,3.8
Sabine,5/1/2000,9326,8855,471,5.1,142388,136630,5758,4
Sabine,6/1/2000,9324,8801,523,5.6,142591,136940,5651,4
Sabine,7/1/2000,9353,8879,474,5.1,142278,136531,5747,4
Sabine,8/1/2000,9288,8784,504,5.4,142514,136662,5853,4.1
Sabine,9/1/2000,9256,8764,492,5.3,142518,136893,5625,3.9
Sabine,10/1/2000,9371,8892,479,5.1,142622,137088,5534,3.9
Sabine,11/1/2000,9246,8756,490,5.3,142962,137322,5639,3.9
Sabine,12/1/2000,9254,8781,473,5.1,143248,137614,5634,3.9
Sabine,1/1/2001,9147,8566,581,6.4,143800,137778,6023,4.2
Sabine,2/1/2001,9166,8646,520,5.7,143701,137612,6089,4.2
Sabine,3/1/2001,9519,8794,725,7.6,143924,137783,6141,4.3
Sabine,4/1/2001,9132,8570,562,6.2,143569,137299,6271,4.4
Sabine,5/1/2001,9135,8601,534,5.8,143318,137092,6226,4.3
Sabine,6/1/2001,9244,8630,614,6.6,143357,136873,6484,4.5
Sabine,7/1/2001,9423,8886,537,5.7,143654,137071,6583,4.6
Sabine,8/1/2001,9290,8764,526,5.7,143284,136241,7042,4.9
Sabine,9/1/2001,9342,8774,568,6.1,143989,136846,7142,5
Sabine,10/1/2001,9480,8914,566,6,144086,136392,7694,5.3
Sabine,11/1/2001,9375,8786,589,6.3,144240,136238,8003,5.5
Sabine,12/1/2001,9305,8690,615,6.6,144305,136047,8258,5.7
Sabine,1/1/2002,9295,8529,766,8.2,143883,135701,8182,5.7
Sabine,2/1/2002,9259,8567,692,7.5,144653,136438,8215,5.7
Sabine,3/1/2002,9368,8644,724,7.7,144481,136177,8304,5.7
Sabine,4/1/2002,9360,8657,703,7.5,144725,136126,8599,5.9
Sabine,5/1/2002,9411,8743,668,7.1,144938,136539,8399,5.8
Sabine,6/1/2002,9424,8681,743,7.9,144808,136415,8393,5.8
Sabine,7/1/2002,9395,8671,724,7.7,144803,136413,8390,5.8
Sabine,8/1/2002,9210,8488,722,7.8,145009,136705,8304,5.7
Sabine,9/1/2002,9121,8418,703,7.7,145552,137302,8251,5.7
Sabine,10/1/2002,9379,8717,662,7.1,145314,137008,8307,5.7
Sabine,11/1/2002,9244,8591,653,7.1,145041,136521,8520,5.9
Sabine,12/1/2002,9222,8571,651,7.1,145066,136426,8640,6
Sabine,1/1/2003,9364,8603,761,8.1,145937,137417,8520,5.8
Sabine,2/1/2003,9258,8562,696,7.5,146100,137482,8618,5.9
Sabine,3/1/2003,9446,8701,745,7.9,146022,137434,8588,5.9
Sabine,4/1/2003,9403,8694,709,7.5,146474,137633,8842,6
Sabine,5/1/2003,9440,8741,699,7.4,146500,137544,8957,6.1
Sabine,6/1/2003,9540,8710,830,8.7,147056,137790,9266,6.3
Sabine,7/1/2003,9509,8769,740,7.8,146485,137474,9011,6.2
Sabine,8/1/2003,9442,8781,661,7,146445,137549,8896,6.1
Sabine,9/1/2003,9354,8721,633,6.8,146530,137609,8921,6.1
Sabine,10/1/2003,9492,8922,570,6,146716,137984,8732,6
Sabine,11/1/2003,9352,8813,539,5.8,147000,138424,8576,5.8
Sabine,12/1/2003,9173,8653,520,5.7,146729,138411,8317,5.7
Sabine,1/1/2004,9241,8619,622,6.7,146842,138472,8370,5.7
Sabine,2/1/2004,9078,8542,536,5.9,146709,138542,8167,5.6
Sabine,3/1/2004,9100,8538,562,6.2,146944,138453,8491,5.8
Sabine,4/1/2004,9188,8670,518,5.6,146850,138680,8170,5.6
Sabine,5/1/2004,9152,8614,538,5.9,147065,138852,8212,5.6
Sabine,6/1/2004,9258,8612,646,7,147460,139174,8286,5.6
Sabine,7/1/2004,9435,8862,573,6.1,147692,139556,8136,5.5
Sabine,8/1/2004,9369,8869,500,5.3,147564,139573,7990,5.4
Sabine,9/1/2004,9280,8751,529,5.7,147415,139487,7927,5.4
Sabine,10/1/2004,9553,9040,513,5.4,147793,139732,8061,5.5
Sabine,11/1/2004,9429,8906,523,5.5,148162,140231,7932,5.4
Sabine,12/1/2004,9284,8758,526,5.7,148059,140125,7934,5.4
Sabine,1/1/2005,9245,8627,618,6.7,148029,140245,7784,5.3
Sabine,2/1/2005,9061,8507,554,6.1,148364,140385,7980,5.4
Sabine,3/1/2005,9078,8541,537,5.9,148391,140654,7737,5.2
Sabine,4/1/2005,9297,8805,492,5.3,148926,141254,7672,5.2
Sabine,5/1/2005,9325,8829,496,5.3,149261,141609,7651,5.1
Sabine,6/1/2005,9486,8903,583,6.1,149238,141714,7524,5
Sabine,7/1/2005,9482,8957,525,5.5,149432,142026,7406,5
Sabine,8/1/2005,9321,8823,498,5.3,149779,142434,7345,4.9
Sabine,9/1/2005,10072,9358,714,7.1,149954,142401,7553,5
Sabine,10/1/2005,10384,9657,727,7,150001,142548,7453,5
Sabine,11/1/2005,10013,9295,718,7.2,150065,142499,7566,5
Sabine,12/1/2005,9571,9138,433,4.5,150030,142752,7279,4.9
Sabine,1/1/2006,9709,9329,380,3.9,150214,143150,7064,4.7
Sabine,2/1/2006,9647,9337,310,3.2,150641,143457,7184,4.8
Sabine,3/1/2006,9669,9368,301,3.1,150813,143741,7072,4.7
Sabine,4/1/2006,9833,9537,296,3,150881,143761,7120,4.7
Sabine,5/1/2006,9726,9393,333,3.4,151069,144089,6980,4.6
Sabine,6/1/2006,9847,9435,412,4.2,151354,144353,7001,4.6
Sabine,7/1/2006,9829,9475,354,3.6,151377,144202,7175,4.7
Sabine,8/1/2006,9644,9291,353,3.7,151716,144625,7091,4.7
Sabine,9/1/2006,9710,9351,359,3.7,151662,144815,6847,4.5
Sabine,10/1/2006,9713,9344,369,3.8,152041,145314,6727,4.4
Sabine,11/1/2006,9620,9232,388,4,152406,145534,6872,4.5
Sabine,12/1/2006,9400,8996,404,4.3,152732,145970,6762,4.4
Sabine,1/1/2007,9363,8928,435,4.6,153144,146028,7116,4.6
Sabine,2/1/2007,9377,8994,383,4.1,152983,146057,6927,4.5
Sabine,3/1/2007,9445,9054,391,4.1,153051,146320,6731,4.4
Sabine,4/1/2007,9440,9072,368,3.9,152435,145586,6850,4.5
Sabine,5/1/2007,9313,8909,404,4.3,152670,145903,6766,4.4
Sabine,6/1/2007,9515,9039,476,5,153041,146063,6979,4.6
Sabine,7/1/2007,9570,9138,432,4.5,153054,145905,7149,4.7
Sabine,8/1/2007,9621,9220,401,4.2,152749,145682,7067,4.6
Sabine,9/1/2007,9706,9277,429,4.4,153414,146244,7170,4.7
Sabine,10/1/2007,9480,9112,368,3.9,153183,145946,7237,4.7
Sabine,11/1/2007,9458,9069,389,4.1,153835,146595,7240,4.7
Sabine,12/1/2007,9385,8974,411,4.4,153918,146273,7645,5
Sabine,1/1/2008,9456,9005,451,4.8,154063,146378,7685,5
Sabine,2/1/2008,9368,8999,369,3.9,153653,146156,7497,4.9
Sabine,3/1/2008,9646,9244,402,4.2,153908,146086,7822,5.1
Sabine,4/1/2008,9620,9260,360,3.7,153769,146132,7637,5
Sabine,5/1/2008,9547,9118,429,4.5,154303,145908,8395,5.4
Sabine,6/1/2008,9648,9131,517,5.4,154313,145737,8575,5.6
Sabine,7/1/2008,9800,9318,482,4.9,154469,145532,8937,5.8
Sabine,8/1/2008,9748,9263,485,5,154641,145203,9438,6.1
Sabine,9/1/2008,9733,9282,451,4.6,154570,145076,9494,6.1
Sabine,10/1/2008,9692,9213,479,4.9,154876,144802,10074,6.5
Sabine,11/1/2008,9721,9216,505,5.2,154639,144100,10538,6.8
Sabine,12/1/2008,9445,8902,543,5.7,154655,143369,11286,7.3
Sabine,1/1/2009,9392,8731,661,7,154210,142152,12058,7.8
Sabine,2/1/2009,9467,8596,871,9.2,154538,141640,12898,8.3
Sabine,3/1/2009,9631,8776,855,8.9,154133,140707,13426,8.7
Sabine,4/1/2009,9685,8967,718,7.4,154509,140656,13853,9
Sabine,5/1/2009,9796,9031,765,7.8,154747,140248,14499,9.4
Sabine,6/1/2009,9827,8952,875,8.9,154716,140009,14707,9.5
Sabine,7/1/2009,9645,8807,838,8.7,154502,139901,14601,9.5
Sabine,8/1/2009,9409,8620,789,8.4,154307,139492,14814,9.6
Sabine,9/1/2009,9303,8568,735,7.9,153827,138818,15009,9.8
Sabine,10/1/2009,9415,8703,712,7.6,153784,138432,15352,10
Sabine,11/1/2009,9387,8744,643,6.8,153878,138659,15219,9.9
Sabine,12/1/2009,9322,8647,675,7.2,153111,138013,15098,9.9
Sabine,1/1/2010,9285,8565,720,7.8,153484,138438,15046,9.8
Sabine,2/1/2010,9439,8820,619,6.6,153694,138581,15113,9.8
Sabine,3/1/2010,9539,8943,596,6.2,153954,138751,15202,9.9
Sabine,4/1/2010,9604,9013,591,6.2,154622,139297,15325,9.9
Sabine,5/1/2010,9674,9056,618,6.4,154091,139241,14849,9.6
Sabine,6/1/2010,9879,9170,709,7.2,153616,139141,14474,9.4
Sabine,7/1/2010,10045,9370,675,6.7,153691,139179,14512,9.4
Sabine,8/1/2010,9893,9194,699,7.1,154086,139438,14648,9.5
Sabine,9/1/2010,9692,9027,665,6.9,153975,139396,14579,9.5
Sabine,10/1/2010,9822,9133,689,7,153635,139119,14516,9.4
Sabine,11/1/2010,9818,9156,662,6.7,154125,139044,15081,9.8
Sabine,12/1/2010,9643,9002,641,6.6,153650,139301,14348,9.3
Sabine,1/1/2011,9247,8531,716,7.7,153263,139250,14013,9.1
Sabine,2/1/2011,9354,8718,636,6.8,153214,139394,13820,9
Sabine,3/1/2011,9406,8791,615,6.5,153376,139639,13737,9
Sabine,4/1/2011,9523,8921,602,6.3,153543,139586,13957,9.1
Sabine,5/1/2011,9666,9040,626,6.5,153479,139624,13855,9
Sabine,6/1/2011,9777,9083,694,7.1,153346,139384,13962,9.1
Sabine,7/1/2011,9833,9154,679,6.9,153288,139524,13763,9
Sabine,8/1/2011,9530,8910,620,6.5,153760,139942,13818,9
Sabine,9/1/2011,9530,8899,631,6.6,154131,140183,13948,9
Sabine,10/1/2011,9455,8818,637,6.7,153961,140368,13594,8.8
Sabine,11/1/2011,9405,8809,596,6.3,154128,140826,13302,8.6
Sabine,12/1/2011,9436,8837,599,6.3,153995,140902,13093,8.5
Sabine,1/1/2012,9086,8421,665,7.3,154381,141584,12797,8.3
Sabine,2/1/2012,9191,8577,614,6.7,154671,141858,12813,8.3
Sabine,3/1/2012,9177,8576,601,6.5,154749,142036,12713,8.2
Sabine,4/1/2012,9321,8743,578,6.2,154545,141899,12646,8.2
Sabine,5/1/2012,9424,8760,664,7,154866,142206,12660,8.2
Sabine,6/1/2012,9448,8730,718,7.6,155083,142391,12692,8.2
Sabine,7/1/2012,9556,8899,657,6.9,154948,142292,12656,8.2
Sabine,8/1/2012,9215,8616,599,6.5,154763,142291,12471,8.1
Sabine,9/1/2012,9181,8618,563,6.1,155160,143044,12115,7.8
Sabine,10/1/2012,9231,8663,568,6.2,155554,143431,12124,7.8
Sabine,11/1/2012,9178,8657,521,5.7,155338,143333,12005,7.7
Sabine,12/1/2012,9186,8607,579,6.3,155628,143330,12298,7.9
Sabine,1/1/2013,9122,8422,700,7.7,155763,143292,12471,8
Sabine,2/1/2013,9052,8450,602,6.7,155312,143362,11950,7.7
Sabine,3/1/2013,9028,8452,576,6.4,155005,143316,11689,7.5
Sabine,4/1/2013,9188,8611,577,6.3,155394,143635,11760,7.6
Sabine,5/1/2013,9351,8735,616,6.6,155536,143882,11654,7.5
Sabine,6/1/2013,9419,8737,682,7.2,155749,143999,11751,7.5
Sabine,7/1/2013,9568,8911,657,6.9,155599,144264,11335,7.3
Sabine,8/1/2013,9260,8658,602,6.5,155605,144326,11279,7.2
Sabine,9/1/2013,9267,8679,588,6.3,155687,144418,11270,7.2
Sabine,10/1/2013,9127,8562,565,6.2,154673,143537,11136,7.2
Sabine,11/1/2013,8970,8468,502,5.6,155265,144479,10787,6.9
Sabine,12/1/2013,8953,8500,453,5.1,155182,144778,10404,6.7
Sabine,1/1/2014,8930,8416,514,5.8,155352,145150,10202,6.6
Sabine,2/1/2014,8878,8400,478,5.4,155483,145134,10349,6.7
Sabine,3/1/2014,8927,8406,521,5.8,156028,145648,10380,6.7
Sabine,4/1/2014,8978,8512,466,5.2,155369,145667,9702,6.2
Sabine,5/1/2014,9023,8479,544,6,155684,145825,9859,6.3
Sabine,6/1/2014,9342,8722,620,6.6,155707,146247,9460,6.1
Sabine,7/1/2014,9485,8792,693,7.3,156007,146399,9608,6.2
Sabine,8/1/2014,9203,8523,680,7.4,156130,146530,9599,6.1
Sabine,9/1/2014,9261,8611,650,7,156040,146778,9262,5.9
Sabine,10/1/2014,9349,8695,654,7,156417,147427,8990,5.7
Sabine,11/1/2014,9278,8636,642,6.9,156494,147404,9090,5.8
Sabine,12/1/2014,9284,8699,585,6.3,156332,147615,8717,5.6
Sabine,1/1/2015,9395,8694,701,7.5,157030,148145,8885,5.7
Sabine,2/1/2015,9408,8739,669,7.1,156644,148045,8599,5.5
Sabine,3/1/2015,9418,8759,659,7,156643,148128,8515,5.4
Sabine,4/1/2015,9434,8781,653,6.9,157060,148511,8550,5.4
Sabine,5/1/2015,9496,8803,693,7.3,157651,148817,8834,5.6
Sabine,6/1/2015,9690,8936,754,7.8,157062,148816,8247,5.3
Sabine,7/1/2015,9731,9016,715,7.3,156997,148830,8167,5.2
Sabine,8/1/2015,9435,8769,666,7.1,157172,149181,7992,5.1
Sabine,9/1/2015,9322,8661,661,7.1,156733,148826,7907,5
Sabine,10/1/2015,9292,8637,655,7,157167,149246,7922,5
Sabine,11/1/2015,9241,8641,600,6.5,157463,149463,8000,5.1
Sabine,12/1/2015,9288,8715,573,6.2,158035,150128,7907,5
Sabine,1/1/2016,9215,8557,658,7.1,158280,150653,7627,4.8
Sabine,2/1/2016,9282,8651,631,6.8,158640,150939,7702,4.9
Sabine,3/1/2016,9334,8689,645,6.9,159179,151218,7961,5
Sabine,4/1/2016,9176,8558,618,6.7,159141,151074,8067,5.1
Sabine,5/1/2016,9265,8632,633,6.8,158784,151132,7652,4.8
Sabine,6/1/2016,9443,8713,730,7.7,158967,151223,7744,4.9
Sabine,7/1/2016,9422,8729,693,7.4,159194,151554,7641,4.8
Sabine,8/1/2016,9056,8410,646,7.1,159562,151779,7784,4.9
Sabine,9/1/2016,9009,8353,656,7.3,159714,151761,7953,5
Sabine,10/1/2016,8798,8220,578,6.6,159605,151793,7811,4.9
Sabine,11/1/2016,8823,8279,544,6.2,159506,151954,7553,4.7
Sabine,12/1/2016,8802,8284,518,5.9,159678,152157,7521,4.7
Sabine,1/1/2017,8680,8097,583,6.7,159620,152152,7468,4.7
Sabine,2/1/2017,8603,8095,508,5.9,159859,152480,7379,4.6
Sabine,3/1/2017,8729,8232,497,5.7,160137,153065,7073,4.4
Sabine,4/1/2017,8903,8428,475,5.3,160345,153255,7089,4.4
Sabine,5/1/2017,8879,8407,472,5.3,160068,153069,7000,4.4
Sabine,6/1/2017,9115,8584,531,5.8,160192,153318,6873,4.3
Sabine,7/1/2017,9103,8581,522,5.7,160462,153569,6892,4.3
Sabine,8/1/2017,8867,8369,498,5.6,160586,153503,7082,4.4
Sabine,9/1/2017,8889,8417,472,5.3,161140,154286,6854,4.3
Sabine,10/1/2017,8681,8268,413,4.8,160309,153609,6700,4.2
Sabine,11/1/2017,8634,8202,432,5,160579,153805,6774,4.2
Sabine,12/1/2017,8724,8307,417,4.8,160535,153904,6632,4.1
Sabine,1/1/2018,8818,8346,472,5.4,160914,154425,6489,4
Sabine,2/1/2018,8815,8391,424,4.8,161778,155197,6581,4.1
Sabine,3/1/2018,8920,8480,440,4.9,161686,155214,6472,4
Sabine,4/1/2018,9065,8633,432,4.8,161771,155312,6459,4
Sabine,5/1/2018,9191,8732,459,5,161848,155652,6196,3.8
Sabine,6/1/2018,9380,8791,589,6.3,162210,155762,6447,4
Sabine,7/1/2018,9239,8710,529,5.7,162341,156146,6195,3.8
Sabine,8/1/2018,8916,8443,473,5.3,161660,155504,6156,3.8
Sabine,9/1/2018,9119,8664,455,5,162087,156015,6073,3.7
Sabine,10/1/2018,8959,8532,427,4.8,162602,156391,6211,3.8
Sabine,11/1/2018,8944,8530,414,4.6,162836,156721,6115,3.8
Sabine,12/1/2018,8940,8521,419,4.7,163206,156817,6389,3.9
Sabine,1/1/2019,8954,8457,497,5.6,162963,156487,6475,4
Sabine,2/1/2019,9020,8599,421,4.7,162999,156863,6136,3.8
Sabine,3/1/2019,9083,8686,397,4.4,162904,156701,6202,3.8
Sabine,4/1/2019,9094,8730,364,4,162586,156625,5961,3.7
Sabine,5/1/2019,9207,8784,423,4.6,162751,156821,5930,3.6
Sabine,6/1/2019,9307,8807,500,5.4,163168,157232,5935,3.6
Sabine,7/1/2019,9433,8924,509,5.4,163590,157529,6061,3.7
Sabine,8/1/2019,9391,8915,476,5.1,163774,157829,5945,3.6
Sabine,9/1/2019,9426,8952,474,5,164092,158339,5753,3.5
Sabine,10/1/2019,9340,8877,463,5,164416,158545,5871,3.6
Sabine,11/1/2019,9167,8706,461,5,164496,158629,5868,3.6
Sabine,12/1/2019,9107,8687,420,4.6,164699,158845,5853,3.6
Sabine,1/1/2020,9100,8643,457,5,164377,158508,5869,3.6
Sabine,2/1/2020,9127,8765,362,4,164467,158714,5753,3.5
Sabine,3/1/2020,9375,8745,630,6.7,162559,155353,7206,4.4
Sabine,4/1/2020,8819,8235,584,6.6,156269,133185,23084,14.8
Sabine,5/1/2020,8815,8219,596,6.8,158101,137173,20929,13.2
Sabine,6/1/2020,9053,8391,662,7.3,159994,142342,17652,11
Sabine,7/1/2020,9086,8434,652,7.2,160132,143779,16352,10.2
Sabine,8/1/2020,9145,8589,556,6.1,160706,147245,13461,8.4
Sabine,9/1/2020,9342,8777,565,6,160174,147620,12554,7.8
Sabine,10/1/2020,9396,8892,504,5.4,161003,149931,11072,6.9
Sabine,11/1/2020,9159,8722,437,4.8,160629,149934,10694,6.7
Sabine,12/1/2020,9303,8834,469,5,160745,149975,10770,6.7
Sabine,1/1/2021,9159,8698,461,5,160088,149852,10236,6.4
Sabine,2/1/2021,9166,8742,424,4.6,160184,150189,9995,6.2
Sabine,3/1/2021,9181,8775,406,4.4,160400,150644,9756,6.1
Sabine,4/1/2021,9300,8937,363,3.9,160843,151081,9762,6.1
Sabine,5/1/2021,9168,8800,368,4,160800,151535,9266,5.8
Sabine,6/1/2021,9279,8846,433,4.7,161197,151734,9462,5.9
Sabine,7/1/2021,9267,8882,385,4.2,161504,152773,8731,5.4
Sabine,8/1/2021,9091,8745,346,3.8,161527,153250,8276,5.1
Sabine,9/1/2021,9379,9060,319,3.4,161495,153843,7652,4.7
Sabine,10/1/2021,9173,8879,294,3.2,161754,154475,7279,4.5
Sabine,11/1/2021,9051,8795,256,2.8,162281,155530,6751,4.2
Sabine,12/1/2021,9079,8847,232,2.6,162497,156099,6398,3.9
Sabine,1/1/2022,9102,8811,291,3.2,163627,157115,6512,4
Sabine,2/1/2022,9143,8880,263,2.9,163899,157598,6301,3.8
Sabine,3/1/2022,9195,8921,274,3,164220,158206,6014,3.7
Sabine,4/1/2022,9258,8998,260,2.8,163893,157891,6002,3.7
Sabine,5/1/2022,9284,9002,282,3,164362,158378,5983,3.6
Sabine,6/1/2022,9445,9056,389,4.1,164046,158094,5951,3.6
Sabine,7/1/2022,9383,9043,340,3.6,164026,158258,5768,3.5
Sabine,8/1/2022,9100,8791,309,3.4,164654,158735,5919,3.6
Sabine,9/1/2022,9239,8931,308,3.3,164602,158810,5792,3.5
Sabine,10/1/2022,9147,8843,304,3.3,164648,158684,5964,3.6
Sabine,11/1/2022,9091,8810,281,3.1,164450,158507,5943,3.6
Sabine,12/1/2022,9046,8752,294,3.3,165025,159259,5766,3.5
Sabine,1/1/2023,9137,8798,339,3.7,165964,160217,5747,3.5
Sabine,2/1/2023,9184,8840,344,3.7,166358,160395,5962,3.6
Sabine,3/1/2023,9353,9035,318,3.4,166651,160812,5839,3.5
Sabine,4/1/2023,9268,8978,290,3.1,166725,160974,5751,3.4
Sabine,5/1/2023,9187,8860,327,3.6,166886,160796,6089,3.6
Sabine,6/1/2023,9495,9097,398,4.2,166937,160979,5958,3.6
Sabine,7/1/2023,9445,9096,349,3.7,167103,161183,5920,3.5
Sabine,8/1/2023,9243,8873,370,4,167759,161475,6284,3.7
Sabine,9/1/2023,9524,9127,397,4.2,167767,161442,6326,3.8
Sabine,10/1/2023,9442,9059,383,4.1,167690,161211,6479,3.9
Sabine,11/1/2023,9433,9063,370,3.9,168140,161886,6254,3.7
Sabine,12/1/2023,9454,9054,400,4.2,167439,161124,6315,3.8
Sabine,1/1/2024,9453,9013,440,4.7,167339,161190,6149,3.7
Sabine,2/1/2024,9347,8911,436,4.7,167475,161013,6462,3.9
Sabine,3/1/2024,9363,8935,428,4.6,167922,161425,6497,3.9
Sabine,4/1/2024,9381,9023,358,3.8,167988,161495,6492,3.9
Sabine,5/1/2024,9315,8924,391,4.2,167799,161164,6635,4
Sabine,6/1/2024,9369,8889,480,5.1,168005,161155,6849,4.1
Sabine,7/1/2024,9394,8954,440,4.7,168315,161219,7097,4.2
Sabine,8/1/2024,9202,8752,450,4.9,168496,161425,7071,4.2
Sabine,9/1/2024,9139,8685,454,5,168703,161802,6901,4.1
Sabine,10/1/2024,9060,8611,449,5,168428,161456,6972,4.1
Sabine,11/1/2024,8908,8474,434,4.9,168304,161183,7121,4.2
Sabine,12/1/2024,8905,8498,407,4.6,168547,161661,6886,4.1
Sabine,1/1/2025,7721,7312,409,5.3,170744,163895,6849,4
Sabine,2/1/2025,7639,7242,397,5.2,170359,163307,7052,4.1
St. Bernard,1/1/1990,30400,27994,2406,7.9,125833,119081,6752,5.4
St. Bernard,2/1/1990,30632,28229,2403,7.8,125710,119059,6651,5.3
St. Bernard,3/1/1990,30618,28463,2155,7,125801,119203,6598,5.2
St. Bernard,4/1/1990,30859,28663,2196,7.1,125649,118852,6797,5.4
St. Bernard,5/1/1990,31129,28885,2244,7.2,125893,119151,6742,5.4
St. Bernard,6/1/1990,32107,29201,2906,9.1,125573,118983,6590,5.2
St. Bernard,7/1/1990,31707,29005,2702,8.5,125732,118810,6922,5.5
St. Bernard,8/1/1990,30973,28525,2448,7.9,125990,118802,7188,5.7
St. Bernard,9/1/1990,30831,28304,2527,8.2,125892,118524,7368,5.9
St. Bernard,10/1/1990,31168,28766,2402,7.7,125995,118536,7459,5.9
St. Bernard,11/1/1990,31288,28682,2606,8.3,126070,118306,7764,6.2
St. Bernard,12/1/1990,30982,28562,2420,7.8,126142,118241,7901,6.3
St. Bernard,1/1/1991,30940,28260,2680,8.7,125955,117940,8015,6.4
St. Bernard,2/1/1991,30984,28434,2550,8.2,126020,117755,8265,6.6
St. Bernard,3/1/1991,30960,28560,2400,7.8,126238,117652,8586,6.8
St. Bernard,4/1/1991,31304,28983,2321,7.4,126548,118109,8439,6.7
St. Bernard,5/1/1991,31465,28906,2559,8.1,126176,117440,8736,6.9
St. Bernard,6/1/1991,32399,29360,3039,9.4,126331,117639,8692,6.9
St. Bernard,7/1/1991,32056,29190,2866,8.9,126154,117568,8586,6.8
St. Bernard,8/1/1991,31162,28624,2538,8.1,126150,117484,8666,6.9
St. Bernard,9/1/1991,31110,28642,2468,7.9,126650,117928,8722,6.9
St. Bernard,10/1/1991,31511,29057,2454,7.8,126642,117800,8842,7
St. Bernard,11/1/1991,31823,29044,2779,8.7,126701,117770,8931,7
St. Bernard,12/1/1991,31501,28843,2658,8.4,126664,117466,9198,7.3
St. Bernard,1/1/1992,31455,28651,2804,8.9,127261,117978,9283,7.3
St. Bernard,2/1/1992,31633,28776,2857,9,127207,117753,9454,7.4
St. Bernard,3/1/1992,31629,28969,2660,8.4,127604,118144,9460,7.4
St. Bernard,4/1/1992,32256,29272,2984,9.3,127841,118426,9415,7.4
St. Bernard,5/1/1992,32393,29311,3082,9.5,128119,118375,9744,7.6
St. Bernard,6/1/1992,33481,29676,3805,11.4,128459,118419,10040,7.8
St. Bernard,7/1/1992,31432,27432,4000,12.7,128563,118713,9850,7.7
St. Bernard,8/1/1992,30118,26858,3260,10.8,128613,118826,9787,7.6
St. Bernard,9/1/1992,29997,26688,3309,11,128501,118720,9781,7.6
St. Bernard,10/1/1992,29945,27023,2922,9.8,128026,118628,9398,7.3
St. Bernard,11/1/1992,30139,27077,3062,10.2,128441,118876,9565,7.4
St. Bernard,12/1/1992,30915,27867,3048,9.9,128554,118997,9557,7.4
St. Bernard,1/1/1993,30956,27635,3321,10.7,128400,119075,9325,7.3
St. Bernard,2/1/1993,30961,27923,3038,9.8,128458,119275,9183,7.1
St. Bernard,3/1/1993,31078,28074,3004,9.7,128598,119542,9056,7
St. Bernard,4/1/1993,31237,28299,2938,9.4,128584,119474,9110,7.1
St. Bernard,5/1/1993,31569,28558,3011,9.5,129264,120115,9149,7.1
St. Bernard,6/1/1993,32339,28830,3509,10.9,129411,120290,9121,7
St. Bernard,7/1/1993,31881,28491,3390,10.6,129397,120467,8930,6.9
St. Bernard,8/1/1993,30973,28026,2947,9.5,129619,120856,8763,6.8
St. Bernard,9/1/1993,30665,27920,2745,9,129268,120554,8714,6.7
St. Bernard,10/1/1993,31434,28421,3013,9.6,129573,120823,8750,6.8
St. Bernard,11/1/1993,31640,28582,3058,9.7,129711,121169,8542,6.6
St. Bernard,12/1/1993,31186,28498,2688,8.6,129941,121464,8477,6.5
St. Bernard,1/1/1994,31371,28356,3015,9.6,130596,121966,8630,6.6
St. Bernard,2/1/1994,31701,28660,3041,9.6,130669,122086,8583,6.6
St. Bernard,3/1/1994,31458,28781,2677,8.5,130400,121930,8470,6.5
St. Bernard,4/1/1994,31782,28981,2801,8.8,130621,122290,8331,6.4
St. Bernard,5/1/1994,32141,29200,2941,9.2,130779,122864,7915,6.1
St. Bernard,6/1/1994,32793,29366,3427,10.5,130561,122634,7927,6.1
St. Bernard,7/1/1994,32622,29137,3485,10.7,130652,122706,7946,6.1
St. Bernard,8/1/1994,31915,28744,3171,9.9,131275,123342,7933,6
St. Bernard,9/1/1994,31590,28802,2788,8.8,131421,123687,7734,5.9
St. Bernard,10/1/1994,32050,29176,2874,9,131744,124112,7632,5.8
St. Bernard,11/1/1994,32122,29372,2750,8.6,131891,124516,7375,5.6
St. Bernard,12/1/1994,31975,29165,2810,8.8,131951,124721,7230,5.5
St. Bernard,1/1/1995,31729,28818,2911,9.2,132038,124663,7375,5.6
St. Bernard,2/1/1995,31954,29059,2895,9.1,132115,124928,7187,5.4
St. Bernard,3/1/1995,32129,29302,2827,8.8,132108,124955,7153,5.4
St. Bernard,4/1/1995,32588,29452,3136,9.6,132590,124945,7645,5.8
St. Bernard,5/1/1995,32521,29521,3000,9.2,131851,124421,7430,5.6
St. Bernard,6/1/1995,33400,29704,3696,11.1,131949,124522,7427,5.6
St. Bernard,7/1/1995,33068,29524,3544,10.7,132343,124816,7527,5.7
St. Bernard,8/1/1995,31885,28981,2904,9.1,132336,124852,7484,5.7
St. Bernard,9/1/1995,31814,29065,2749,8.6,132611,125133,7478,5.6
St. Bernard,10/1/1995,31916,29319,2597,8.1,132716,125388,7328,5.5
St. Bernard,11/1/1995,31937,29428,2509,7.9,132614,125188,7426,5.6
St. Bernard,12/1/1995,31702,29198,2504,7.9,132511,125088,7423,5.6
St. Bernard,1/1/1996,31720,28938,2782,8.8,132616,125125,7491,5.6
St. Bernard,2/1/1996,31604,29286,2318,7.3,132952,125639,7313,5.5
St. Bernard,3/1/1996,31815,29611,2204,6.9,133180,125862,7318,5.5
St. Bernard,4/1/1996,32041,29786,2255,7,133409,125994,7415,5.6
St. Bernard,5/1/1996,32395,29986,2409,7.4,133667,126244,7423,5.6
St. Bernard,6/1/1996,33102,30228,2874,8.7,133697,126602,7095,5.3
St. Bernard,7/1/1996,32958,30033,2925,8.9,134284,126947,7337,5.5
St. Bernard,8/1/1996,31898,29544,2354,7.4,134054,127172,6882,5.1
St. Bernard,9/1/1996,32147,29765,2382,7.4,134515,127536,6979,5.2
St. Bernard,10/1/1996,32286,30006,2280,7.1,134921,127890,7031,5.2
St. Bernard,11/1/1996,32517,30154,2363,7.3,135007,127771,7236,5.4
St. Bernard,12/1/1996,32256,30042,2214,6.9,135113,127860,7253,5.4
St. Bernard,1/1/1997,31796,29665,2131,6.7,135456,128298,7158,5.3
St. Bernard,2/1/1997,32010,29822,2188,6.8,135400,128298,7102,5.2
St. Bernard,3/1/1997,32218,30242,1976,6.1,135891,128891,7000,5.2
St. Bernard,4/1/1997,32246,30433,1813,5.6,136016,129143,6873,5.1
St. Bernard,5/1/1997,32559,30591,1968,6,136119,129464,6655,4.9
St. Bernard,6/1/1997,33078,30660,2418,7.3,136211,129412,6799,5
St. Bernard,7/1/1997,32890,30553,2337,7.1,136477,129822,6655,4.9
St. Bernard,8/1/1997,32027,30016,2011,6.3,136618,130010,6608,4.8
St. Bernard,9/1/1997,32042,30081,1961,6.1,136675,130019,6656,4.9
St. Bernard,10/1/1997,32341,30358,1983,6.1,136633,130179,6454,4.7
St. Bernard,11/1/1997,32558,30662,1896,5.8,136961,130653,6308,4.6
St. Bernard,12/1/1997,32316,30585,1731,5.4,137155,130679,6476,4.7
St. Bernard,1/1/1998,31849,30031,1818,5.7,137095,130726,6368,4.6
St. Bernard,2/1/1998,31892,30275,1617,5.1,137112,130807,6306,4.6
St. Bernard,3/1/1998,32235,30579,1656,5.1,137236,130814,6422,4.7
St. Bernard,4/1/1998,32494,30854,1640,5,137150,131209,5941,4.3
St. Bernard,5/1/1998,32823,31029,1794,5.5,137372,131325,6047,4.4
St. Bernard,6/1/1998,33288,31007,2281,6.9,137455,131244,6212,4.5
St. Bernard,7/1/1998,32956,30735,2221,6.7,137588,131329,6259,4.5
St. Bernard,8/1/1998,32087,30126,1961,6.1,137570,131390,6179,4.5
St. Bernard,9/1/1998,32168,30309,1859,5.8,138286,131986,6300,4.6
St. Bernard,10/1/1998,32170,30416,1754,5.5,138279,131999,6280,4.5
St. Bernard,11/1/1998,32414,30612,1802,5.6,138381,132280,6100,4.4
St. Bernard,12/1/1998,32249,30543,1706,5.3,138634,132602,6032,4.4
St. Bernard,1/1/1999,31832,30135,1697,5.3,139003,133027,5976,4.3
St. Bernard,2/1/1999,31776,30304,1472,4.6,138967,132856,6111,4.4
St. Bernard,3/1/1999,31997,30581,1416,4.4,138730,132947,5783,4.2
St. Bernard,4/1/1999,31892,30632,1260,4,138959,132955,6004,4.3
St. Bernard,5/1/1999,32146,30758,1388,4.3,139107,133311,5796,4.2
St. Bernard,6/1/1999,32614,30813,1801,5.5,139329,133378,5951,4.3
St. Bernard,7/1/1999,32335,30537,1798,5.6,139439,133414,6025,4.3
St. Bernard,8/1/1999,31677,29929,1748,5.5,139430,133591,5838,4.2
St. Bernard,9/1/1999,31744,30012,1732,5.5,139622,133707,5915,4.2
St. Bernard,10/1/1999,31902,30242,1660,5.2,139771,133993,5778,4.1
St. Bernard,11/1/1999,32178,30535,1643,5.1,140025,134309,5716,4.1
St. Bernard,12/1/1999,31887,30359,1528,4.8,140177,134523,5653,4
St. Bernard,1/1/2000,31937,30179,1758,5.5,142267,136559,5708,4
St. Bernard,2/1/2000,32016,30405,1611,5,142456,136598,5858,4.1
St. Bernard,3/1/2000,32250,30672,1578,4.9,142434,136701,5733,4
St. Bernard,4/1/2000,32248,30851,1397,4.3,142751,137270,5481,3.8
St. Bernard,5/1/2000,32448,30806,1642,5.1,142388,136630,5758,4
St. Bernard,6/1/2000,32818,30808,2010,6.1,142591,136940,5651,4
St. Bernard,7/1/2000,32389,30510,1879,5.8,142278,136531,5747,4
St. Bernard,8/1/2000,31658,29841,1817,5.7,142514,136662,5853,4.1
St. Bernard,9/1/2000,31602,29937,1665,5.3,142518,136893,5625,3.9
St. Bernard,10/1/2000,31739,30071,1668,5.3,142622,137088,5534,3.9
St. Bernard,11/1/2000,32044,30305,1739,5.4,142962,137322,5639,3.9
St. Bernard,12/1/2000,31888,30294,1594,5,143248,137614,5634,3.9
St. Bernard,1/1/2001,31637,29812,1825,5.8,143800,137778,6023,4.2
St. Bernard,2/1/2001,31707,29979,1728,5.4,143701,137612,6089,4.2
St. Bernard,3/1/2001,31945,30296,1649,5.2,143924,137783,6141,4.3
St. Bernard,4/1/2001,31763,30221,1542,4.9,143569,137299,6271,4.4
St. Bernard,5/1/2001,31941,30275,1666,5.2,143318,137092,6226,4.3
St. Bernard,6/1/2001,32213,30272,1941,6,143357,136873,6484,4.5
St. Bernard,7/1/2001,31957,30135,1822,5.7,143654,137071,6583,4.6
St. Bernard,8/1/2001,31076,29280,1796,5.8,143284,136241,7042,4.9
St. Bernard,9/1/2001,31318,29565,1753,5.6,143989,136846,7142,5
St. Bernard,10/1/2001,31333,29522,1811,5.8,144086,136392,7694,5.3
St. Bernard,11/1/2001,31647,29730,1917,6.1,144240,136238,8003,5.5
St. Bernard,12/1/2001,31317,29516,1801,5.8,144305,136047,8258,5.7
St. Bernard,1/1/2002,30811,28858,1953,6.3,143883,135701,8182,5.7
St. Bernard,2/1/2002,31009,29218,1791,5.8,144653,136438,8215,5.7
St. Bernard,3/1/2002,31137,29450,1687,5.4,144481,136177,8304,5.7
St. Bernard,4/1/2002,31177,29515,1662,5.3,144725,136126,8599,5.9
St. Bernard,5/1/2002,31510,29608,1902,6,144938,136539,8399,5.8
St. Bernard,6/1/2002,31814,29651,2163,6.8,144808,136415,8393,5.8
St. Bernard,7/1/2002,31551,29516,2035,6.4,144803,136413,8390,5.8
St. Bernard,8/1/2002,30838,28884,1954,6.3,145009,136705,8304,5.7
St. Bernard,9/1/2002,30947,29212,1735,5.6,145552,137302,8251,5.7
St. Bernard,10/1/2002,30855,29138,1717,5.6,145314,137008,8307,5.7
St. Bernard,11/1/2002,31149,29341,1808,5.8,145041,136521,8520,5.9
St. Bernard,12/1/2002,30900,29131,1769,5.7,145066,136426,8640,6
St. Bernard,1/1/2003,30596,28632,1964,6.4,145937,137417,8520,5.8
St. Bernard,2/1/2003,30828,28926,1902,6.2,146100,137482,8618,5.9
St. Bernard,3/1/2003,30923,29182,1741,5.6,146022,137434,8588,5.9
St. Bernard,4/1/2003,30960,29265,1695,5.5,146474,137633,8842,6
St. Bernard,5/1/2003,31216,29297,1919,6.1,146500,137544,8957,6.1
St. Bernard,6/1/2003,31607,29351,2256,7.1,147056,137790,9266,6.3
St. Bernard,7/1/2003,31196,29132,2064,6.6,146485,137474,9011,6.2
St. Bernard,8/1/2003,30357,28450,1907,6.3,146445,137549,8896,6.1
St. Bernard,9/1/2003,30392,28683,1709,5.6,146530,137609,8921,6.1
St. Bernard,10/1/2003,30554,28792,1762,5.8,146716,137984,8732,6
St. Bernard,11/1/2003,30844,29149,1695,5.5,147000,138424,8576,5.8
St. Bernard,12/1/2003,30512,28967,1545,5.1,146729,138411,8317,5.7
St. Bernard,1/1/2004,30286,28415,1871,6.2,146842,138472,8370,5.7
St. Bernard,2/1/2004,30338,28715,1623,5.3,146709,138542,8167,5.6
St. Bernard,3/1/2004,30473,28993,1480,4.9,146944,138453,8491,5.8
St. Bernard,4/1/2004,30510,29117,1393,4.6,146850,138680,8170,5.6
St. Bernard,5/1/2004,30718,29193,1525,5,147065,138852,8212,5.6
St. Bernard,6/1/2004,31091,29307,1784,5.7,147460,139174,8286,5.6
St. Bernard,7/1/2004,31006,29291,1715,5.5,147692,139556,8136,5.5
St. Bernard,8/1/2004,30170,28669,1501,5,147564,139573,7990,5.4
St. Bernard,9/1/2004,30319,28810,1509,5,147415,139487,7927,5.4
St. Bernard,10/1/2004,30402,28900,1502,4.9,147793,139732,8061,5.5
St. Bernard,11/1/2004,30927,29320,1607,5.2,148162,140231,7932,5.4
St. Bernard,12/1/2004,30683,29140,1543,5,148059,140125,7934,5.4
St. Bernard,1/1/2005,30255,28560,1695,5.6,148029,140245,7784,5.3
St. Bernard,2/1/2005,30443,28792,1651,5.4,148364,140385,7980,5.4
St. Bernard,3/1/2005,30591,29131,1460,4.8,148391,140654,7737,5.2
St. Bernard,4/1/2005,30782,29384,1398,4.5,148926,141254,7672,5.2
St. Bernard,5/1/2005,31111,29496,1615,5.2,149261,141609,7651,5.1
St. Bernard,6/1/2005,31400,29589,1811,5.8,149238,141714,7524,5
St. Bernard,7/1/2005,31273,29519,1754,5.6,149432,142026,7406,5
St. Bernard,8/1/2005,30519,28862,1657,5.4,149779,142434,7345,4.9
St. Bernard,7/1/2006,7505,7156,349,4.7,151377,144202,7175,4.7
St. Bernard,8/1/2006,7442,7108,334,4.5,151716,144625,7091,4.7
St. Bernard,9/1/2006,7470,7090,380,5.1,151662,144815,6847,4.5
St. Bernard,10/1/2006,7617,7256,361,4.7,152041,145314,6727,4.4
St. Bernard,11/1/2006,7661,7323,338,4.4,152406,145534,6872,4.5
St. Bernard,12/1/2006,7653,7344,309,4,152732,145970,6762,4.4
St. Bernard,1/1/2007,9660,9255,405,4.2,153144,146028,7116,4.6
St. Bernard,2/1/2007,9683,9312,371,3.8,152983,146057,6927,4.5
St. Bernard,3/1/2007,9820,9436,384,3.9,153051,146320,6731,4.4
St. Bernard,4/1/2007,9672,9316,356,3.7,152435,145586,6850,4.5
St. Bernard,5/1/2007,9708,9295,413,4.3,152670,145903,6766,4.4
St. Bernard,6/1/2007,9868,9389,479,4.9,153041,146063,6979,4.6
St. Bernard,7/1/2007,9851,9404,447,4.5,153054,145905,7149,4.7
St. Bernard,8/1/2007,9732,9295,437,4.5,152749,145682,7067,4.6
St. Bernard,9/1/2007,9706,9267,439,4.5,153414,146244,7170,4.7
St. Bernard,10/1/2007,9892,9506,386,3.9,153183,145946,7237,4.7
St. Bernard,11/1/2007,9944,9588,356,3.6,153835,146595,7240,4.7
St. Bernard,12/1/2007,9969,9569,400,4,153918,146273,7645,5
St. Bernard,1/1/2008,17108,16432,676,4,154063,146378,7685,5
St. Bernard,2/1/2008,17066,16484,582,3.4,153653,146156,7497,4.9
St. Bernard,3/1/2008,17281,16643,638,3.7,153908,146086,7822,5.1
St. Bernard,4/1/2008,17429,16868,561,3.2,153769,146132,7637,5
St. Bernard,5/1/2008,17423,16741,682,3.9,154303,145908,8395,5.4
St. Bernard,6/1/2008,17745,16898,847,4.8,154313,145737,8575,5.6
St. Bernard,7/1/2008,17647,16893,754,4.3,154469,145532,8937,5.8
St. Bernard,8/1/2008,17604,16808,796,4.5,154641,145203,9438,6.1
St. Bernard,9/1/2008,17632,16771,861,4.9,154570,145076,9494,6.1
St. Bernard,10/1/2008,17728,16892,836,4.7,154876,144802,10074,6.5
St. Bernard,11/1/2008,17642,16813,829,4.7,154639,144100,10538,6.8
St. Bernard,12/1/2008,17676,16785,891,5,154655,143369,11286,7.3
St. Bernard,1/1/2009,17949,16960,989,5.5,154210,142152,12058,7.8
St. Bernard,2/1/2009,18010,17029,981,5.4,154538,141640,12898,8.3
St. Bernard,3/1/2009,18038,17039,999,5.5,154133,140707,13426,8.7
St. Bernard,4/1/2009,18172,17194,978,5.4,154509,140656,13853,9
St. Bernard,5/1/2009,18186,17099,1087,6,154747,140248,14499,9.4
St. Bernard,6/1/2009,18408,17120,1288,7,154716,140009,14707,9.5
St. Bernard,7/1/2009,18459,17245,1214,6.6,154502,139901,14601,9.5
St. Bernard,8/1/2009,18377,17185,1192,6.5,154307,139492,14814,9.6
St. Bernard,9/1/2009,18229,17028,1201,6.6,153827,138818,15009,9.8
St. Bernard,10/1/2009,18296,17128,1168,6.4,153784,138432,15352,10
St. Bernard,11/1/2009,18325,17199,1126,6.1,153878,138659,15219,9.9
St. Bernard,12/1/2009,18136,17027,1109,6.1,153111,138013,15098,9.9
St. Bernard,1/1/2010,15711,14481,1230,7.8,153484,138438,15046,9.8
St. Bernard,2/1/2010,15760,14643,1117,7.1,153694,138581,15113,9.8
St. Bernard,3/1/2010,15906,14792,1114,7,153954,138751,15202,9.9
St. Bernard,4/1/2010,16040,14919,1121,7,154622,139297,15325,9.9
St. Bernard,5/1/2010,15940,14756,1184,7.4,154091,139241,14849,9.6
St. Bernard,6/1/2010,16124,14799,1325,8.2,153616,139141,14474,9.4
St. Bernard,7/1/2010,16062,14778,1284,8,153691,139179,14512,9.4
St. Bernard,8/1/2010,16033,14722,1311,8.2,154086,139438,14648,9.5
St. Bernard,9/1/2010,16051,14727,1324,8.2,153975,139396,14579,9.5
St. Bernard,10/1/2010,16017,14715,1302,8.1,153635,139119,14516,9.4
St. Bernard,11/1/2010,16064,14757,1307,8.1,154125,139044,15081,9.8
St. Bernard,12/1/2010,15990,14701,1289,8.1,153650,139301,14348,9.3
St. Bernard,1/1/2011,16832,15375,1457,8.7,153263,139250,14013,9.1
St. Bernard,2/1/2011,16842,15519,1323,7.9,153214,139394,13820,9
St. Bernard,3/1/2011,16914,15613,1301,7.7,153376,139639,13737,9
St. Bernard,4/1/2011,16893,15635,1258,7.4,153543,139586,13957,9.1
St. Bernard,5/1/2011,16898,15577,1321,7.8,153479,139624,13855,9
St. Bernard,6/1/2011,17036,15530,1506,8.8,153346,139384,13962,9.1
St. Bernard,7/1/2011,17038,15573,1465,8.6,153288,139524,13763,9
St. Bernard,8/1/2011,16923,15532,1391,8.2,153760,139942,13818,9
St. Bernard,9/1/2011,16911,15533,1378,8.1,154131,140183,13948,9
St. Bernard,10/1/2011,16981,15650,1331,7.8,153961,140368,13594,8.8
St. Bernard,11/1/2011,17018,15785,1233,7.2,154128,140826,13302,8.6
St. Bernard,12/1/2011,16927,15694,1233,7.3,153995,140902,13093,8.5
St. Bernard,1/1/2012,17441,16054,1387,8,154381,141584,12797,8.3
St. Bernard,2/1/2012,17540,16195,1345,7.7,154671,141858,12813,8.3
St. Bernard,3/1/2012,17680,16320,1360,7.7,154749,142036,12713,8.2
St. Bernard,4/1/2012,17794,16489,1305,7.3,154545,141899,12646,8.2
St. Bernard,5/1/2012,17801,16466,1335,7.5,154866,142206,12660,8.2
St. Bernard,6/1/2012,17965,16432,1533,8.5,155083,142391,12692,8.2
St. Bernard,7/1/2012,18017,16521,1496,8.3,154948,142292,12656,8.2
St. Bernard,8/1/2012,17735,16362,1373,7.7,154763,142291,12471,8.1
St. Bernard,9/1/2012,17640,16311,1329,7.5,155160,143044,12115,7.8
St. Bernard,10/1/2012,17760,16508,1252,7,155554,143431,12124,7.8
St. Bernard,11/1/2012,17709,16558,1151,6.5,155338,143333,12005,7.7
St. Bernard,12/1/2012,17715,16507,1208,6.8,155628,143330,12298,7.9
St. Bernard,1/1/2013,18444,16982,1462,7.9,155763,143292,12471,8
St. Bernard,2/1/2013,18436,17123,1313,7.1,155312,143362,11950,7.7
St. Bernard,3/1/2013,18390,17080,1310,7.1,155005,143316,11689,7.5
St. Bernard,4/1/2013,18424,17166,1258,6.8,155394,143635,11760,7.6
St. Bernard,5/1/2013,18502,17142,1360,7.4,155536,143882,11654,7.5
St. Bernard,6/1/2013,18750,17234,1516,8.1,155749,143999,11751,7.5
St. Bernard,7/1/2013,18654,17236,1418,7.6,155599,144264,11335,7.3
St. Bernard,8/1/2013,18587,17226,1361,7.3,155605,144326,11279,7.2
St. Bernard,9/1/2013,18521,17186,1335,7.2,155687,144418,11270,7.2
St. Bernard,10/1/2013,18464,17242,1222,6.6,154673,143537,11136,7.2
St. Bernard,11/1/2013,18538,17438,1100,5.9,155265,144479,10787,6.9
St. Bernard,12/1/2013,18449,17429,1020,5.5,155182,144778,10404,6.7
St. Bernard,1/1/2014,18618,17454,1164,6.3,155352,145150,10202,6.6
St. Bernard,2/1/2014,18764,17645,1119,6,155483,145134,10349,6.7
St. Bernard,3/1/2014,18915,17762,1153,6.1,156028,145648,10380,6.7
St. Bernard,4/1/2014,18860,17768,1092,5.8,155369,145667,9702,6.2
St. Bernard,5/1/2014,18960,17725,1235,6.5,155684,145825,9859,6.3
St. Bernard,6/1/2014,19283,17906,1377,7.1,155707,146247,9460,6.1
St. Bernard,7/1/2014,19390,17931,1459,7.5,156007,146399,9608,6.2
St. Bernard,8/1/2014,19284,17829,1455,7.5,156130,146530,9599,6.1
St. Bernard,9/1/2014,19226,17793,1433,7.5,156040,146778,9262,5.9
St. Bernard,10/1/2014,19326,17960,1366,7.1,156417,147427,8990,5.7
St. Bernard,11/1/2014,19457,18088,1369,7,156494,147404,9090,5.8
St. Bernard,12/1/2014,19363,18024,1339,6.9,156332,147615,8717,5.6
St. Bernard,1/1/2015,19587,18119,1468,7.5,157030,148145,8885,5.7
St. Bernard,2/1/2015,19587,18224,1363,7,156644,148045,8599,5.5
St. Bernard,3/1/2015,19658,18324,1334,6.8,156643,148128,8515,5.4
St. Bernard,4/1/2015,19848,18564,1284,6.5,157060,148511,8550,5.4
St. Bernard,5/1/2015,19912,18545,1367,6.9,157651,148817,8834,5.6
St. Bernard,6/1/2015,19916,18516,1400,7,157062,148816,8247,5.3
St. Bernard,7/1/2015,19827,18442,1385,7,156997,148830,8167,5.2
St. Bernard,8/1/2015,19538,18268,1270,6.5,157172,149181,7992,5.1
St. Bernard,9/1/2015,19314,18080,1234,6.4,156733,148826,7907,5
St. Bernard,10/1/2015,19454,18286,1168,6,157167,149246,7922,5
St. Bernard,11/1/2015,19429,18340,1089,5.6,157463,149463,8000,5.1
St. Bernard,12/1/2015,19397,18376,1021,5.3,158035,150128,7907,5
St. Bernard,1/1/2016,19425,18193,1232,6.3,158280,150653,7627,4.8
St. Bernard,2/1/2016,19412,18275,1137,5.9,158640,150939,7702,4.9
St. Bernard,3/1/2016,19551,18364,1187,6.1,159179,151218,7961,5
St. Bernard,4/1/2016,19627,18504,1123,5.7,159141,151074,8067,5.1
St. Bernard,5/1/2016,19650,18523,1127,5.7,158784,151132,7652,4.8
St. Bernard,6/1/2016,19823,18506,1317,6.6,158967,151223,7744,4.9
St. Bernard,7/1/2016,19793,18489,1304,6.6,159194,151554,7641,4.8
St. Bernard,8/1/2016,19566,18307,1259,6.4,159562,151779,7784,4.9
St. Bernard,9/1/2016,19520,18248,1272,6.5,159714,151761,7953,5
St. Bernard,10/1/2016,19455,18297,1158,6,159605,151793,7811,4.9
St. Bernard,11/1/2016,19442,18380,1062,5.5,159506,151954,7553,4.7
St. Bernard,12/1/2016,19226,18208,1018,5.3,159678,152157,7521,4.7
St. Bernard,1/1/2017,19315,18132,1183,6.1,159620,152152,7468,4.7
St. Bernard,2/1/2017,19451,18380,1071,5.5,159859,152480,7379,4.6
St. Bernard,3/1/2017,19454,18415,1039,5.3,160137,153065,7073,4.4
St. Bernard,4/1/2017,19618,18604,1014,5.2,160345,153255,7089,4.4
St. Bernard,5/1/2017,19562,18586,976,5,160068,153069,7000,4.4
St. Bernard,6/1/2017,19734,18614,1120,5.7,160192,153318,6873,4.3
St. Bernard,7/1/2017,19690,18565,1125,5.7,160462,153569,6892,4.3
St. Bernard,8/1/2017,19455,18365,1090,5.6,160586,153503,7082,4.4
St. Bernard,9/1/2017,19462,18426,1036,5.3,161140,154286,6854,4.3
St. Bernard,10/1/2017,19406,18511,895,4.6,160309,153609,6700,4.2
St. Bernard,11/1/2017,19453,18574,879,4.5,160579,153805,6774,4.2
St. Bernard,12/1/2017,19314,18504,810,4.2,160535,153904,6632,4.1
St. Bernard,1/1/2018,19609,18663,946,4.8,160914,154425,6489,4
St. Bernard,2/1/2018,19687,18792,895,4.5,161778,155197,6581,4.1
St. Bernard,3/1/2018,19743,18827,916,4.6,161686,155214,6472,4
St. Bernard,4/1/2018,19933,19014,919,4.6,161771,155312,6459,4
St. Bernard,5/1/2018,19876,18924,952,4.8,161848,155652,6196,3.8
St. Bernard,6/1/2018,20090,18885,1205,6,162210,155762,6447,4
St. Bernard,7/1/2018,20074,18939,1135,5.7,162341,156146,6195,3.8
St. Bernard,8/1/2018,19699,18656,1043,5.3,161660,155504,6156,3.8
St. Bernard,9/1/2018,19655,18649,1006,5.1,162087,156015,6073,3.7
St. Bernard,10/1/2018,19766,18823,943,4.8,162602,156391,6211,3.8
St. Bernard,11/1/2018,19756,18856,900,4.6,162836,156721,6115,3.8
St. Bernard,12/1/2018,19585,18707,878,4.5,163206,156817,6389,3.9
St. Bernard,1/1/2019,19856,18824,1032,5.2,162963,156487,6475,4
St. Bernard,2/1/2019,19931,19062,869,4.4,162999,156863,6136,3.8
St. Bernard,3/1/2019,19894,19071,823,4.1,162904,156701,6202,3.8
St. Bernard,4/1/2019,20056,19276,780,3.9,162586,156625,5961,3.7
St. Bernard,5/1/2019,20055,19155,900,4.5,162751,156821,5930,3.6
St. Bernard,6/1/2019,20355,19270,1085,5.3,163168,157232,5935,3.6
St. Bernard,7/1/2019,20291,19231,1060,5.2,163590,157529,6061,3.7
St. Bernard,8/1/2019,20151,19148,1003,5,163774,157829,5945,3.6
St. Bernard,9/1/2019,20177,19206,971,4.8,164092,158339,5753,3.5
St. Bernard,10/1/2019,20270,19299,971,4.8,164416,158545,5871,3.6
St. Bernard,11/1/2019,20285,19344,941,4.6,164496,158629,5868,3.6
St. Bernard,12/1/2019,20080,19189,891,4.4,164699,158845,5853,3.6
St. Bernard,1/1/2020,20238,19243,995,4.9,164377,158508,5869,3.6
St. Bernard,2/1/2020,20181,19350,831,4.1,164467,158714,5753,3.5
St. Bernard,3/1/2020,20278,18878,1400,6.9,162559,155353,7206,4.4
St. Bernard,4/1/2020,19191,15838,3353,17.5,156269,133185,23084,14.8
St. Bernard,5/1/2020,19378,16277,3101,16,158101,137173,20929,13.2
St. Bernard,6/1/2020,19981,17067,2914,14.6,159994,142342,17652,11
St. Bernard,7/1/2020,19953,17262,2691,13.5,160132,143779,16352,10.2
St. Bernard,8/1/2020,19836,17611,2225,11.2,160706,147245,13461,8.4
St. Bernard,9/1/2020,19886,17645,2241,11.3,160174,147620,12554,7.8
St. Bernard,10/1/2020,20054,18104,1950,9.7,161003,149931,11072,6.9
St. Bernard,11/1/2020,19745,18124,1621,8.2,160629,149934,10694,6.7
St. Bernard,12/1/2020,19628,18053,1575,8,160745,149975,10770,6.7
St. Bernard,1/1/2021,19454,17785,1669,8.6,160088,149852,10236,6.4
St. Bernard,2/1/2021,19620,18059,1561,8,160184,150189,9995,6.2
St. Bernard,3/1/2021,19742,18242,1500,7.6,160400,150644,9756,6.1
St. Bernard,4/1/2021,20035,18443,1592,7.9,160843,151081,9762,6.1
St. Bernard,5/1/2021,19983,18451,1532,7.7,160800,151535,9266,5.8
St. Bernard,6/1/2021,20248,18507,1741,8.6,161197,151734,9462,5.9
St. Bernard,7/1/2021,20232,18737,1495,7.4,161504,152773,8731,5.4
St. Bernard,8/1/2021,19919,18647,1272,6.4,161527,153250,8276,5.1
St. Bernard,9/1/2021,19304,18056,1248,6.5,161495,153843,7652,4.7
St. Bernard,10/1/2021,19546,18535,1011,5.2,161754,154475,7279,4.5
St. Bernard,11/1/2021,19607,18717,890,4.5,162281,155530,6751,4.2
St. Bernard,12/1/2021,19518,18731,787,4,162497,156099,6398,3.9
St. Bernard,1/1/2022,19509,18570,939,4.8,163627,157115,6512,4
St. Bernard,2/1/2022,19658,18822,836,4.3,163899,157598,6301,3.8
St. Bernard,3/1/2022,19798,19018,780,3.9,164220,158206,6014,3.7
St. Bernard,4/1/2022,19855,19135,720,3.6,163893,157891,6002,3.7
St. Bernard,5/1/2022,19933,19171,762,3.8,164362,158378,5983,3.6
St. Bernard,6/1/2022,20150,19169,981,4.9,164046,158094,5951,3.6
St. Bernard,7/1/2022,20039,19144,895,4.5,164026,158258,5768,3.5
St. Bernard,8/1/2022,19781,18937,844,4.3,164654,158735,5919,3.6
St. Bernard,9/1/2022,19750,18972,778,3.9,164602,158810,5792,3.5
St. Bernard,10/1/2022,19795,19071,724,3.7,164648,158684,5964,3.6
St. Bernard,11/1/2022,19802,19086,716,3.6,164450,158507,5943,3.6
St. Bernard,12/1/2022,19749,19050,699,3.5,165025,159259,5766,3.5
St. Bernard,1/1/2023,19747,18897,850,4.3,165964,160217,5747,3.5
St. Bernard,2/1/2023,19847,19045,802,4,166358,160395,5962,3.6
St. Bernard,3/1/2023,19916,19146,770,3.9,166651,160812,5839,3.5
St. Bernard,4/1/2023,19987,19267,720,3.6,166725,160974,5751,3.4
St. Bernard,5/1/2023,19995,19161,834,4.2,166886,160796,6089,3.6
St. Bernard,6/1/2023,20133,19184,949,4.7,166937,160979,5958,3.6
St. Bernard,7/1/2023,19932,19088,844,4.2,167103,161183,5920,3.5
St. Bernard,8/1/2023,19869,18959,910,4.6,167759,161475,6284,3.7
St. Bernard,9/1/2023,19867,18980,887,4.5,167767,161442,6326,3.8
St. Bernard,10/1/2023,19868,18981,887,4.5,167690,161211,6479,3.9
St. Bernard,11/1/2023,19903,19043,860,4.3,168140,161886,6254,3.7
St. Bernard,12/1/2023,19688,18859,829,4.2,167439,161124,6315,3.8
St. Bernard,1/1/2024,19567,18639,928,4.7,167339,161190,6149,3.7
St. Bernard,2/1/2024,19650,18743,907,4.6,167475,161013,6462,3.9
St. Bernard,3/1/2024,19831,18926,905,4.6,167922,161425,6497,3.9
St. Bernard,4/1/2024,19895,19077,818,4.1,167988,161495,6492,3.9
St. Bernard,5/1/2024,19742,18898,844,4.3,167799,161164,6635,4
St. Bernard,6/1/2024,20037,18946,1091,5.4,168005,161155,6849,4.1
St. Bernard,7/1/2024,20185,19109,1076,5.3,168315,161219,7097,4.2
St. Bernard,8/1/2024,19918,18879,1039,5.2,168496,161425,7071,4.2
St. Bernard,9/1/2024,19886,18883,1003,5,168703,161802,6901,4.1
St. Bernard,10/1/2024,19945,18937,1008,5.1,168428,161456,6972,4.1
St. Bernard,11/1/2024,19959,18984,975,4.9,168304,161183,7121,4.2
St. Bernard,12/1/2024,19773,18870,903,4.6,168547,161661,6886,4.1
St. Bernard,1/1/2025,19255,18357,898,4.7,170744,163895,6849,4
St. Bernard,2/1/2025,19401,18540,861,4.4,170359,163307,7052,4.1
St. Charles,1/1/1990,18983,17907,1076,5.7,125833,119081,6752,5.4
St. Charles,2/1/1990,19090,18057,1033,5.4,125710,119059,6651,5.3
St. Charles,3/1/1990,19194,18208,986,5.1,125801,119203,6598,5.2
St. Charles,4/1/1990,19337,18335,1002,5.2,125649,118852,6797,5.4
St. Charles,5/1/1990,19606,18477,1129,5.8,125893,119151,6742,5.4
St. Charles,6/1/1990,20184,18678,1506,7.5,125573,118983,6590,5.2
St. Charles,7/1/1990,19966,18553,1413,7.1,125732,118810,6922,5.5
St. Charles,8/1/1990,19440,18246,1194,6.1,125990,118802,7188,5.7
St. Charles,9/1/1990,19280,18105,1175,6.1,125892,118524,7368,5.9
St. Charles,10/1/1990,19541,18401,1140,5.8,125995,118536,7459,5.9
St. Charles,11/1/1990,19714,18347,1367,6.9,126070,118306,7764,6.2
St. Charles,12/1/1990,19633,18269,1364,6.9,126142,118241,7901,6.3
St. Charles,1/1/1991,19932,18484,1448,7.3,125955,117940,8015,6.4
St. Charles,2/1/1991,19960,18598,1362,6.8,126020,117755,8265,6.6
St. Charles,3/1/1991,19928,18679,1249,6.3,126238,117652,8586,6.8
St. Charles,4/1/1991,20167,18957,1210,6,126548,118109,8439,6.7
St. Charles,5/1/1991,20292,18906,1386,6.8,126176,117440,8736,6.9
St. Charles,6/1/1991,20926,19203,1723,8.2,126331,117639,8692,6.9
St. Charles,7/1/1991,21021,19092,1929,9.2,126154,117568,8586,6.8
St. Charles,8/1/1991,20285,18722,1563,7.7,126150,117484,8666,6.9
St. Charles,9/1/1991,20243,18732,1511,7.5,126650,117928,8722,6.9
St. Charles,10/1/1991,20470,19005,1465,7.2,126642,117800,8842,7
St. Charles,11/1/1991,20419,18996,1423,7,126701,117770,8931,7
St. Charles,12/1/1991,20395,18865,1530,7.5,126664,117466,9198,7.3
St. Charles,1/1/1992,20712,19033,1679,8.1,127261,117978,9283,7.3
St. Charles,2/1/1992,20750,19116,1634,7.9,127207,117753,9454,7.4
St. Charles,3/1/1992,20758,19244,1514,7.3,127604,118144,9460,7.4
St. Charles,4/1/1992,21022,19445,1577,7.5,127841,118426,9415,7.4
St. Charles,5/1/1992,21263,19470,1793,8.4,128119,118375,9744,7.6
St. Charles,6/1/1992,21993,19716,2277,10.4,128459,118419,10040,7.8
St. Charles,7/1/1992,20811,18223,2588,12.4,128563,118713,9850,7.7
St. Charles,8/1/1992,20197,17843,2354,11.7,128613,118826,9787,7.6
St. Charles,9/1/1992,20085,17728,2357,11.7,128501,118720,9781,7.6
St. Charles,10/1/1992,20084,17951,2133,10.6,128026,118628,9398,7.3
St. Charles,11/1/1992,20396,17988,2408,11.8,128441,118876,9565,7.4
St. Charles,12/1/1992,21162,18513,2649,12.5,128554,118997,9557,7.4
St. Charles,1/1/1993,21463,18651,2812,13.1,128400,119075,9325,7.3
St. Charles,2/1/1993,21468,18844,2624,12.2,128458,119275,9183,7.1
St. Charles,3/1/1993,21097,18946,2151,10.2,128598,119542,9056,7
St. Charles,4/1/1993,21217,19098,2119,10,128584,119474,9110,7.1
St. Charles,5/1/1993,21410,19273,2137,10,129264,120115,9149,7.1
St. Charles,6/1/1993,21959,19456,2503,11.4,129411,120290,9121,7
St. Charles,7/1/1993,21950,19228,2722,12.4,129397,120467,8930,6.9
St. Charles,8/1/1993,21349,18914,2435,11.4,129619,120856,8763,6.8
St. Charles,9/1/1993,20924,18843,2081,9.9,129268,120554,8714,6.7
St. Charles,10/1/1993,21238,19181,2057,9.7,129573,120823,8750,6.8
St. Charles,11/1/1993,21282,19289,1993,9.4,129711,121169,8542,6.6
St. Charles,12/1/1993,21211,19232,1979,9.3,129941,121464,8477,6.5
St. Charles,1/1/1994,21550,19428,2122,9.8,130596,121966,8630,6.6
St. Charles,2/1/1994,21544,19637,1907,8.9,130669,122086,8583,6.6
St. Charles,3/1/1994,21542,19720,1822,8.5,130400,121930,8470,6.5
St. Charles,4/1/1994,21878,19857,2021,9.2,130621,122290,8331,6.4
St. Charles,5/1/1994,22081,20007,2074,9.4,130779,122864,7915,6.1
St. Charles,6/1/1994,22461,20119,2342,10.4,130561,122634,7927,6.1
St. Charles,7/1/1994,22320,19962,2358,10.6,130652,122706,7946,6.1
St. Charles,8/1/1994,21721,19695,2026,9.3,131275,123342,7933,6
St. Charles,9/1/1994,21536,19734,1802,8.4,131421,123687,7734,5.9
St. Charles,10/1/1994,21783,19990,1793,8.2,131744,124112,7632,5.8
St. Charles,11/1/1994,21776,20123,1653,7.6,131891,124516,7375,5.6
St. Charles,12/1/1994,21538,19982,1556,7.2,131951,124721,7230,5.5
St. Charles,1/1/1995,21893,20040,1853,8.5,132038,124663,7375,5.6
St. Charles,2/1/1995,21835,20206,1629,7.5,132115,124928,7187,5.4
St. Charles,3/1/1995,21925,20376,1549,7.1,132108,124955,7153,5.4
St. Charles,4/1/1995,22320,20480,1840,8.2,132590,124945,7645,5.8
St. Charles,5/1/1995,22467,20527,1940,8.6,131851,124421,7430,5.6
St. Charles,6/1/1995,22718,20656,2062,9.1,131949,124522,7427,5.6
St. Charles,7/1/1995,22607,20531,2076,9.2,132343,124816,7527,5.7
St. Charles,8/1/1995,21754,20153,1601,7.4,132336,124852,7484,5.7
St. Charles,9/1/1995,21740,20211,1529,7,132611,125133,7478,5.6
St. Charles,10/1/1995,21851,20388,1463,6.7,132716,125388,7328,5.5
St. Charles,11/1/1995,22011,20465,1546,7,132614,125188,7426,5.6
St. Charles,12/1/1995,21673,20304,1369,6.3,132511,125088,7423,5.6
St. Charles,1/1/1996,22041,20492,1549,7,132616,125125,7491,5.6
St. Charles,2/1/1996,22304,20738,1566,7,132952,125639,7313,5.5
St. Charles,3/1/1996,22514,20968,1546,6.9,133180,125862,7318,5.5
St. Charles,4/1/1996,22661,21092,1569,6.9,133409,125994,7415,5.6
St. Charles,5/1/1996,22885,21234,1651,7.2,133667,126244,7423,5.6
St. Charles,6/1/1996,23293,21407,1886,8.1,133697,126602,7095,5.3
St. Charles,7/1/1996,23358,21267,2091,9,134284,126947,7337,5.5
St. Charles,8/1/1996,22567,20920,1647,7.3,134054,127172,6882,5.1
St. Charles,9/1/1996,22696,21077,1619,7.1,134515,127536,6979,5.2
St. Charles,10/1/1996,22837,21249,1588,7,134921,127890,7031,5.2
St. Charles,11/1/1996,22937,21353,1584,6.9,135007,127771,7236,5.4
St. Charles,12/1/1996,22939,21272,1667,7.3,135113,127860,7253,5.4
St. Charles,1/1/1997,22985,21383,1602,7,135456,128298,7158,5.3
St. Charles,2/1/1997,22774,21496,1278,5.6,135400,128298,7102,5.2
St. Charles,3/1/1997,23146,21798,1348,5.8,135891,128891,7000,5.2
St. Charles,4/1/1997,23089,21937,1152,5,136016,129143,6873,5.1
St. Charles,5/1/1997,23359,22051,1308,5.6,136119,129464,6655,4.9
St. Charles,6/1/1997,23720,22100,1620,6.8,136211,129412,6799,5
St. Charles,7/1/1997,23500,22021,1479,6.3,136477,129822,6655,4.9
St. Charles,8/1/1997,22762,21636,1126,4.9,136618,130010,6608,4.8
St. Charles,9/1/1997,22760,21681,1079,4.7,136675,130019,6656,4.9
St. Charles,10/1/1997,22865,21883,982,4.3,136633,130179,6454,4.7
St. Charles,11/1/1997,23139,22101,1038,4.5,136961,130653,6308,4.6
St. Charles,12/1/1997,22955,22045,910,4,137155,130679,6476,4.7
St. Charles,1/1/1998,23018,22039,979,4.3,137095,130726,6368,4.6
St. Charles,2/1/1998,23128,22219,909,3.9,137112,130807,6306,4.6
St. Charles,3/1/1998,23369,22439,930,4,137236,130814,6422,4.7
St. Charles,4/1/1998,23559,22643,916,3.9,137150,131209,5941,4.3
St. Charles,5/1/1998,23929,22772,1157,4.8,137372,131325,6047,4.4
St. Charles,6/1/1998,24271,22756,1515,6.2,137455,131244,6212,4.5
St. Charles,7/1/1998,24137,22557,1580,6.5,137588,131329,6259,4.5
St. Charles,8/1/1998,23420,22109,1311,5.6,137570,131390,6179,4.5
St. Charles,9/1/1998,23506,22244,1262,5.4,138286,131986,6300,4.6
St. Charles,10/1/1998,23614,22320,1294,5.5,138279,131999,6280,4.5
St. Charles,11/1/1998,23744,22464,1280,5.4,138381,132280,6100,4.4
St. Charles,12/1/1998,23659,22415,1244,5.3,138634,132602,6032,4.4
St. Charles,1/1/1999,23808,22485,1323,5.6,139003,133027,5976,4.3
St. Charles,2/1/1999,24025,22612,1413,5.9,138967,132856,6111,4.4
St. Charles,3/1/1999,23939,22817,1122,4.7,138730,132947,5783,4.2
St. Charles,4/1/1999,23943,22855,1088,4.5,138959,132955,6004,4.3
St. Charles,5/1/1999,24043,22948,1095,4.6,139107,133311,5796,4.2
St. Charles,6/1/1999,24499,22991,1508,6.2,139329,133378,5951,4.3
St. Charles,7/1/1999,24204,22783,1421,5.9,139439,133414,6025,4.3
St. Charles,8/1/1999,23545,22330,1215,5.2,139430,133591,5838,4.2
St. Charles,9/1/1999,23560,22393,1167,5,139622,133707,5915,4.2
St. Charles,10/1/1999,23699,22564,1135,4.8,139771,133993,5778,4.1
St. Charles,11/1/1999,23902,22784,1118,4.7,140025,134309,5716,4.1
St. Charles,12/1/1999,23769,22651,1118,4.7,140177,134523,5653,4
St. Charles,1/1/2000,23615,22382,1233,5.2,142267,136559,5708,4
St. Charles,2/1/2000,23658,22549,1109,4.7,142456,136598,5858,4.1
St. Charles,3/1/2000,23827,22748,1079,4.5,142434,136701,5733,4
St. Charles,4/1/2000,23838,22881,957,4,142751,137270,5481,3.8
St. Charles,5/1/2000,24157,22847,1310,5.4,142388,136630,5758,4
St. Charles,6/1/2000,24394,22848,1546,6.3,142591,136940,5651,4
St. Charles,7/1/2000,24127,22626,1501,6.2,142278,136531,5747,4
St. Charles,8/1/2000,23543,22132,1411,6,142514,136662,5853,4.1
St. Charles,9/1/2000,23477,22202,1275,5.4,142518,136893,5625,3.9
St. Charles,10/1/2000,23581,22303,1278,5.4,142622,137088,5534,3.9
St. Charles,11/1/2000,23869,22475,1394,5.8,142962,137322,5639,3.9
St. Charles,12/1/2000,23816,22467,1349,5.7,143248,137614,5634,3.9
St. Charles,1/1/2001,23905,22417,1488,6.2,143800,137778,6023,4.2
St. Charles,2/1/2001,23785,22543,1242,5.2,143701,137612,6089,4.2
St. Charles,3/1/2001,23964,22781,1183,4.9,143924,137783,6141,4.3
St. Charles,4/1/2001,23778,22725,1053,4.4,143569,137299,6271,4.4
St. Charles,5/1/2001,23860,22766,1094,4.6,143318,137092,6226,4.3
St. Charles,6/1/2001,24188,22762,1426,5.9,143357,136873,6484,4.5
St. Charles,7/1/2001,23972,22661,1311,5.5,143654,137071,6583,4.6
St. Charles,8/1/2001,23296,22018,1278,5.5,143284,136241,7042,4.9
St. Charles,9/1/2001,23403,22232,1171,5,143989,136846,7142,5
St. Charles,10/1/2001,23449,22199,1250,5.3,144086,136392,7694,5.3
St. Charles,11/1/2001,23696,22356,1340,5.7,144240,136238,8003,5.5
St. Charles,12/1/2001,23479,22196,1283,5.5,144305,136047,8258,5.7
St. Charles,1/1/2002,23436,22023,1413,6,143883,135701,8182,5.7
St. Charles,2/1/2002,23546,22299,1247,5.3,144653,136438,8215,5.7
St. Charles,3/1/2002,23594,22474,1120,4.7,144481,136177,8304,5.7
St. Charles,4/1/2002,23658,22525,1133,4.8,144725,136126,8599,5.9
St. Charles,5/1/2002,23880,22595,1285,5.4,144938,136539,8399,5.8
St. Charles,6/1/2002,24203,22628,1575,6.5,144808,136415,8393,5.8
St. Charles,7/1/2002,23964,22524,1440,6,144803,136413,8390,5.8
St. Charles,8/1/2002,23372,22042,1330,5.7,145009,136705,8304,5.7
St. Charles,9/1/2002,23454,22293,1161,5,145552,137302,8251,5.7
St. Charles,10/1/2002,23492,22236,1256,5.3,145314,137008,8307,5.7
St. Charles,11/1/2002,23756,22391,1365,5.7,145041,136521,8520,5.9
St. Charles,12/1/2002,23508,22231,1277,5.4,145066,136426,8640,6
St. Charles,1/1/2003,23478,22120,1358,5.8,145937,137417,8520,5.8
St. Charles,2/1/2003,23652,22346,1306,5.5,146100,137482,8618,5.9
St. Charles,3/1/2003,23755,22545,1210,5.1,146022,137434,8588,5.9
St. Charles,4/1/2003,23713,22609,1104,4.7,146474,137633,8842,6
St. Charles,5/1/2003,23905,22635,1270,5.3,146500,137544,8957,6.1
St. Charles,6/1/2003,24258,22676,1582,6.5,147056,137790,9266,6.3
St. Charles,7/1/2003,24046,22507,1539,6.4,146485,137474,9011,6.2
St. Charles,8/1/2003,23348,21980,1368,5.9,146445,137549,8896,6.1
St. Charles,9/1/2003,23388,22161,1227,5.2,146530,137609,8921,6.1
St. Charles,10/1/2003,23414,22243,1171,5,146716,137984,8732,6
St. Charles,11/1/2003,23797,22519,1278,5.4,147000,138424,8576,5.8
St. Charles,12/1/2003,23553,22380,1173,5,146729,138411,8317,5.7
St. Charles,1/1/2004,23606,22303,1303,5.5,146842,138472,8370,5.7
St. Charles,2/1/2004,23692,22538,1154,4.9,146709,138542,8167,5.6
St. Charles,3/1/2004,23834,22757,1077,4.5,146944,138453,8491,5.8
St. Charles,4/1/2004,23960,22855,1105,4.6,146850,138680,8170,5.6
St. Charles,5/1/2004,24121,22913,1208,5,147065,138852,8212,5.6
St. Charles,6/1/2004,24439,23004,1435,5.9,147460,139174,8286,5.6
St. Charles,7/1/2004,24318,22991,1327,5.5,147692,139556,8136,5.5
St. Charles,8/1/2004,23695,22503,1192,5,147564,139573,7990,5.4
St. Charles,9/1/2004,23753,22614,1139,4.8,147415,139487,7927,5.4
St. Charles,10/1/2004,23874,22685,1189,5,147793,139732,8061,5.5
St. Charles,11/1/2004,24207,23014,1193,4.9,148162,140231,7932,5.4
St. Charles,12/1/2004,24025,22873,1152,4.8,148059,140125,7934,5.4
St. Charles,1/1/2005,24085,22817,1268,5.3,148029,140245,7784,5.3
St. Charles,2/1/2005,24199,23002,1197,4.9,148364,140385,7980,5.4
St. Charles,3/1/2005,24356,23273,1083,4.4,148391,140654,7737,5.2
St. Charles,4/1/2005,24524,23475,1049,4.3,148926,141254,7672,5.2
St. Charles,5/1/2005,24774,23566,1208,4.9,149261,141609,7651,5.1
St. Charles,6/1/2005,25076,23640,1436,5.7,149238,141714,7524,5
St. Charles,7/1/2005,24952,23584,1368,5.5,149432,142026,7406,5
St. Charles,8/1/2005,24278,23058,1220,5,149779,142434,7345,4.9
St. Charles,7/1/2006,26203,25098,1105,4.2,151377,144202,7175,4.7
St. Charles,8/1/2006,26014,24936,1078,4.1,151716,144625,7091,4.7
St. Charles,9/1/2006,25891,24871,1020,3.9,151662,144815,6847,4.5
St. Charles,10/1/2006,26411,25449,962,3.6,152041,145314,6727,4.4
St. Charles,11/1/2006,26609,25682,927,3.5,152406,145534,6872,4.5
St. Charles,12/1/2006,26638,25760,878,3.3,152732,145970,6762,4.4
St. Charles,1/1/2007,26059,25053,1006,3.9,153144,146028,7116,4.6
St. Charles,2/1/2007,26080,25205,875,3.4,152983,146057,6927,4.5
St. Charles,3/1/2007,26455,25540,915,3.5,153051,146320,6731,4.4
St. Charles,4/1/2007,26159,25222,937,3.6,152435,145586,6850,4.5
St. Charles,5/1/2007,26170,25162,1008,3.9,152670,145903,6766,4.4
St. Charles,6/1/2007,26607,25420,1187,4.5,153041,146063,6979,4.6
St. Charles,7/1/2007,26567,25460,1107,4.2,153054,145905,7149,4.7
St. Charles,8/1/2007,26137,25161,976,3.7,152749,145682,7067,4.6
St. Charles,9/1/2007,26034,25089,945,3.6,153414,146244,7170,4.7
St. Charles,10/1/2007,26587,25736,851,3.2,153183,145946,7237,4.7
St. Charles,11/1/2007,26809,25956,853,3.2,153835,146595,7240,4.7
St. Charles,12/1/2007,26781,25904,877,3.3,153918,146273,7645,5
St. Charles,1/1/2008,24146,23159,987,4.1,154063,146378,7685,5
St. Charles,2/1/2008,24064,23231,833,3.5,153653,146156,7497,4.9
St. Charles,3/1/2008,24387,23454,933,3.8,153908,146086,7822,5.1
St. Charles,4/1/2008,24582,23771,811,3.3,153769,146132,7637,5
St. Charles,5/1/2008,24527,23594,933,3.8,154303,145908,8395,5.4
St. Charles,6/1/2008,25017,23811,1206,4.8,154313,145737,8575,5.6
St. Charles,7/1/2008,24918,23809,1109,4.5,154469,145532,8937,5.8
St. Charles,8/1/2008,24843,23687,1156,4.7,154641,145203,9438,6.1
St. Charles,9/1/2008,25107,23638,1469,5.9,154570,145076,9494,6.1
St. Charles,10/1/2008,25093,23805,1288,5.1,154876,144802,10074,6.5
St. Charles,11/1/2008,24911,23693,1218,4.9,154639,144100,10538,6.8
St. Charles,12/1/2008,24922,23654,1268,5.1,154655,143369,11286,7.3
St. Charles,1/1/2009,23661,22206,1455,6.1,154210,142152,12058,7.8
St. Charles,2/1/2009,23682,22294,1388,5.9,154538,141640,12898,8.3
St. Charles,3/1/2009,23737,22310,1427,6,154133,140707,13426,8.7
St. Charles,4/1/2009,23877,22512,1365,5.7,154509,140656,13853,9
St. Charles,5/1/2009,23879,22386,1493,6.3,154747,140248,14499,9.4
St. Charles,6/1/2009,24188,22416,1772,7.3,154716,140009,14707,9.5
St. Charles,7/1/2009,24285,22579,1706,7,154502,139901,14601,9.5
St. Charles,8/1/2009,24150,22500,1650,6.8,154307,139492,14814,9.6
St. Charles,9/1/2009,23865,22295,1570,6.6,153827,138818,15009,9.8
St. Charles,10/1/2009,23941,22427,1514,6.3,153784,138432,15352,10
St. Charles,11/1/2009,23994,22517,1477,6.2,153878,138659,15219,9.9
St. Charles,12/1/2009,23815,22294,1521,6.4,153111,138013,15098,9.9
St. Charles,1/1/2010,25287,23517,1770,7,153484,138438,15046,9.8
St. Charles,2/1/2010,25229,23621,1608,6.4,153694,138581,15113,9.8
St. Charles,3/1/2010,25467,23841,1626,6.4,153954,138751,15202,9.9
St. Charles,4/1/2010,25699,24048,1651,6.4,154622,139297,15325,9.9
St. Charles,5/1/2010,25546,23768,1778,7,154091,139241,14849,9.6
St. Charles,6/1/2010,25864,23849,2015,7.8,153616,139141,14474,9.4
St. Charles,7/1/2010,25752,23802,1950,7.6,153691,139179,14512,9.4
St. Charles,8/1/2010,25542,23669,1873,7.3,154086,139438,14648,9.5
St. Charles,9/1/2010,25515,23722,1793,7,153975,139396,14579,9.5
St. Charles,10/1/2010,25489,23760,1729,6.8,153635,139119,14516,9.4
St. Charles,11/1/2010,25560,23849,1711,6.7,154125,139044,15081,9.8
St. Charles,12/1/2010,25511,23851,1660,6.5,153650,139301,14348,9.3
St. Charles,1/1/2011,24905,23066,1839,7.4,153263,139250,14013,9.1
St. Charles,2/1/2011,24893,23198,1695,6.8,153214,139394,13820,9
St. Charles,3/1/2011,25020,23372,1648,6.6,153376,139639,13737,9
St. Charles,4/1/2011,24927,23381,1546,6.2,153543,139586,13957,9.1
St. Charles,5/1/2011,24884,23248,1636,6.6,153479,139624,13855,9
St. Charles,6/1/2011,25082,23166,1916,7.6,153346,139384,13962,9.1
St. Charles,7/1/2011,25017,23182,1835,7.3,153288,139524,13763,9
St. Charles,8/1/2011,24871,23134,1737,7,153760,139942,13818,9
St. Charles,9/1/2011,24884,23187,1697,6.8,154131,140183,13948,9
St. Charles,10/1/2011,25087,23409,1678,6.7,153961,140368,13594,8.8
St. Charles,11/1/2011,25145,23583,1562,6.2,154128,140826,13302,8.6
St. Charles,12/1/2011,24980,23481,1499,6,153995,140902,13093,8.5
St. Charles,1/1/2012,24557,22897,1660,6.8,154381,141584,12797,8.3
St. Charles,2/1/2012,24553,23033,1520,6.2,154671,141858,12813,8.3
St. Charles,3/1/2012,24749,23232,1517,6.1,154749,142036,12713,8.2
St. Charles,4/1/2012,24931,23501,1430,5.7,154545,141899,12646,8.2
St. Charles,5/1/2012,25004,23424,1580,6.3,154866,142206,12660,8.2
St. Charles,6/1/2012,25212,23347,1865,7.4,155083,142391,12692,8.2
St. Charles,7/1/2012,25173,23433,1740,6.9,154948,142292,12656,8.2
St. Charles,8/1/2012,24834,23225,1609,6.5,154763,142291,12471,8.1
St. Charles,9/1/2012,24650,23170,1480,6,155160,143044,12115,7.8
St. Charles,10/1/2012,24930,23511,1419,5.7,155554,143431,12124,7.8
St. Charles,11/1/2012,24866,23572,1294,5.2,155338,143333,12005,7.7
St. Charles,12/1/2012,24911,23486,1425,5.7,155628,143330,12298,7.9
St. Charles,1/1/2013,24890,23193,1697,6.8,155763,143292,12471,8
St. Charles,2/1/2013,24783,23305,1478,6,155312,143362,11950,7.7
St. Charles,3/1/2013,24780,23332,1448,5.8,155005,143316,11689,7.5
St. Charles,4/1/2013,24917,23483,1434,5.8,155394,143635,11760,7.6
St. Charles,5/1/2013,24957,23396,1561,6.3,155536,143882,11654,7.5
St. Charles,6/1/2013,25270,23479,1791,7.1,155749,143999,11751,7.5
St. Charles,7/1/2013,25068,23410,1658,6.6,155599,144264,11335,7.3
St. Charles,8/1/2013,24958,23410,1548,6.2,155605,144326,11279,7.2
St. Charles,9/1/2013,24820,23351,1469,5.9,155687,144418,11270,7.2
St. Charles,10/1/2013,24908,23526,1382,5.5,154673,143537,11136,7.2
St. Charles,11/1/2013,25076,23790,1286,5.1,155265,144479,10787,6.9
St. Charles,12/1/2013,24905,23714,1191,4.8,155182,144778,10404,6.7
St. Charles,1/1/2014,24656,23317,1339,5.4,155352,145150,10202,6.6
St. Charles,2/1/2014,24801,23536,1265,5.1,155483,145134,10349,6.7
St. Charles,3/1/2014,25085,23774,1311,5.2,156028,145648,10380,6.7
St. Charles,4/1/2014,25041,23812,1229,4.9,155369,145667,9702,6.2
St. Charles,5/1/2014,25183,23743,1440,5.7,155684,145825,9859,6.3
St. Charles,6/1/2014,25614,23954,1660,6.5,155707,146247,9460,6.1
St. Charles,7/1/2014,25711,23952,1759,6.8,156007,146399,9608,6.2
St. Charles,8/1/2014,25548,23841,1707,6.7,156130,146530,9599,6.1
St. Charles,9/1/2014,25400,23753,1647,6.5,156040,146778,9262,5.9
St. Charles,10/1/2014,25701,24075,1626,6.3,156417,147427,8990,5.7
St. Charles,11/1/2014,25869,24255,1614,6.2,156494,147404,9090,5.8
St. Charles,12/1/2014,25612,24085,1527,6,156332,147615,8717,5.6
St. Charles,1/1/2015,25395,23700,1695,6.7,157030,148145,8885,5.7
St. Charles,2/1/2015,25328,23838,1490,5.9,156644,148045,8599,5.5
St. Charles,3/1/2015,25502,24030,1472,5.8,156643,148128,8515,5.4
St. Charles,4/1/2015,25798,24389,1409,5.5,157060,148511,8550,5.4
St. Charles,5/1/2015,25785,24256,1529,5.9,157651,148817,8834,5.6
St. Charles,6/1/2015,25816,24188,1628,6.3,157062,148816,8247,5.3
St. Charles,7/1/2015,25675,24140,1535,6,156997,148830,8167,5.2
St. Charles,8/1/2015,25365,23928,1437,5.7,157172,149181,7992,5.1
St. Charles,9/1/2015,25111,23751,1360,5.4,156733,148826,7907,5
St. Charles,10/1/2015,25394,24075,1319,5.2,157167,149246,7922,5
St. Charles,11/1/2015,25368,24121,1247,4.9,157463,149463,8000,5.1
St. Charles,12/1/2015,25302,24106,1196,4.7,158035,150128,7907,5
St. Charles,1/1/2016,25158,23765,1393,5.5,158280,150653,7627,4.8
St. Charles,2/1/2016,25178,23881,1297,5.2,158640,150939,7702,4.9
St. Charles,3/1/2016,25335,24009,1326,5.2,159179,151218,7961,5
St. Charles,4/1/2016,25410,24157,1253,4.9,159141,151074,8067,5.1
St. Charles,5/1/2016,25331,24070,1261,5,158784,151132,7652,4.8
St. Charles,6/1/2016,25597,24040,1557,6.1,158967,151223,7744,4.9
St. Charles,7/1/2016,25563,24076,1487,5.8,159194,151554,7641,4.8
St. Charles,8/1/2016,25322,23891,1431,5.7,159562,151779,7784,4.9
St. Charles,9/1/2016,25326,23915,1411,5.6,159714,151761,7953,5
St. Charles,10/1/2016,25289,24009,1280,5.1,159605,151793,7811,4.9
St. Charles,11/1/2016,25254,24073,1181,4.7,159506,151954,7553,4.7
St. Charles,12/1/2016,25006,23838,1168,4.7,159678,152157,7521,4.7
St. Charles,1/1/2017,24655,23358,1297,5.3,159620,152152,7468,4.7
St. Charles,2/1/2017,24839,23682,1157,4.7,159859,152480,7379,4.6
St. Charles,3/1/2017,24870,23719,1151,4.6,160137,153065,7073,4.4
St. Charles,4/1/2017,24989,23888,1101,4.4,160345,153255,7089,4.4
St. Charles,5/1/2017,24855,23748,1107,4.5,160068,153069,7000,4.4
St. Charles,6/1/2017,24995,23732,1263,5.1,160192,153318,6873,4.3
St. Charles,7/1/2017,24990,23754,1236,4.9,160462,153569,6892,4.3
St. Charles,8/1/2017,24815,23617,1198,4.8,160586,153503,7082,4.4
St. Charles,9/1/2017,24924,23807,1117,4.5,161140,154286,6854,4.3
St. Charles,10/1/2017,24840,23895,945,3.8,160309,153609,6700,4.2
St. Charles,11/1/2017,24940,23977,963,3.9,160579,153805,6774,4.2
St. Charles,12/1/2017,24775,23885,890,3.6,160535,153904,6632,4.1
St. Charles,1/1/2018,24850,23822,1028,4.1,160914,154425,6489,4
St. Charles,2/1/2018,24975,23997,978,3.9,161778,155197,6581,4.1
St. Charles,3/1/2018,25024,24029,995,4,161686,155214,6472,4
St. Charles,4/1/2018,25256,24241,1015,4,161771,155312,6459,4
St. Charles,5/1/2018,25068,24011,1057,4.2,161848,155652,6196,3.8
St. Charles,6/1/2018,25331,23966,1365,5.4,162210,155762,6447,4
St. Charles,7/1/2018,25268,23976,1292,5.1,162341,156146,6195,3.8
St. Charles,8/1/2018,24864,23699,1165,4.7,161660,155504,6156,3.8
St. Charles,9/1/2018,24871,23763,1108,4.5,162087,156015,6073,3.7
St. Charles,10/1/2018,25060,24007,1053,4.2,162602,156391,6211,3.8
St. Charles,11/1/2018,25033,24082,951,3.8,162836,156721,6115,3.8
St. Charles,12/1/2018,24873,23913,960,3.9,163206,156817,6389,3.9
St. Charles,1/1/2019,25018,23896,1122,4.5,162963,156487,6475,4
St. Charles,2/1/2019,25091,24163,928,3.7,162999,156863,6136,3.8
St. Charles,3/1/2019,25022,24127,895,3.6,162904,156701,6202,3.8
St. Charles,4/1/2019,25245,24397,848,3.4,162586,156625,5961,3.7
St. Charles,5/1/2019,25191,24205,986,3.9,162751,156821,5930,3.6
St. Charles,6/1/2019,25557,24305,1252,4.9,163168,157232,5935,3.6
St. Charles,7/1/2019,25473,24247,1226,4.8,163590,157529,6061,3.7
St. Charles,8/1/2019,25223,24097,1126,4.5,163774,157829,5945,3.6
St. Charles,9/1/2019,25267,24183,1084,4.3,164092,158339,5753,3.5
St. Charles,10/1/2019,25483,24416,1067,4.2,164416,158545,5871,3.6
St. Charles,11/1/2019,25614,24554,1060,4.1,164496,158629,5868,3.6
St. Charles,12/1/2019,25346,24364,982,3.9,164699,158845,5853,3.6
St. Charles,1/1/2020,25248,24162,1086,4.3,164377,158508,5869,3.6
St. Charles,2/1/2020,25132,24263,869,3.5,164467,158714,5753,3.5
St. Charles,3/1/2020,25150,23641,1509,6,162559,155353,7206,4.4
St. Charles,4/1/2020,23012,19786,3226,14,156269,133185,23084,14.8
St. Charles,5/1/2020,23354,20325,3029,13,158101,137173,20929,13.2
St. Charles,6/1/2020,24100,21296,2804,11.6,159994,142342,17652,11
St. Charles,7/1/2020,24098,21559,2539,10.5,160132,143779,16352,10.2
St. Charles,8/1/2020,23922,21955,1967,8.2,160706,147245,13461,8.4
St. Charles,9/1/2020,23971,21982,1989,8.3,160174,147620,12554,7.8
St. Charles,10/1/2020,24294,22571,1723,7.1,161003,149931,11072,6.9
St. Charles,11/1/2020,24146,22664,1482,6.1,160629,149934,10694,6.7
St. Charles,12/1/2020,23998,22559,1439,6,160745,149975,10770,6.7
St. Charles,1/1/2021,23776,22240,1536,6.5,160088,149852,10236,6.4
St. Charles,2/1/2021,23990,22568,1422,5.9,160184,150189,9995,6.2
St. Charles,3/1/2021,24037,22718,1319,5.5,160400,150644,9756,6.1
St. Charles,4/1/2021,24300,22963,1337,5.5,160843,151081,9762,6.1
St. Charles,5/1/2021,24285,22970,1315,5.4,160800,151535,9266,5.8
St. Charles,6/1/2021,24590,23047,1543,6.3,161197,151734,9462,5.9
St. Charles,7/1/2021,24702,23387,1315,5.3,161504,152773,8731,5.4
St. Charles,8/1/2021,24439,23297,1142,4.7,161527,153250,8276,5.1
St. Charles,9/1/2021,23827,22510,1317,5.5,161495,153843,7652,4.7
St. Charles,10/1/2021,24150,23103,1047,4.3,161754,154475,7279,4.5
St. Charles,11/1/2021,24359,23457,902,3.7,162281,155530,6751,4.2
St. Charles,12/1/2021,24229,23454,775,3.2,162497,156099,6398,3.9
St. Charles,1/1/2022,24175,23231,944,3.9,163627,157115,6512,4
St. Charles,2/1/2022,24399,23549,850,3.5,163899,157598,6301,3.8
St. Charles,3/1/2022,24552,23739,813,3.3,164220,158206,6014,3.7
St. Charles,4/1/2022,24565,23831,734,3,163893,157891,6002,3.7
St. Charles,5/1/2022,24603,23817,786,3.2,164362,158378,5983,3.6
St. Charles,6/1/2022,24892,23877,1015,4.1,164046,158094,5951,3.6
St. Charles,7/1/2022,24811,23881,930,3.7,164026,158258,5768,3.5
St. Charles,8/1/2022,24569,23714,855,3.5,164654,158735,5919,3.6
St. Charles,9/1/2022,24498,23718,780,3.2,164602,158810,5792,3.5
St. Charles,10/1/2022,24576,23841,735,3,164648,158684,5964,3.6
St. Charles,11/1/2022,24585,23904,681,2.8,164450,158507,5943,3.6
St. Charles,12/1/2022,24563,23863,700,2.8,165025,159259,5766,3.5
St. Charles,1/1/2023,24408,23601,807,3.3,165964,160217,5747,3.5
St. Charles,2/1/2023,24569,23809,760,3.1,166358,160395,5962,3.6
St. Charles,3/1/2023,24688,23962,726,2.9,166651,160812,5839,3.5
St. Charles,4/1/2023,24715,24064,651,2.6,166725,160974,5751,3.4
St. Charles,5/1/2023,24700,23908,792,3.2,166886,160796,6089,3.6
St. Charles,6/1/2023,24850,23939,911,3.7,166937,160979,5958,3.6
St. Charles,7/1/2023,24617,23841,776,3.2,167103,161183,5920,3.5
St. Charles,8/1/2023,24514,23709,805,3.3,167759,161475,6284,3.7
St. Charles,9/1/2023,24541,23690,851,3.5,167767,161442,6326,3.8
St. Charles,10/1/2023,24576,23726,850,3.5,167690,161211,6479,3.9
St. Charles,11/1/2023,24601,23800,801,3.3,168140,161886,6254,3.7
St. Charles,12/1/2023,24368,23531,837,3.4,167439,161124,6315,3.8
St. Charles,1/1/2024,24170,23273,897,3.7,167339,161190,6149,3.7
St. Charles,2/1/2024,24357,23471,886,3.6,167475,161013,6462,3.9
St. Charles,3/1/2024,24539,23691,848,3.5,167922,161425,6497,3.9
St. Charles,4/1/2024,24579,23863,716,2.9,167988,161495,6492,3.9
St. Charles,5/1/2024,24376,23589,787,3.2,167799,161164,6635,4
St. Charles,6/1/2024,24664,23631,1033,4.2,168005,161155,6849,4.1
St. Charles,7/1/2024,24860,23824,1036,4.2,168315,161219,7097,4.2
St. Charles,8/1/2024,24573,23552,1021,4.2,168496,161425,7071,4.2
St. Charles,9/1/2024,24581,23563,1018,4.1,168703,161802,6901,4.1
St. Charles,10/1/2024,24684,23681,1003,4.1,168428,161456,6972,4.1
St. Charles,11/1/2024,24777,23766,1011,4.1,168304,161183,7121,4.2
St. Charles,12/1/2024,24515,23586,929,3.8,168547,161661,6886,4.1
St. Charles,1/1/2025,24539,23628,911,3.7,170744,163895,6849,4
St. Charles,2/1/2025,24859,23965,894,3.6,170359,163307,7052,4.1
St. Helena,1/1/1990,3512,3326,186,5.3,125833,119081,6752,5.4
St. Helena,2/1/1990,3500,3316,184,5.3,125710,119059,6651,5.3
St. Helena,3/1/1990,3533,3352,181,5.1,125801,119203,6598,5.2
St. Helena,4/1/1990,3549,3348,201,5.7,125649,118852,6797,5.4
St. Helena,5/1/1990,3555,3356,199,5.6,125893,119151,6742,5.4
St. Helena,6/1/1990,3649,3356,293,8,125573,118983,6590,5.2
St. Helena,7/1/1990,3649,3357,292,8,125732,118810,6922,5.5
St. Helena,8/1/1990,3684,3362,322,8.7,125990,118802,7188,5.7
St. Helena,9/1/1990,3643,3357,286,7.9,125892,118524,7368,5.9
St. Helena,10/1/1990,3704,3433,271,7.3,125995,118536,7459,5.9
St. Helena,11/1/1990,3640,3413,227,6.2,126070,118306,7764,6.2
St. Helena,12/1/1990,3644,3411,233,6.4,126142,118241,7901,6.3
St. Helena,1/1/1991,3666,3376,290,7.9,125955,117940,8015,6.4
St. Helena,2/1/1991,3622,3394,228,6.3,126020,117755,8265,6.6
St. Helena,3/1/1991,3627,3423,204,5.6,126238,117652,8586,6.8
St. Helena,4/1/1991,3635,3411,224,6.2,126548,118109,8439,6.7
St. Helena,5/1/1991,3654,3357,297,8.1,126176,117440,8736,6.9
St. Helena,6/1/1991,3756,3355,401,10.7,126331,117639,8692,6.9
St. Helena,7/1/1991,3768,3442,326,8.7,126154,117568,8586,6.8
St. Helena,8/1/1991,3733,3446,287,7.7,126150,117484,8666,6.9
St. Helena,9/1/1991,3707,3476,231,6.2,126650,117928,8722,6.9
St. Helena,10/1/1991,3735,3524,211,5.6,126642,117800,8842,7
St. Helena,11/1/1991,3786,3524,262,6.9,126701,117770,8931,7
St. Helena,12/1/1991,3757,3504,253,6.7,126664,117466,9198,7.3
St. Helena,1/1/1992,3696,3441,255,6.9,127261,117978,9283,7.3
St. Helena,2/1/1992,3739,3464,275,7.4,127207,117753,9454,7.4
St. Helena,3/1/1992,3780,3508,272,7.2,127604,118144,9460,7.4
St. Helena,4/1/1992,3758,3526,232,6.2,127841,118426,9415,7.4
St. Helena,5/1/1992,3724,3488,236,6.3,128119,118375,9744,7.6
St. Helena,6/1/1992,3891,3549,342,8.8,128459,118419,10040,7.8
St. Helena,7/1/1992,4037,3710,327,8.1,128563,118713,9850,7.7
St. Helena,8/1/1992,3968,3661,307,7.7,128613,118826,9787,7.6
St. Helena,9/1/1992,3953,3678,275,7,128501,118720,9781,7.6
St. Helena,10/1/1992,3923,3728,195,5,128026,118628,9398,7.3
St. Helena,11/1/1992,3913,3728,185,4.7,128441,118876,9565,7.4
St. Helena,12/1/1992,3853,3655,198,5.1,128554,118997,9557,7.4
St. Helena,1/1/1993,3737,3469,268,7.2,128400,119075,9325,7.3
St. Helena,2/1/1993,3810,3545,265,7,128458,119275,9183,7.1
St. Helena,3/1/1993,3862,3585,277,7.2,128598,119542,9056,7
St. Helena,4/1/1993,3850,3571,279,7.2,128584,119474,9110,7.1
St. Helena,5/1/1993,3877,3609,268,6.9,129264,120115,9149,7.1
St. Helena,6/1/1993,4044,3650,394,9.7,129411,120290,9121,7
St. Helena,7/1/1993,3922,3593,329,8.4,129397,120467,8930,6.9
St. Helena,8/1/1993,3875,3592,283,7.3,129619,120856,8763,6.8
St. Helena,9/1/1993,3848,3616,232,6,129268,120554,8714,6.7
St. Helena,10/1/1993,3982,3747,235,5.9,129573,120823,8750,6.8
St. Helena,11/1/1993,3985,3760,225,5.6,129711,121169,8542,6.6
St. Helena,12/1/1993,4006,3761,245,6.1,129941,121464,8477,6.5
St. Helena,1/1/1994,3922,3618,304,7.8,130596,121966,8630,6.6
St. Helena,2/1/1994,3861,3617,244,6.3,130669,122086,8583,6.6
St. Helena,3/1/1994,3880,3638,242,6.2,130400,121930,8470,6.5
St. Helena,4/1/1994,3878,3639,239,6.2,130621,122290,8331,6.4
St. Helena,5/1/1994,3920,3685,235,6,130779,122864,7915,6.1
St. Helena,6/1/1994,4043,3675,368,9.1,130561,122634,7927,6.1
St. Helena,7/1/1994,4052,3679,373,9.2,130652,122706,7946,6.1
St. Helena,8/1/1994,4076,3689,387,9.5,131275,123342,7933,6
St. Helena,9/1/1994,4097,3762,335,8.2,131421,123687,7734,5.9
St. Helena,10/1/1994,4104,3786,318,7.7,131744,124112,7632,5.8
St. Helena,11/1/1994,4035,3789,246,6.1,131891,124516,7375,5.6
St. Helena,12/1/1994,3985,3755,230,5.8,131951,124721,7230,5.5
St. Helena,1/1/1995,3957,3665,292,7.4,132038,124663,7375,5.6
St. Helena,2/1/1995,3937,3668,269,6.8,132115,124928,7187,5.4
St. Helena,3/1/1995,3964,3678,286,7.2,132108,124955,7153,5.4
St. Helena,4/1/1995,4033,3745,288,7.1,132590,124945,7645,5.8
St. Helena,5/1/1995,4010,3728,282,7,131851,124421,7430,5.6
St. Helena,6/1/1995,4104,3752,352,8.6,131949,124522,7427,5.6
St. Helena,7/1/1995,4133,3765,368,8.9,132343,124816,7527,5.7
St. Helena,8/1/1995,4106,3744,362,8.8,132336,124852,7484,5.7
St. Helena,9/1/1995,4068,3770,298,7.3,132611,125133,7478,5.6
St. Helena,10/1/1995,4027,3734,293,7.3,132716,125388,7328,5.5
St. Helena,11/1/1995,3974,3727,247,6.2,132614,125188,7426,5.6
St. Helena,12/1/1995,3892,3680,212,5.4,132511,125088,7423,5.6
St. Helena,1/1/1996,3823,3545,278,7.3,132616,125125,7491,5.6
St. Helena,2/1/1996,3896,3637,259,6.6,132952,125639,7313,5.5
St. Helena,3/1/1996,3984,3700,284,7.1,133180,125862,7318,5.5
St. Helena,4/1/1996,3962,3688,274,6.9,133409,125994,7415,5.6
St. Helena,5/1/1996,3949,3705,244,6.2,133667,126244,7423,5.6
St. Helena,6/1/1996,4076,3733,343,8.4,133697,126602,7095,5.3
St. Helena,7/1/1996,4054,3731,323,8,134284,126947,7337,5.5
St. Helena,8/1/1996,4061,3762,299,7.4,134054,127172,6882,5.1
St. Helena,9/1/1996,4060,3799,261,6.4,134515,127536,6979,5.2
St. Helena,10/1/1996,4020,3748,272,6.8,134921,127890,7031,5.2
St. Helena,11/1/1996,3946,3709,237,6,135007,127771,7236,5.4
St. Helena,12/1/1996,3929,3688,241,6.1,135113,127860,7253,5.4
St. Helena,1/1/1997,3818,3537,281,7.4,135456,128298,7158,5.3
St. Helena,2/1/1997,3764,3544,220,5.8,135400,128298,7102,5.2
St. Helena,3/1/1997,3825,3606,219,5.7,135891,128891,7000,5.2
St. Helena,4/1/1997,3859,3623,236,6.1,136016,129143,6873,5.1
St. Helena,5/1/1997,3834,3610,224,5.8,136119,129464,6655,4.9
St. Helena,6/1/1997,3956,3627,329,8.3,136211,129412,6799,5
St. Helena,7/1/1997,3944,3641,303,7.7,136477,129822,6655,4.9
St. Helena,8/1/1997,3958,3659,299,7.6,136618,130010,6608,4.8
St. Helena,9/1/1997,3909,3646,263,6.7,136675,130019,6656,4.9
St. Helena,10/1/1997,3909,3653,256,6.5,136633,130179,6454,4.7
St. Helena,11/1/1997,3856,3662,194,5,136961,130653,6308,4.6
St. Helena,12/1/1997,3866,3643,223,5.8,137155,130679,6476,4.7
St. Helena,1/1/1998,3753,3482,271,7.2,137095,130726,6368,4.6
St. Helena,2/1/1998,3693,3508,185,5,137112,130807,6306,4.6
St. Helena,3/1/1998,3758,3520,238,6.3,137236,130814,6422,4.7
St. Helena,4/1/1998,3761,3555,206,5.5,137150,131209,5941,4.3
St. Helena,5/1/1998,3769,3577,192,5.1,137372,131325,6047,4.4
St. Helena,6/1/1998,3897,3622,275,7.1,137455,131244,6212,4.5
St. Helena,7/1/1998,3862,3595,267,6.9,137588,131329,6259,4.5
St. Helena,8/1/1998,3832,3566,266,6.9,137570,131390,6179,4.5
St. Helena,9/1/1998,3827,3587,240,6.3,138286,131986,6300,4.6
St. Helena,10/1/1998,3810,3630,180,4.7,138279,131999,6280,4.5
St. Helena,11/1/1998,3775,3617,158,4.2,138381,132280,6100,4.4
St. Helena,12/1/1998,3793,3621,172,4.5,138634,132602,6032,4.4
St. Helena,1/1/1999,3771,3576,195,5.2,139003,133027,5976,4.3
St. Helena,2/1/1999,3728,3557,171,4.6,138967,132856,6111,4.4
St. Helena,3/1/1999,3782,3623,159,4.2,138730,132947,5783,4.2
St. Helena,4/1/1999,3830,3664,166,4.3,138959,132955,6004,4.3
St. Helena,5/1/1999,3836,3665,171,4.5,139107,133311,5796,4.2
St. Helena,6/1/1999,3976,3716,260,6.5,139329,133378,5951,4.3
St. Helena,7/1/1999,3938,3700,238,6,139439,133414,6025,4.3
St. Helena,8/1/1999,3928,3698,230,5.9,139430,133591,5838,4.2
St. Helena,9/1/1999,3885,3707,178,4.6,139622,133707,5915,4.2
St. Helena,10/1/1999,3894,3731,163,4.2,139771,133993,5778,4.1
St. Helena,11/1/1999,3883,3734,149,3.8,140025,134309,5716,4.1
St. Helena,12/1/1999,3863,3708,155,4,140177,134523,5653,4
St. Helena,1/1/2000,4028,3802,226,5.6,142267,136559,5708,4
St. Helena,2/1/2000,4033,3845,188,4.7,142456,136598,5858,4.1
St. Helena,3/1/2000,4056,3860,196,4.8,142434,136701,5733,4
St. Helena,4/1/2000,4086,3903,183,4.5,142751,137270,5481,3.8
St. Helena,5/1/2000,4028,3829,199,4.9,142388,136630,5758,4
St. Helena,6/1/2000,4139,3859,280,6.8,142591,136940,5651,4
St. Helena,7/1/2000,4054,3775,279,6.9,142278,136531,5747,4
St. Helena,8/1/2000,4041,3771,270,6.7,142514,136662,5853,4.1
St. Helena,9/1/2000,3994,3771,223,5.6,142518,136893,5625,3.9
St. Helena,10/1/2000,4006,3783,223,5.6,142622,137088,5534,3.9
St. Helena,11/1/2000,4019,3791,228,5.7,142962,137322,5639,3.9
St. Helena,12/1/2000,4002,3788,214,5.3,143248,137614,5634,3.9
St. Helena,1/1/2001,3965,3716,249,6.3,143800,137778,6023,4.2
St. Helena,2/1/2001,3954,3720,234,5.9,143701,137612,6089,4.2
St. Helena,3/1/2001,3959,3717,242,6.1,143924,137783,6141,4.3
St. Helena,4/1/2001,3958,3740,218,5.5,143569,137299,6271,4.4
St. Helena,5/1/2001,3957,3724,233,5.9,143318,137092,6226,4.3
St. Helena,6/1/2001,4045,3738,307,7.6,143357,136873,6484,4.5
St. Helena,7/1/2001,3972,3704,268,6.7,143654,137071,6583,4.6
St. Helena,8/1/2001,3921,3674,247,6.3,143284,136241,7042,4.9
St. Helena,9/1/2001,3954,3690,264,6.7,143989,136846,7142,5
St. Helena,10/1/2001,3985,3747,238,6,144086,136392,7694,5.3
St. Helena,11/1/2001,3981,3741,240,6,144240,136238,8003,5.5
St. Helena,12/1/2001,3961,3726,235,5.9,144305,136047,8258,5.7
St. Helena,1/1/2002,3879,3611,268,6.9,143883,135701,8182,5.7
St. Helena,2/1/2002,3871,3657,214,5.5,144653,136438,8215,5.7
St. Helena,3/1/2002,3855,3651,204,5.3,144481,136177,8304,5.7
St. Helena,4/1/2002,3903,3687,216,5.5,144725,136126,8599,5.9
St. Helena,5/1/2002,3902,3653,249,6.4,144938,136539,8399,5.8
St. Helena,6/1/2002,3994,3681,313,7.8,144808,136415,8393,5.8
St. Helena,7/1/2002,3953,3665,288,7.3,144803,136413,8390,5.8
St. Helena,8/1/2002,3921,3659,262,6.7,145009,136705,8304,5.7
St. Helena,9/1/2002,3932,3684,248,6.3,145552,137302,8251,5.7
St. Helena,10/1/2002,3956,3716,240,6.1,145314,137008,8307,5.7
St. Helena,11/1/2002,3940,3690,250,6.3,145041,136521,8520,5.9
St. Helena,12/1/2002,3910,3661,249,6.4,145066,136426,8640,6
St. Helena,1/1/2003,3818,3561,257,6.7,145937,137417,8520,5.8
St. Helena,2/1/2003,3840,3624,216,5.6,146100,137482,8618,5.9
St. Helena,3/1/2003,3855,3618,237,6.1,146022,137434,8588,5.9
St. Helena,4/1/2003,3892,3667,225,5.8,146474,137633,8842,6
St. Helena,5/1/2003,3885,3623,262,6.7,146500,137544,8957,6.1
St. Helena,6/1/2003,3989,3619,370,9.3,147056,137790,9266,6.3
St. Helena,7/1/2003,3978,3644,334,8.4,146485,137474,9011,6.2
St. Helena,8/1/2003,3913,3618,295,7.5,146445,137549,8896,6.1
St. Helena,9/1/2003,3891,3623,268,6.9,146530,137609,8921,6.1
St. Helena,10/1/2003,3910,3679,231,5.9,146716,137984,8732,6
St. Helena,11/1/2003,3905,3669,236,6,147000,138424,8576,5.8
St. Helena,12/1/2003,3881,3643,238,6.1,146729,138411,8317,5.7
St. Helena,1/1/2004,3845,3582,263,6.8,146842,138472,8370,5.7
St. Helena,2/1/2004,3863,3638,225,5.8,146709,138542,8167,5.6
St. Helena,3/1/2004,3896,3666,230,5.9,146944,138453,8491,5.8
St. Helena,4/1/2004,3915,3675,240,6.1,146850,138680,8170,5.6
St. Helena,5/1/2004,3875,3625,250,6.5,147065,138852,8212,5.6
St. Helena,6/1/2004,3971,3662,309,7.8,147460,139174,8286,5.6
St. Helena,7/1/2004,3964,3679,285,7.2,147692,139556,8136,5.5
St. Helena,8/1/2004,3922,3666,256,6.5,147564,139573,7990,5.4
St. Helena,9/1/2004,3926,3666,260,6.6,147415,139487,7927,5.4
St. Helena,10/1/2004,3920,3700,220,5.6,147793,139732,8061,5.5
St. Helena,11/1/2004,3960,3726,234,5.9,148162,140231,7932,5.4
St. Helena,12/1/2004,3952,3702,250,6.3,148059,140125,7934,5.4
St. Helena,1/1/2005,3972,3586,386,9.7,148029,140245,7784,5.3
St. Helena,2/1/2005,3979,3636,343,8.6,148364,140385,7980,5.4
St. Helena,3/1/2005,3967,3663,304,7.7,148391,140654,7737,5.2
St. Helena,4/1/2005,4099,3722,377,9.2,148926,141254,7672,5.2
St. Helena,5/1/2005,4031,3664,367,9.1,149261,141609,7651,5.1
St. Helena,6/1/2005,4143,3677,466,11.2,149238,141714,7524,5
St. Helena,7/1/2005,4149,3699,450,10.8,149432,142026,7406,5
St. Helena,8/1/2005,4093,3700,393,9.6,149779,142434,7345,4.9
St. Helena,9/1/2005,5395,3984,1411,26.2,149954,142401,7553,5
St. Helena,10/1/2005,5293,4057,1236,23.4,150001,142548,7453,5
St. Helena,11/1/2005,5279,4061,1218,23.1,150065,142499,7566,5
St. Helena,12/1/2005,4591,4013,578,12.6,150030,142752,7279,4.9
St. Helena,1/1/2006,4348,3937,411,9.5,150214,143150,7064,4.7
St. Helena,2/1/2006,4308,3987,321,7.5,150641,143457,7184,4.8
St. Helena,3/1/2006,4290,3996,294,6.9,150813,143741,7072,4.7
St. Helena,4/1/2006,4289,3981,308,7.2,150881,143761,7120,4.7
St. Helena,5/1/2006,4272,3949,323,7.6,151069,144089,6980,4.6
St. Helena,6/1/2006,4304,3925,379,8.8,151354,144353,7001,4.6
St. Helena,7/1/2006,4215,3890,325,7.7,151377,144202,7175,4.7
St. Helena,8/1/2006,4231,3901,330,7.8,151716,144625,7091,4.7
St. Helena,9/1/2006,4174,3904,270,6.5,151662,144815,6847,4.5
St. Helena,10/1/2006,4193,3954,239,5.7,152041,145314,6727,4.4
St. Helena,11/1/2006,4212,3953,259,6.1,152406,145534,6872,4.5
St. Helena,12/1/2006,4259,3959,300,7,152732,145970,6762,4.4
St. Helena,1/1/2007,4146,3810,336,8.1,153144,146028,7116,4.6
St. Helena,2/1/2007,4157,3855,302,7.3,152983,146057,6927,4.5
St. Helena,3/1/2007,4173,3898,275,6.6,153051,146320,6731,4.4
St. Helena,4/1/2007,4188,3906,282,6.7,152435,145586,6850,4.5
St. Helena,5/1/2007,4166,3898,268,6.4,152670,145903,6766,4.4
St. Helena,6/1/2007,4291,3925,366,8.5,153041,146063,6979,4.6
St. Helena,7/1/2007,4370,3956,414,9.5,153054,145905,7149,4.7
St. Helena,8/1/2007,4219,3915,304,7.2,152749,145682,7067,4.6
St. Helena,9/1/2007,4215,3940,275,6.5,153414,146244,7170,4.7
St. Helena,10/1/2007,4240,3973,267,6.3,153183,145946,7237,4.7
St. Helena,11/1/2007,4235,3991,244,5.8,153835,146595,7240,4.7
St. Helena,12/1/2007,4300,3970,330,7.7,153918,146273,7645,5
St. Helena,1/1/2008,4163,3816,347,8.3,154063,146378,7685,5
St. Helena,2/1/2008,4108,3848,260,6.3,153653,146156,7497,4.9
St. Helena,3/1/2008,4157,3876,281,6.8,153908,146086,7822,5.1
St. Helena,4/1/2008,4181,3912,269,6.4,153769,146132,7637,5
St. Helena,5/1/2008,4161,3886,275,6.6,154303,145908,8395,5.4
St. Helena,6/1/2008,4330,3930,400,9.2,154313,145737,8575,5.6
St. Helena,7/1/2008,4373,3932,441,10.1,154469,145532,8937,5.8
St. Helena,8/1/2008,4295,3890,405,9.4,154641,145203,9438,6.1
St. Helena,9/1/2008,4361,3897,464,10.6,154570,145076,9494,6.1
St. Helena,10/1/2008,4314,3944,370,8.6,154876,144802,10074,6.5
St. Helena,11/1/2008,4327,3944,383,8.9,154639,144100,10538,6.8
St. Helena,12/1/2008,4339,3923,416,9.6,154655,143369,11286,7.3
St. Helena,1/1/2009,4236,3761,475,11.2,154210,142152,12058,7.8
St. Helena,2/1/2009,4186,3793,393,9.4,154538,141640,12898,8.3
St. Helena,3/1/2009,4198,3810,388,9.2,154133,140707,13426,8.7
St. Helena,4/1/2009,4214,3830,384,9.1,154509,140656,13853,9
St. Helena,5/1/2009,4224,3796,428,10.1,154747,140248,14499,9.4
St. Helena,6/1/2009,4339,3802,537,12.4,154716,140009,14707,9.5
St. Helena,7/1/2009,4367,3846,521,11.9,154502,139901,14601,9.5
St. Helena,8/1/2009,4307,3815,492,11.4,154307,139492,14814,9.6
St. Helena,9/1/2009,4283,3827,456,10.6,153827,138818,15009,9.8
St. Helena,10/1/2009,4248,3815,433,10.2,153784,138432,15352,10
St. Helena,11/1/2009,4271,3827,444,10.4,153878,138659,15219,9.9
St. Helena,12/1/2009,4248,3768,480,11.3,153111,138013,15098,9.9
St. Helena,1/1/2010,4580,4050,530,11.6,153484,138438,15046,9.8
St. Helena,2/1/2010,4591,4097,494,10.8,153694,138581,15113,9.8
St. Helena,3/1/2010,4631,4130,501,10.8,153954,138751,15202,9.9
St. Helena,4/1/2010,4649,4164,485,10.4,154622,139297,15325,9.9
St. Helena,5/1/2010,4682,4131,551,11.8,154091,139241,14849,9.6
St. Helena,6/1/2010,4806,4144,662,13.8,153616,139141,14474,9.4
St. Helena,7/1/2010,4823,4155,668,13.9,153691,139179,14512,9.4
St. Helena,8/1/2010,4791,4146,645,13.5,154086,139438,14648,9.5
St. Helena,9/1/2010,4750,4135,615,12.9,153975,139396,14579,9.5
St. Helena,10/1/2010,4734,4151,583,12.3,153635,139119,14516,9.4
St. Helena,11/1/2010,4730,4136,594,12.6,154125,139044,15081,9.8
St. Helena,12/1/2010,4699,4099,600,12.8,153650,139301,14348,9.3
St. Helena,1/1/2011,4613,3973,640,13.9,153263,139250,14013,9.1
St. Helena,2/1/2011,4621,4022,599,13,153214,139394,13820,9
St. Helena,3/1/2011,4631,4043,588,12.7,153376,139639,13737,9
St. Helena,4/1/2011,4628,4064,564,12.2,153543,139586,13957,9.1
St. Helena,5/1/2011,4592,4042,550,12,153479,139624,13855,9
St. Helena,6/1/2011,4698,4024,674,14.3,153346,139384,13962,9.1
St. Helena,7/1/2011,4702,4047,655,13.9,153288,139524,13763,9
St. Helena,8/1/2011,4651,4018,633,13.6,153760,139942,13818,9
St. Helena,9/1/2011,4692,4055,637,13.6,154131,140183,13948,9
St. Helena,10/1/2011,4652,4091,561,12.1,153961,140368,13594,8.8
St. Helena,11/1/2011,4633,4094,539,11.6,154128,140826,13302,8.6
St. Helena,12/1/2011,4605,4057,548,11.9,153995,140902,13093,8.5
St. Helena,1/1/2012,4574,3985,589,12.9,154381,141584,12797,8.3
St. Helena,2/1/2012,4599,4045,554,12,154671,141858,12813,8.3
St. Helena,3/1/2012,4610,4073,537,11.6,154749,142036,12713,8.2
St. Helena,4/1/2012,4597,4090,507,11,154545,141899,12646,8.2
St. Helena,5/1/2012,4591,4076,515,11.2,154866,142206,12660,8.2
St. Helena,6/1/2012,4676,4079,597,12.8,155083,142391,12692,8.2
St. Helena,7/1/2012,4674,4079,595,12.7,154948,142292,12656,8.2
St. Helena,8/1/2012,4623,4074,549,11.9,154763,142291,12471,8.1
St. Helena,9/1/2012,4611,4113,498,10.8,155160,143044,12115,7.8
St. Helena,10/1/2012,4634,4149,485,10.5,155554,143431,12124,7.8
St. Helena,11/1/2012,4585,4146,439,9.6,155338,143333,12005,7.7
St. Helena,12/1/2012,4589,4107,482,10.5,155628,143330,12298,7.9
St. Helena,1/1/2013,4490,3954,536,11.9,155763,143292,12471,8
St. Helena,2/1/2013,4506,4009,497,11,155312,143362,11950,7.7
St. Helena,3/1/2013,4527,4031,496,11,155005,143316,11689,7.5
St. Helena,4/1/2013,4536,4075,461,10.2,155394,143635,11760,7.6
St. Helena,5/1/2013,4559,4077,482,10.6,155536,143882,11654,7.5
St. Helena,6/1/2013,4663,4081,582,12.5,155749,143999,11751,7.5
St. Helena,7/1/2013,4674,4105,569,12.2,155599,144264,11335,7.3
St. Helena,8/1/2013,4613,4086,527,11.4,155605,144326,11279,7.2
St. Helena,9/1/2013,4621,4111,510,11,155687,144418,11270,7.2
St. Helena,10/1/2013,4561,4106,455,10,154673,143537,11136,7.2
St. Helena,11/1/2013,4547,4125,422,9.3,155265,144479,10787,6.9
St. Helena,12/1/2013,4500,4086,414,9.2,155182,144778,10404,6.7
St. Helena,1/1/2014,4342,3928,414,9.5,155352,145150,10202,6.6
St. Helena,2/1/2014,4372,3983,389,8.9,155483,145134,10349,6.7
St. Helena,3/1/2014,4408,4017,391,8.9,156028,145648,10380,6.7
St. Helena,4/1/2014,4408,4041,367,8.3,155369,145667,9702,6.2
St. Helena,5/1/2014,4449,4043,406,9.1,155684,145825,9859,6.3
St. Helena,6/1/2014,4550,4056,494,10.9,155707,146247,9460,6.1
St. Helena,7/1/2014,4609,4088,521,11.3,156007,146399,9608,6.2
St. Helena,8/1/2014,4582,4087,495,10.8,156130,146530,9599,6.1
St. Helena,9/1/2014,4609,4124,485,10.5,156040,146778,9262,5.9
St. Helena,10/1/2014,4600,4164,436,9.5,156417,147427,8990,5.7
St. Helena,11/1/2014,4576,4133,443,9.7,156494,147404,9090,5.8
St. Helena,12/1/2014,4577,4102,475,10.4,156332,147615,8717,5.6
St. Helena,1/1/2015,4521,4026,495,10.9,157030,148145,8885,5.7
St. Helena,2/1/2015,4513,4064,449,9.9,156644,148045,8599,5.5
St. Helena,3/1/2015,4527,4089,438,9.7,156643,148128,8515,5.4
St. Helena,4/1/2015,4521,4105,416,9.2,157060,148511,8550,5.4
St. Helena,5/1/2015,4534,4115,419,9.2,157651,148817,8834,5.6
St. Helena,6/1/2015,4582,4117,465,10.1,157062,148816,8247,5.3
St. Helena,7/1/2015,4567,4134,433,9.5,156997,148830,8167,5.2
St. Helena,8/1/2015,4496,4110,386,8.6,157172,149181,7992,5.1
St. Helena,9/1/2015,4481,4099,382,8.5,156733,148826,7907,5
St. Helena,10/1/2015,4453,4122,331,7.4,157167,149246,7922,5
St. Helena,11/1/2015,4461,4132,329,7.4,157463,149463,8000,5.1
St. Helena,12/1/2015,4422,4101,321,7.3,158035,150128,7907,5
St. Helena,1/1/2016,4343,4000,343,7.9,158280,150653,7627,4.8
St. Helena,2/1/2016,4369,4051,318,7.3,158640,150939,7702,4.9
St. Helena,3/1/2016,4390,4089,301,6.9,159179,151218,7961,5
St. Helena,4/1/2016,4385,4092,293,6.7,159141,151074,8067,5.1
St. Helena,5/1/2016,4388,4077,311,7.1,158784,151132,7652,4.8
St. Helena,6/1/2016,4468,4085,383,8.6,158967,151223,7744,4.9
St. Helena,7/1/2016,4488,4090,398,8.9,159194,151554,7641,4.8
St. Helena,8/1/2016,4379,4011,368,8.4,159562,151779,7784,4.9
St. Helena,9/1/2016,4400,4034,366,8.3,159714,151761,7953,5
St. Helena,10/1/2016,4398,4062,336,7.6,159605,151793,7811,4.9
St. Helena,11/1/2016,4349,4053,296,6.8,159506,151954,7553,4.7
St. Helena,12/1/2016,4301,4001,300,7,159678,152157,7521,4.7
St. Helena,1/1/2017,4256,3937,319,7.5,159620,152152,7468,4.7
St. Helena,2/1/2017,4288,4006,282,6.6,159859,152480,7379,4.6
St. Helena,3/1/2017,4309,4032,277,6.4,160137,153065,7073,4.4
St. Helena,4/1/2017,4304,4040,264,6.1,160345,153255,7089,4.4
St. Helena,5/1/2017,4286,4017,269,6.3,160068,153069,7000,4.4
St. Helena,6/1/2017,4361,4028,333,7.6,160192,153318,6873,4.3
St. Helena,7/1/2017,4373,4042,331,7.6,160462,153569,6892,4.3
St. Helena,8/1/2017,4342,4022,320,7.4,160586,153503,7082,4.4
St. Helena,9/1/2017,4327,4047,280,6.5,161140,154286,6854,4.3
St. Helena,10/1/2017,4308,4055,253,5.9,160309,153609,6700,4.2
St. Helena,11/1/2017,4303,4052,251,5.8,160579,153805,6774,4.2
St. Helena,12/1/2017,4272,4021,251,5.9,160535,153904,6632,4.1
St. Helena,1/1/2018,4218,3941,277,6.6,160914,154425,6489,4
St. Helena,2/1/2018,4277,4002,275,6.4,161778,155197,6581,4.1
St. Helena,3/1/2018,4305,4058,247,5.7,161686,155214,6472,4
St. Helena,4/1/2018,4298,4051,247,5.7,161771,155312,6459,4
St. Helena,5/1/2018,4289,4025,264,6.2,161848,155652,6196,3.8
St. Helena,6/1/2018,4392,4037,355,8.1,162210,155762,6447,4
St. Helena,7/1/2018,4385,4048,337,7.7,162341,156146,6195,3.8
St. Helena,8/1/2018,4312,4000,312,7.2,161660,155504,6156,3.8
St. Helena,9/1/2018,4294,4023,271,6.3,162087,156015,6073,3.7
St. Helena,10/1/2018,4325,4061,264,6.1,162602,156391,6211,3.8
St. Helena,11/1/2018,4316,4072,244,5.7,162836,156721,6115,3.8
St. Helena,12/1/2018,4289,4035,254,5.9,163206,156817,6389,3.9
St. Helena,1/1/2019,4217,3926,291,6.9,162963,156487,6475,4
St. Helena,2/1/2019,4222,3989,233,5.5,162999,156863,6136,3.8
St. Helena,3/1/2019,4224,4011,213,5,162904,156701,6202,3.8
St. Helena,4/1/2019,4191,3989,202,4.8,162586,156625,5961,3.7
St. Helena,5/1/2019,4180,3959,221,5.3,162751,156821,5930,3.6
St. Helena,6/1/2019,4252,3950,302,7.1,163168,157232,5935,3.6
St. Helena,7/1/2019,4247,3940,307,7.2,163590,157529,6061,3.7
St. Helena,8/1/2019,4202,3939,263,6.3,163774,157829,5945,3.6
St. Helena,9/1/2019,4204,3969,235,5.6,164092,158339,5753,3.5
St. Helena,10/1/2019,4221,3978,243,5.8,164416,158545,5871,3.6
St. Helena,11/1/2019,4224,3982,242,5.7,164496,158629,5868,3.6
St. Helena,12/1/2019,4169,3924,245,5.9,164699,158845,5853,3.6
St. Helena,1/1/2020,4085,3833,252,6.2,164377,158508,5869,3.6
St. Helena,2/1/2020,4099,3889,210,5.1,164467,158714,5753,3.5
St. Helena,3/1/2020,4193,3842,351,8.4,162559,155353,7206,4.4
St. Helena,4/1/2020,3927,3339,588,15,156269,133185,23084,14.8
St. Helena,5/1/2020,4118,3437,681,16.5,158101,137173,20929,13.2
St. Helena,6/1/2020,4262,3552,710,16.7,159994,142342,17652,11
St. Helena,7/1/2020,4300,3601,699,16.3,160132,143779,16352,10.2
St. Helena,8/1/2020,4299,3698,601,14,160706,147245,13461,8.4
St. Helena,9/1/2020,4349,3757,592,13.6,160174,147620,12554,7.8
St. Helena,10/1/2020,4363,3838,525,12,161003,149931,11072,6.9
St. Helena,11/1/2020,4277,3813,464,10.8,160629,149934,10694,6.7
St. Helena,12/1/2020,4255,3789,466,11,160745,149975,10770,6.7
St. Helena,1/1/2021,4217,3747,470,11.1,160088,149852,10236,6.4
St. Helena,2/1/2021,4240,3797,443,10.4,160184,150189,9995,6.2
St. Helena,3/1/2021,4261,3839,422,9.9,160400,150644,9756,6.1
St. Helena,4/1/2021,4306,3864,442,10.3,160843,151081,9762,6.1
St. Helena,5/1/2021,4291,3845,446,10.4,160800,151535,9266,5.8
St. Helena,6/1/2021,4317,3808,509,11.8,161197,151734,9462,5.9
St. Helena,7/1/2021,4288,3829,459,10.7,161504,152773,8731,5.4
St. Helena,8/1/2021,4238,3841,397,9.4,161527,153250,8276,5.1
St. Helena,9/1/2021,4286,3953,333,7.8,161495,153843,7652,4.7
St. Helena,10/1/2021,4246,3968,278,6.5,161754,154475,7279,4.5
St. Helena,11/1/2021,4237,3986,251,5.9,162281,155530,6751,4.2
St. Helena,12/1/2021,4200,3972,228,5.4,162497,156099,6398,3.9
St. Helena,1/1/2022,4235,3963,272,6.4,163627,157115,6512,4
St. Helena,2/1/2022,4278,4030,248,5.8,163899,157598,6301,3.8
St. Helena,3/1/2022,4286,4061,225,5.2,164220,158206,6014,3.7
St. Helena,4/1/2022,4251,4055,196,4.6,163893,157891,6002,3.7
St. Helena,5/1/2022,4240,4029,211,5,164362,158378,5983,3.6
St. Helena,6/1/2022,4282,3998,284,6.6,164046,158094,5951,3.6
St. Helena,7/1/2022,4284,4020,264,6.2,164026,158258,5768,3.5
St. Helena,8/1/2022,4246,4004,242,5.7,164654,158735,5919,3.6
St. Helena,9/1/2022,4235,4020,215,5.1,164602,158810,5792,3.5
St. Helena,10/1/2022,4227,4033,194,4.6,164648,158684,5964,3.6
St. Helena,11/1/2022,4217,4027,190,4.5,164450,158507,5943,3.6
St. Helena,12/1/2022,4200,4007,193,4.6,165025,159259,5766,3.5
St. Helena,1/1/2023,4202,3975,227,5.4,165964,160217,5747,3.5
St. Helena,2/1/2023,4219,4026,193,4.6,166358,160395,5962,3.6
St. Helena,3/1/2023,4262,4068,194,4.6,166651,160812,5839,3.5
St. Helena,4/1/2023,4247,4065,182,4.3,166725,160974,5751,3.4
St. Helena,5/1/2023,4226,4024,202,4.8,166886,160796,6089,3.6
St. Helena,6/1/2023,4275,4003,272,6.4,166937,160979,5958,3.6
St. Helena,7/1/2023,4297,4028,269,6.3,167103,161183,5920,3.5
St. Helena,8/1/2023,4281,4021,260,6.1,167759,161475,6284,3.7
St. Helena,9/1/2023,4276,4055,221,5.2,167767,161442,6326,3.8
St. Helena,10/1/2023,4299,4071,228,5.3,167690,161211,6479,3.9
St. Helena,11/1/2023,4331,4094,237,5.5,168140,161886,6254,3.7
St. Helena,12/1/2023,4297,4048,249,5.8,167439,161124,6315,3.8
St. Helena,1/1/2024,4285,4018,267,6.2,167339,161190,6149,3.7
St. Helena,2/1/2024,4289,4039,250,5.8,167475,161013,6462,3.9
St. Helena,3/1/2024,4345,4098,247,5.7,167922,161425,6497,3.9
St. Helena,4/1/2024,4341,4101,240,5.5,167988,161495,6492,3.9
St. Helena,5/1/2024,4309,4066,243,5.6,167799,161164,6635,4
St. Helena,6/1/2024,4395,4046,349,7.9,168005,161155,6849,4.1
St. Helena,7/1/2024,4385,4061,324,7.4,168315,161219,7097,4.2
St. Helena,8/1/2024,4309,4045,264,6.1,168496,161425,7071,4.2
St. Helena,9/1/2024,4282,4039,243,5.7,168703,161802,6901,4.1
St. Helena,10/1/2024,4311,4062,249,5.8,168428,161456,6972,4.1
St. Helena,11/1/2024,4287,4054,233,5.4,168304,161183,7121,4.2
St. Helena,12/1/2024,4286,4040,246,5.7,168547,161661,6886,4.1
St. Helena,1/1/2025,4147,3859,288,6.9,170744,163895,6849,4
St. Helena,2/1/2025,4097,3832,265,6.5,170359,163307,7052,4.1
St. James,1/1/1990,8714,7992,722,8.3,125833,119081,6752,5.4
St. James,2/1/1990,8729,8048,681,7.8,125710,119059,6651,5.3
St. James,3/1/1990,8628,8089,539,6.2,125801,119203,6598,5.2
St. James,4/1/1990,8637,8046,591,6.8,125649,118852,6797,5.4
St. James,5/1/1990,8647,8005,642,7.4,125893,119151,6742,5.4
St. James,6/1/1990,8863,8087,776,8.8,125573,118983,6590,5.2
St. James,7/1/1990,9012,8282,730,8.1,125732,118810,6922,5.5
St. James,8/1/1990,9019,8206,813,9,125990,118802,7188,5.7
St. James,9/1/1990,8935,8084,851,9.5,125892,118524,7368,5.9
St. James,10/1/1990,8861,8123,738,8.3,125995,118536,7459,5.9
St. James,11/1/1990,8763,8132,631,7.2,126070,118306,7764,6.2
St. James,12/1/1990,8805,8102,703,8,126142,118241,7901,6.3
St. James,1/1/1991,8894,7915,979,11,125955,117940,8015,6.4
St. James,2/1/1991,8804,7936,868,9.9,126020,117755,8265,6.6
St. James,3/1/1991,8770,8026,744,8.5,126238,117652,8586,6.8
St. James,4/1/1991,8752,8031,721,8.2,126548,118109,8439,6.7
St. James,5/1/1991,8726,7945,781,9,126176,117440,8736,6.9
St. James,6/1/1991,9050,8046,1004,11.1,126331,117639,8692,6.9
St. James,7/1/1991,9051,8184,867,9.6,126154,117568,8586,6.8
St. James,8/1/1991,8838,8044,794,9,126150,117484,8666,6.9
St. James,9/1/1991,8713,8009,704,8.1,126650,117928,8722,6.9
St. James,10/1/1991,8539,8003,536,6.3,126642,117800,8842,7
St. James,11/1/1991,8538,8025,513,6,126701,117770,8931,7
St. James,12/1/1991,8599,8011,588,6.8,126664,117466,9198,7.3
St. James,1/1/1992,8787,7834,953,10.8,127261,117978,9283,7.3
St. James,2/1/1992,8587,7872,715,8.3,127207,117753,9454,7.4
St. James,3/1/1992,8659,7896,763,8.8,127604,118144,9460,7.4
St. James,4/1/1992,8571,7856,715,8.3,127841,118426,9415,7.4
St. James,5/1/1992,8537,7810,727,8.5,128119,118375,9744,7.6
St. James,6/1/1992,8850,7863,987,11.2,128459,118419,10040,7.8
St. James,7/1/1992,9206,8168,1038,11.3,128563,118713,9850,7.7
St. James,8/1/1992,9044,8057,987,10.9,128613,118826,9787,7.6
St. James,9/1/1992,8968,7988,980,10.9,128501,118720,9781,7.6
St. James,10/1/1992,8763,8043,720,8.2,128026,118628,9398,7.3
St. James,11/1/1992,8715,8081,634,7.3,128441,118876,9565,7.4
St. James,12/1/1992,8675,7909,766,8.8,128554,118997,9557,7.4
St. James,1/1/1993,8766,7707,1059,12.1,128400,119075,9325,7.3
St. James,2/1/1993,8666,7755,911,10.5,128458,119275,9183,7.1
St. James,3/1/1993,8591,7730,861,10,128598,119542,9056,7
St. James,4/1/1993,8634,7782,852,9.9,128584,119474,9110,7.1
St. James,5/1/1993,8670,7742,928,10.7,129264,120115,9149,7.1
St. James,6/1/1993,8855,7775,1080,12.2,129411,120290,9121,7
St. James,7/1/1993,8909,7893,1016,11.4,129397,120467,8930,6.9
St. James,8/1/1993,9004,7855,1149,12.8,129619,120856,8763,6.8
St. James,9/1/1993,8868,7796,1072,12.1,129268,120554,8714,6.7
St. James,10/1/1993,8788,7852,936,10.7,129573,120823,8750,6.8
St. James,11/1/1993,8821,7933,888,10.1,129711,121169,8542,6.6
St. James,12/1/1993,8795,7872,923,10.5,129941,121464,8477,6.5
St. James,1/1/1994,9074,7841,1233,13.6,130596,121966,8630,6.6
St. James,2/1/1994,8876,7862,1014,11.4,130669,122086,8583,6.6
St. James,3/1/1994,8748,7816,932,10.7,130400,121930,8470,6.5
St. James,4/1/1994,8802,7799,1003,11.4,130621,122290,8331,6.4
St. James,5/1/1994,8898,7793,1105,12.4,130779,122864,7915,6.1
St. James,6/1/1994,9092,7833,1259,13.8,130561,122634,7927,6.1
St. James,7/1/1994,9164,7977,1187,13,130652,122706,7946,6.1
St. James,8/1/1994,9136,7982,1154,12.6,131275,123342,7933,6
St. James,9/1/1994,8728,7935,793,9.1,131421,123687,7734,5.9
St. James,10/1/1994,8653,7994,659,7.6,131744,124112,7632,5.8
St. James,11/1/1994,8666,8020,646,7.5,131891,124516,7375,5.6
St. James,12/1/1994,8672,7974,698,8,131951,124721,7230,5.5
St. James,1/1/1995,8832,7799,1033,11.7,132038,124663,7375,5.6
St. James,2/1/1995,8582,7863,719,8.4,132115,124928,7187,5.4
St. James,3/1/1995,8723,7929,794,9.1,132108,124955,7153,5.4
St. James,4/1/1995,8842,7919,923,10.4,132590,124945,7645,5.8
St. James,5/1/1995,8869,7921,948,10.7,131851,124421,7430,5.6
St. James,6/1/1995,9041,7906,1135,12.6,131949,124522,7427,5.6
St. James,7/1/1995,9044,8012,1032,11.4,132343,124816,7527,5.7
St. James,8/1/1995,8784,7930,854,9.7,132336,124852,7484,5.7
St. James,9/1/1995,8735,7878,857,9.8,132611,125133,7478,5.6
St. James,10/1/1995,8477,7906,571,6.7,132716,125388,7328,5.5
St. James,11/1/1995,8508,7970,538,6.3,132614,125188,7426,5.6
St. James,12/1/1995,8595,7917,678,7.9,132511,125088,7423,5.6
St. James,1/1/1996,8986,7794,1192,13.3,132616,125125,7491,5.6
St. James,2/1/1996,8822,7860,962,10.9,132952,125639,7313,5.5
St. James,3/1/1996,8791,7916,875,10,133180,125862,7318,5.5
St. James,4/1/1996,8715,7877,838,9.6,133409,125994,7415,5.6
St. James,5/1/1996,8657,7886,771,8.9,133667,126244,7423,5.6
St. James,6/1/1996,8943,7923,1020,11.4,133697,126602,7095,5.3
St. James,7/1/1996,9154,8039,1115,12.2,134284,126947,7337,5.5
St. James,8/1/1996,9013,8007,1006,11.2,134054,127172,6882,5.1
St. James,9/1/1996,8914,8018,896,10.1,134515,127536,6979,5.2
St. James,10/1/1996,8657,8011,646,7.5,134921,127890,7031,5.2
St. James,11/1/1996,8726,8086,640,7.3,135007,127771,7236,5.4
St. James,12/1/1996,8784,8095,689,7.8,135113,127860,7253,5.4
St. James,1/1/1997,8925,7968,957,10.7,135456,128298,7158,5.3
St. James,2/1/1997,8625,7919,706,8.2,135400,128298,7102,5.2
St. James,3/1/1997,8710,7997,713,8.2,135891,128891,7000,5.2
St. James,4/1/1997,8577,8007,570,6.6,136016,129143,6873,5.1
St. James,5/1/1997,8626,7987,639,7.4,136119,129464,6655,4.9
St. James,6/1/1997,8885,7998,887,10,136211,129412,6799,5
St. James,7/1/1997,8846,8067,779,8.8,136477,129822,6655,4.9
St. James,8/1/1997,8701,7996,705,8.1,136618,130010,6608,4.8
St. James,9/1/1997,8674,8048,626,7.2,136675,130019,6656,4.9
St. James,10/1/1997,8507,7997,510,6,136633,130179,6454,4.7
St. James,11/1/1997,8520,8086,434,5.1,136961,130653,6308,4.6
St. James,12/1/1997,8464,8063,401,4.7,137155,130679,6476,4.7
St. James,1/1/1998,8503,7925,578,6.8,137095,130726,6368,4.6
St. James,2/1/1998,8409,7956,453,5.4,137112,130807,6306,4.6
St. James,3/1/1998,8519,7992,527,6.2,137236,130814,6422,4.7
St. James,4/1/1998,8595,8076,519,6,137150,131209,5941,4.3
St. James,5/1/1998,8665,8070,595,6.9,137372,131325,6047,4.4
St. James,6/1/1998,8953,8105,848,9.5,137455,131244,6212,4.5
St. James,7/1/1998,8863,8101,762,8.6,137588,131329,6259,4.5
St. James,8/1/1998,8779,8031,748,8.5,137570,131390,6179,4.5
St. James,9/1/1998,8876,8100,776,8.7,138286,131986,6300,4.6
St. James,10/1/1998,8904,8093,811,9.1,138279,131999,6280,4.5
St. James,11/1/1998,8727,8075,652,7.5,138381,132280,6100,4.4
St. James,12/1/1998,8718,8088,630,7.2,138634,132602,6032,4.4
St. James,1/1/1999,8842,8080,762,8.6,139003,133027,5976,4.3
St. James,2/1/1999,9021,8119,902,10,138967,132856,6111,4.4
St. James,3/1/1999,9007,8169,838,9.3,138730,132947,5783,4.2
St. James,4/1/1999,8998,8110,888,9.9,138959,132955,6004,4.3
St. James,5/1/1999,8882,8083,799,9,139107,133311,5796,4.2
St. James,6/1/1999,9125,8067,1058,11.6,139329,133378,5951,4.3
St. James,7/1/1999,9163,8104,1059,11.6,139439,133414,6025,4.3
St. James,8/1/1999,9015,8050,965,10.7,139430,133591,5838,4.2
St. James,9/1/1999,8958,8090,868,9.7,139622,133707,5915,4.2
St. James,10/1/1999,8909,8169,740,8.3,139771,133993,5778,4.1
St. James,11/1/1999,8801,8209,592,6.7,140025,134309,5716,4.1
St. James,12/1/1999,8944,8224,720,8.1,140177,134523,5653,4
St. James,1/1/2000,8624,7852,772,9,142267,136559,5708,4
St. James,2/1/2000,8565,7859,706,8.2,142456,136598,5858,4.1
St. James,3/1/2000,8533,7872,661,7.7,142434,136701,5733,4
St. James,4/1/2000,8690,8117,573,6.6,142751,137270,5481,3.8
St. James,5/1/2000,8707,8021,686,7.9,142388,136630,5758,4
St. James,6/1/2000,8943,8096,847,9.5,142591,136940,5651,4
St. James,7/1/2000,8879,8118,761,8.6,142278,136531,5747,4
St. James,8/1/2000,8938,8144,794,8.9,142514,136662,5853,4.1
St. James,9/1/2000,8806,8061,745,8.5,142518,136893,5625,3.9
St. James,10/1/2000,8945,8276,669,7.5,142622,137088,5534,3.9
St. James,11/1/2000,9000,8233,767,8.5,142962,137322,5639,3.9
St. James,12/1/2000,9018,8199,819,9.1,143248,137614,5634,3.9
St. James,1/1/2001,9050,8065,985,10.9,143800,137778,6023,4.2
St. James,2/1/2001,8907,8131,776,8.7,143701,137612,6089,4.2
St. James,3/1/2001,8984,8208,776,8.6,143924,137783,6141,4.3
St. James,4/1/2001,8766,8042,724,8.3,143569,137299,6271,4.4
St. James,5/1/2001,8672,7963,709,8.2,143318,137092,6226,4.3
St. James,6/1/2001,8921,8027,894,10,143357,136873,6484,4.5
St. James,7/1/2001,8773,7978,795,9.1,143654,137071,6583,4.6
St. James,8/1/2001,8690,7883,807,9.3,143284,136241,7042,4.9
St. James,9/1/2001,8591,7829,762,8.9,143989,136846,7142,5
St. James,10/1/2001,8688,7919,769,8.9,144086,136392,7694,5.3
St. James,11/1/2001,8623,7862,761,8.8,144240,136238,8003,5.5
St. James,12/1/2001,8614,7865,749,8.7,144305,136047,8258,5.7
St. James,1/1/2002,8585,7737,848,9.9,143883,135701,8182,5.7
St. James,2/1/2002,8565,7842,723,8.4,144653,136438,8215,5.7
St. James,3/1/2002,8601,7834,767,8.9,144481,136177,8304,5.7
St. James,4/1/2002,8640,7872,768,8.9,144725,136126,8599,5.9
St. James,5/1/2002,8609,7821,788,9.2,144938,136539,8399,5.8
St. James,6/1/2002,8852,7935,917,10.4,144808,136415,8393,5.8
St. James,7/1/2002,8905,8081,824,9.3,144803,136413,8390,5.8
St. James,8/1/2002,8867,8080,787,8.9,145009,136705,8304,5.7
St. James,9/1/2002,8802,8083,719,8.2,145552,137302,8251,5.7
St. James,10/1/2002,8833,8123,710,8,145314,137008,8307,5.7
St. James,11/1/2002,8783,8052,731,8.3,145041,136521,8520,5.9
St. James,12/1/2002,8747,7997,750,8.6,145066,136426,8640,6
St. James,1/1/2003,8793,7960,833,9.5,145937,137417,8520,5.8
St. James,2/1/2003,8713,7982,731,8.4,146100,137482,8618,5.9
St. James,3/1/2003,8841,8010,831,9.4,146022,137434,8588,5.9
St. James,4/1/2003,8827,8035,792,9,146474,137633,8842,6
St. James,5/1/2003,8764,7946,818,9.3,146500,137544,8957,6.1
St. James,6/1/2003,9146,8050,1096,12,147056,137790,9266,6.3
St. James,7/1/2003,8990,7997,993,11,146485,137474,9011,6.2
St. James,8/1/2003,8928,7940,988,11.1,146445,137549,8896,6.1
St. James,9/1/2003,8817,7899,918,10.4,146530,137609,8921,6.1
St. James,10/1/2003,8835,8037,798,9,146716,137984,8732,6
St. James,11/1/2003,8788,8010,778,8.9,147000,138424,8576,5.8
St. James,12/1/2003,8728,7973,755,8.7,146729,138411,8317,5.7
St. James,1/1/2004,8780,7870,910,10.4,146842,138472,8370,5.7
St. James,2/1/2004,8652,7935,717,8.3,146709,138542,8167,5.6
St. James,3/1/2004,8684,7930,754,8.7,146944,138453,8491,5.8
St. James,4/1/2004,8776,7936,840,9.6,146850,138680,8170,5.6
St. James,5/1/2004,8709,7842,867,10,147065,138852,8212,5.6
St. James,6/1/2004,8967,7970,997,11.1,147460,139174,8286,5.6
St. James,7/1/2004,8976,8085,891,9.9,147692,139556,8136,5.5
St. James,8/1/2004,8941,8072,869,9.7,147564,139573,7990,5.4
St. James,9/1/2004,8834,7968,866,9.8,147415,139487,7927,5.4
St. James,10/1/2004,8718,7910,808,9.3,147793,139732,8061,5.5
St. James,11/1/2004,8715,7974,741,8.5,148162,140231,7932,5.4
St. James,12/1/2004,8666,7957,709,8.2,148059,140125,7934,5.4
St. James,1/1/2005,8894,8097,797,9,148029,140245,7784,5.3
St. James,2/1/2005,8776,8077,699,8,148364,140385,7980,5.4
St. James,3/1/2005,8776,8098,678,7.7,148391,140654,7737,5.2
St. James,4/1/2005,8809,8134,675,7.7,148926,141254,7672,5.2
St. James,5/1/2005,8777,8102,675,7.7,149261,141609,7651,5.1
St. James,6/1/2005,9088,8290,798,8.8,149238,141714,7524,5
St. James,7/1/2005,9027,8264,763,8.5,149432,142026,7406,5
St. James,8/1/2005,8996,8268,728,8.1,149779,142434,7345,4.9
St. James,9/1/2005,10083,8244,1839,18.2,149954,142401,7553,5
St. James,10/1/2005,9703,8122,1581,16.3,150001,142548,7453,5
St. James,11/1/2005,9511,7998,1513,15.9,150065,142499,7566,5
St. James,12/1/2005,8675,7890,785,9,150030,142752,7279,4.9
St. James,1/1/2006,8333,7715,618,7.4,150214,143150,7064,4.7
St. James,2/1/2006,8250,7758,492,6,150641,143457,7184,4.8
St. James,3/1/2006,8270,7802,468,5.7,150813,143741,7072,4.7
St. James,4/1/2006,8327,7861,466,5.6,150881,143761,7120,4.7
St. James,5/1/2006,8366,7844,522,6.2,151069,144089,6980,4.6
St. James,6/1/2006,8658,8029,629,7.3,151354,144353,7001,4.6
St. James,7/1/2006,8668,8095,573,6.6,151377,144202,7175,4.7
St. James,8/1/2006,8567,8008,559,6.5,151716,144625,7091,4.7
St. James,9/1/2006,8611,8078,533,6.2,151662,144815,6847,4.5
St. James,10/1/2006,8631,8123,508,5.9,152041,145314,6727,4.4
St. James,11/1/2006,8621,8121,500,5.8,152406,145534,6872,4.5
St. James,12/1/2006,8652,8148,504,5.8,152732,145970,6762,4.4
St. James,1/1/2007,8535,7957,578,6.8,153144,146028,7116,4.6
St. James,2/1/2007,8527,7984,543,6.4,152983,146057,6927,4.5
St. James,3/1/2007,8567,8050,517,6,153051,146320,6731,4.4
St. James,4/1/2007,8514,7968,546,6.4,152435,145586,6850,4.5
St. James,5/1/2007,8543,7990,553,6.5,152670,145903,6766,4.4
St. James,6/1/2007,8656,7996,660,7.6,153041,146063,6979,4.6
St. James,7/1/2007,8816,8123,693,7.9,153054,145905,7149,4.7
St. James,8/1/2007,8730,8119,611,7,152749,145682,7067,4.6
St. James,9/1/2007,8765,8166,599,6.8,153414,146244,7170,4.7
St. James,10/1/2007,8690,8161,529,6.1,153183,145946,7237,4.7
St. James,11/1/2007,8755,8249,506,5.8,153835,146595,7240,4.7
St. James,12/1/2007,8760,8196,564,6.4,153918,146273,7645,5
St. James,1/1/2008,8896,8281,615,6.9,154063,146378,7685,5
St. James,2/1/2008,8800,8258,542,6.2,153653,146156,7497,4.9
St. James,3/1/2008,8900,8363,537,6,153908,146086,7822,5.1
St. James,4/1/2008,8917,8446,471,5.3,153769,146132,7637,5
St. James,5/1/2008,8983,8457,526,5.9,154303,145908,8395,5.4
St. James,6/1/2008,9118,8459,659,7.2,154313,145737,8575,5.6
St. James,7/1/2008,9313,8600,713,7.7,154469,145532,8937,5.8
St. James,8/1/2008,9284,8586,698,7.5,154641,145203,9438,6.1
St. James,9/1/2008,9536,8584,952,10,154570,145076,9494,6.1
St. James,10/1/2008,9336,8651,685,7.3,154876,144802,10074,6.5
St. James,11/1/2008,9328,8693,635,6.8,154639,144100,10538,6.8
St. James,12/1/2008,9317,8595,722,7.7,154655,143369,11286,7.3
St. James,1/1/2009,9394,8506,888,9.5,154210,142152,12058,7.8
St. James,2/1/2009,9275,8479,796,8.6,154538,141640,12898,8.3
St. James,3/1/2009,9319,8517,802,8.6,154133,140707,13426,8.7
St. James,4/1/2009,9369,8531,838,8.9,154509,140656,13853,9
St. James,5/1/2009,9312,8496,816,8.8,154747,140248,14499,9.4
St. James,6/1/2009,9547,8598,949,9.9,154716,140009,14707,9.5
St. James,7/1/2009,9624,8686,938,9.7,154502,139901,14601,9.5
St. James,8/1/2009,9373,8520,853,9.1,154307,139492,14814,9.6
St. James,9/1/2009,9436,8598,838,8.9,153827,138818,15009,9.8
St. James,10/1/2009,9527,8693,834,8.8,153784,138432,15352,10
St. James,11/1/2009,9399,8570,829,8.8,153878,138659,15219,9.9
St. James,12/1/2009,9255,8378,877,9.5,153111,138013,15098,9.9
St. James,1/1/2010,9897,8875,1022,10.3,153484,138438,15046,9.8
St. James,2/1/2010,9863,8927,936,9.5,153694,138581,15113,9.8
St. James,3/1/2010,10006,9005,1001,10,153954,138751,15202,9.9
St. James,4/1/2010,10137,9128,1009,10,154622,139297,15325,9.9
St. James,5/1/2010,10103,9019,1084,10.7,154091,139241,14849,9.6
St. James,6/1/2010,10295,9056,1239,12,153616,139141,14474,9.4
St. James,7/1/2010,10352,9082,1270,12.3,153691,139179,14512,9.4
St. James,8/1/2010,10174,8997,1177,11.6,154086,139438,14648,9.5
St. James,9/1/2010,10186,8997,1189,11.7,153975,139396,14579,9.5
St. James,10/1/2010,10145,9039,1106,10.9,153635,139119,14516,9.4
St. James,11/1/2010,10153,9040,1113,11,154125,139044,15081,9.8
St. James,12/1/2010,10176,9034,1142,11.2,153650,139301,14348,9.3
St. James,1/1/2011,9980,8720,1260,12.6,153263,139250,14013,9.1
St. James,2/1/2011,9960,8761,1199,12,153214,139394,13820,9
St. James,3/1/2011,10008,8818,1190,11.9,153376,139639,13737,9
St. James,4/1/2011,9935,8864,1071,10.8,153543,139586,13957,9.1
St. James,5/1/2011,9919,8821,1098,11.1,153479,139624,13855,9
St. James,6/1/2011,10077,8786,1291,12.8,153346,139384,13962,9.1
St. James,7/1/2011,10016,8827,1189,11.9,153288,139524,13763,9
St. James,8/1/2011,9974,8806,1168,11.7,153760,139942,13818,9
St. James,9/1/2011,9939,8803,1136,11.4,154131,140183,13948,9
St. James,10/1/2011,9951,8888,1063,10.7,153961,140368,13594,8.8
St. James,11/1/2011,9961,8946,1015,10.2,154128,140826,13302,8.6
St. James,12/1/2011,9941,8915,1026,10.3,153995,140902,13093,8.5
St. James,1/1/2012,9670,8588,1082,11.2,154381,141584,12797,8.3
St. James,2/1/2012,9622,8646,976,10.1,154671,141858,12813,8.3
St. James,3/1/2012,9648,8692,956,9.9,154749,142036,12713,8.2
St. James,4/1/2012,9722,8828,894,9.2,154545,141899,12646,8.2
St. James,5/1/2012,9742,8817,925,9.5,154866,142206,12660,8.2
St. James,6/1/2012,9857,8775,1082,11,155083,142391,12692,8.2
St. James,7/1/2012,9892,8854,1038,10.5,154948,142292,12656,8.2
St. James,8/1/2012,9701,8746,955,9.8,154763,142291,12471,8.1
St. James,9/1/2012,9605,8694,911,9.5,155160,143044,12115,7.8
St. James,10/1/2012,9666,8855,811,8.4,155554,143431,12124,7.8
St. James,11/1/2012,9632,8878,754,7.8,155338,143333,12005,7.7
St. James,12/1/2012,9662,8848,814,8.4,155628,143330,12298,7.9
St. James,1/1/2013,9673,8725,948,9.8,155763,143292,12471,8
St. James,2/1/2013,9635,8745,890,9.2,155312,143362,11950,7.7
St. James,3/1/2013,9609,8734,875,9.1,155005,143316,11689,7.5
St. James,4/1/2013,9624,8810,814,8.5,155394,143635,11760,7.6
St. James,5/1/2013,9659,8801,858,8.9,155536,143882,11654,7.5
St. James,6/1/2013,9792,8821,971,9.9,155749,143999,11751,7.5
St. James,7/1/2013,9763,8840,923,9.5,155599,144264,11335,7.3
St. James,8/1/2013,9706,8828,878,9,155605,144326,11279,7.2
St. James,9/1/2013,9673,8775,898,9.3,155687,144418,11270,7.2
St. James,10/1/2013,9623,8840,783,8.1,154673,143537,11136,7.2
St. James,11/1/2013,9668,8928,740,7.7,155265,144479,10787,6.9
St. James,12/1/2013,9620,8898,722,7.5,155182,144778,10404,6.7
St. James,1/1/2014,9456,8683,773,8.2,155352,145150,10202,6.6
St. James,2/1/2014,9495,8765,730,7.7,155483,145134,10349,6.7
St. James,3/1/2014,9569,8841,728,7.6,156028,145648,10380,6.7
St. James,4/1/2014,9541,8863,678,7.1,155369,145667,9702,6.2
St. James,5/1/2014,9588,8833,755,7.9,155684,145825,9859,6.3
St. James,6/1/2014,9817,8934,883,9,155707,146247,9460,6.1
St. James,7/1/2014,9900,8977,923,9.3,156007,146399,9608,6.2
St. James,8/1/2014,9835,8930,905,9.2,156130,146530,9599,6.1
St. James,9/1/2014,9758,8879,879,9,156040,146778,9262,5.9
St. James,10/1/2014,9820,8982,838,8.5,156417,147427,8990,5.7
St. James,11/1/2014,9919,9052,867,8.7,156494,147404,9090,5.8
St. James,12/1/2014,9837,8995,842,8.6,156332,147615,8717,5.6
St. James,1/1/2015,9746,8799,947,9.7,157030,148145,8885,5.7
St. James,2/1/2015,9708,8854,854,8.8,156644,148045,8599,5.5
St. James,3/1/2015,9796,8927,869,8.9,156643,148128,8515,5.4
St. James,4/1/2015,9862,9047,815,8.3,157060,148511,8550,5.4
St. James,5/1/2015,9844,8985,859,8.7,157651,148817,8834,5.6
St. James,6/1/2015,9886,8993,893,9,157062,148816,8247,5.3
St. James,7/1/2015,9887,9007,880,8.9,156997,148830,8167,5.2
St. James,8/1/2015,9731,8913,818,8.4,157172,149181,7992,5.1
St. James,9/1/2015,9631,8832,799,8.3,156733,148826,7907,5
St. James,10/1/2015,9653,8935,718,7.4,157167,149246,7922,5
St. James,11/1/2015,9651,8964,687,7.1,157463,149463,8000,5.1
St. James,12/1/2015,9631,8965,666,6.9,158035,150128,7907,5
St. James,1/1/2016,9576,8822,754,7.9,158280,150653,7627,4.8
St. James,2/1/2016,9587,8858,729,7.6,158640,150939,7702,4.9
St. James,3/1/2016,9599,8904,695,7.2,159179,151218,7961,5
St. James,4/1/2016,9651,8951,700,7.3,159141,151074,8067,5.1
St. James,5/1/2016,9635,8921,714,7.4,158784,151132,7652,4.8
St. James,6/1/2016,9752,8922,830,8.5,158967,151223,7744,4.9
St. James,7/1/2016,9731,8945,786,8.1,159194,151554,7641,4.8
St. James,8/1/2016,9607,8871,736,7.7,159562,151779,7784,4.9
St. James,9/1/2016,9590,8869,721,7.5,159714,151761,7953,5
St. James,10/1/2016,9517,8873,644,6.8,159605,151793,7811,4.9
St. James,11/1/2016,9508,8907,601,6.3,159506,151954,7553,4.7
St. James,12/1/2016,9484,8817,667,7,159678,152157,7521,4.7
St. James,1/1/2017,9331,8615,716,7.7,159620,152152,7468,4.7
St. James,2/1/2017,9370,8722,648,6.9,159859,152480,7379,4.6
St. James,3/1/2017,9370,8741,629,6.7,160137,153065,7073,4.4
St. James,4/1/2017,9391,8785,606,6.5,160345,153255,7089,4.4
St. James,5/1/2017,9352,8747,605,6.5,160068,153069,7000,4.4
St. James,6/1/2017,9475,8756,719,7.6,160192,153318,6873,4.3
St. James,7/1/2017,9482,8761,721,7.6,160462,153569,6892,4.3
St. James,8/1/2017,9374,8704,670,7.1,160586,153503,7082,4.4
St. James,9/1/2017,9374,8769,605,6.5,161140,154286,6854,4.3
St. James,10/1/2017,9306,8778,528,5.7,160309,153609,6700,4.2
St. James,11/1/2017,9327,8805,522,5.6,160579,153805,6774,4.2
St. James,12/1/2017,9273,8779,494,5.3,160535,153904,6632,4.1
St. James,1/1/2018,9192,8604,588,6.4,160914,154425,6489,4
St. James,2/1/2018,9244,8667,577,6.2,161778,155197,6581,4.1
St. James,3/1/2018,9241,8695,546,5.9,161686,155214,6472,4
St. James,4/1/2018,9286,8746,540,5.8,161771,155312,6459,4
St. James,5/1/2018,9218,8665,553,6,161848,155652,6196,3.8
St. James,6/1/2018,9350,8646,704,7.5,162210,155762,6447,4
St. James,7/1/2018,9268,8628,640,6.9,162341,156146,6195,3.8
St. James,8/1/2018,9142,8537,605,6.6,161660,155504,6156,3.8
St. James,9/1/2018,9135,8564,571,6.3,162087,156015,6073,3.7
St. James,10/1/2018,9184,8666,518,5.6,162602,156391,6211,3.8
St. James,11/1/2018,9155,8687,468,5.1,162836,156721,6115,3.8
St. James,12/1/2018,9130,8633,497,5.4,163206,156817,6389,3.9
St. James,1/1/2019,9211,8619,592,6.4,162963,156487,6475,4
St. James,2/1/2019,9235,8728,507,5.5,162999,156863,6136,3.8
St. James,3/1/2019,9153,8698,455,5,162904,156701,6202,3.8
St. James,4/1/2019,9206,8774,432,4.7,162586,156625,5961,3.7
St. James,5/1/2019,9213,8727,486,5.3,162751,156821,5930,3.6
St. James,6/1/2019,9352,8732,620,6.6,163168,157232,5935,3.6
St. James,7/1/2019,9309,8706,603,6.5,163590,157529,6061,3.7
St. James,8/1/2019,9263,8679,584,6.3,163774,157829,5945,3.6
St. James,9/1/2019,9248,8720,528,5.7,164092,158339,5753,3.5
St. James,10/1/2019,9348,8803,545,5.8,164416,158545,5871,3.6
St. James,11/1/2019,9362,8840,522,5.6,164496,158629,5868,3.6
St. James,12/1/2019,9294,8780,514,5.5,164699,158845,5853,3.6
St. James,1/1/2020,9132,8567,565,6.2,164377,158508,5869,3.6
St. James,2/1/2020,9106,8618,488,5.4,164467,158714,5753,3.5
St. James,3/1/2020,9237,8402,835,9,162559,155353,7206,4.4
St. James,4/1/2020,8101,7017,1084,13.4,156269,133185,23084,14.8
St. James,5/1/2020,8385,7205,1180,14.1,158101,137173,20929,13.2
St. James,6/1/2020,8711,7530,1181,13.6,159994,142342,17652,11
St. James,7/1/2020,8728,7606,1122,12.9,160132,143779,16352,10.2
St. James,8/1/2020,8741,7770,971,11.1,160706,147245,13461,8.4
St. James,9/1/2020,8807,7795,1012,11.5,160174,147620,12554,7.8
St. James,10/1/2020,8877,8010,867,9.8,161003,149931,11072,6.9
St. James,11/1/2020,8790,8028,762,8.7,160629,149934,10694,6.7
St. James,12/1/2020,8777,7999,778,8.9,160745,149975,10770,6.7
St. James,1/1/2021,8688,7903,785,9,160088,149852,10236,6.4
St. James,2/1/2021,8753,8007,746,8.5,160184,150189,9995,6.2
St. James,3/1/2021,8742,8026,716,8.2,160400,150644,9756,6.1
St. James,4/1/2021,8850,8130,720,8.1,160843,151081,9762,6.1
St. James,5/1/2021,8814,8113,701,8,160800,151535,9266,5.8
St. James,6/1/2021,8964,8149,815,9.1,161197,151734,9462,5.9
St. James,7/1/2021,8982,8254,728,8.1,161504,152773,8731,5.4
St. James,8/1/2021,8847,8233,614,6.9,161527,153250,8276,5.1
St. James,9/1/2021,8602,7961,641,7.5,161495,153843,7652,4.7
St. James,10/1/2021,8687,8167,520,6,161754,154475,7279,4.5
St. James,11/1/2021,8778,8309,469,5.3,162281,155530,6751,4.2
St. James,12/1/2021,8733,8329,404,4.6,162497,156099,6398,3.9
St. James,1/1/2022,8762,8260,502,5.7,163627,157115,6512,4
St. James,2/1/2022,8808,8372,436,5,163899,157598,6301,3.8
St. James,3/1/2022,8814,8407,407,4.6,164220,158206,6014,3.7
St. James,4/1/2022,8815,8454,361,4.1,163893,157891,6002,3.7
St. James,5/1/2022,8795,8411,384,4.4,164362,158378,5983,3.6
St. James,6/1/2022,8944,8456,488,5.5,164046,158094,5951,3.6
St. James,7/1/2022,8953,8483,470,5.2,164026,158258,5768,3.5
St. James,8/1/2022,8837,8411,426,4.8,164654,158735,5919,3.6
St. James,9/1/2022,8797,8414,383,4.4,164602,158810,5792,3.5
St. James,10/1/2022,8803,8455,348,4,164648,158684,5964,3.6
St. James,11/1/2022,8817,8474,343,3.9,164450,158507,5943,3.6
St. James,12/1/2022,8815,8476,339,3.8,165025,159259,5766,3.5
St. James,1/1/2023,8775,8376,399,4.5,165964,160217,5747,3.5
St. James,2/1/2023,8790,8442,348,4,166358,160395,5962,3.6
St. James,3/1/2023,8827,8499,328,3.7,166651,160812,5839,3.5
St. James,4/1/2023,8870,8547,323,3.6,166725,160974,5751,3.4
St. James,5/1/2023,8856,8474,382,4.3,166886,160796,6089,3.6
St. James,6/1/2023,8961,8500,461,5.1,166937,160979,5958,3.6
St. James,7/1/2023,8923,8488,435,4.9,167103,161183,5920,3.5
St. James,8/1/2023,8873,8416,457,5.2,167759,161475,6284,3.7
St. James,9/1/2023,8822,8399,423,4.8,167767,161442,6326,3.8
St. James,10/1/2023,8843,8413,430,4.9,167690,161211,6479,3.9
St. James,11/1/2023,8850,8440,410,4.6,168140,161886,6254,3.7
St. James,12/1/2023,8752,8353,399,4.6,167439,161124,6315,3.8
St. James,1/1/2024,8752,8273,479,5.5,167339,161190,6149,3.7
St. James,2/1/2024,8767,8314,453,5.2,167475,161013,6462,3.9
St. James,3/1/2024,8827,8386,441,5,167922,161425,6497,3.9
St. James,4/1/2024,8882,8468,414,4.7,167988,161495,6492,3.9
St. James,5/1/2024,8746,8346,400,4.6,167799,161164,6635,4
St. James,6/1/2024,8930,8401,529,5.9,168005,161155,6849,4.1
St. James,7/1/2024,9018,8468,550,6.1,168315,161219,7097,4.2
St. James,8/1/2024,8878,8361,517,5.8,168496,161425,7071,4.2
St. James,9/1/2024,8863,8369,494,5.6,168703,161802,6901,4.1
St. James,10/1/2024,8924,8429,495,5.5,168428,161456,6972,4.1
St. James,11/1/2024,8921,8437,484,5.4,168304,161183,7121,4.2
St. James,12/1/2024,8829,8377,452,5.1,168547,161661,6886,4.1
St. James,1/1/2025,8894,8428,466,5.2,170744,163895,6849,4
St. James,2/1/2025,8937,8519,418,4.7,170359,163307,7052,4.1
St. John the Baptist,1/1/1990,17317,16019,1298,7.5,125833,119081,6752,5.4
St. John the Baptist,2/1/1990,17304,16153,1151,6.7,125710,119059,6651,5.3
St. John the Baptist,3/1/1990,17372,16287,1085,6.2,125801,119203,6598,5.2
St. John the Baptist,4/1/1990,17681,16402,1279,7.2,125649,118852,6797,5.4
St. John the Baptist,5/1/1990,17856,16529,1327,7.4,125893,119151,6742,5.4
St. John the Baptist,6/1/1990,18387,16709,1678,9.1,125573,118983,6590,5.2
St. John the Baptist,7/1/1990,18259,16596,1663,9.1,125732,118810,6922,5.5
St. John the Baptist,8/1/1990,17847,16324,1523,8.5,125990,118802,7188,5.7
St. John the Baptist,9/1/1990,17747,16196,1551,8.7,125892,118524,7368,5.9
St. John the Baptist,10/1/1990,17885,16461,1424,8,125995,118536,7459,5.9
St. John the Baptist,11/1/1990,17990,16413,1577,8.8,126070,118306,7764,6.2
St. John the Baptist,12/1/1990,17984,16343,1641,9.1,126142,118241,7901,6.3
St. John the Baptist,1/1/1991,18402,16420,1982,10.8,125955,117940,8015,6.4
St. John the Baptist,2/1/1991,18261,16522,1739,9.5,126020,117755,8265,6.6
St. John the Baptist,3/1/1991,18233,16594,1639,9,126238,117652,8586,6.8
St. John the Baptist,4/1/1991,18443,16842,1601,8.7,126548,118109,8439,6.7
St. John the Baptist,5/1/1991,18685,16795,1890,10.1,126176,117440,8736,6.9
St. John the Baptist,6/1/1991,19313,17060,2253,11.7,126331,117639,8692,6.9
St. John the Baptist,7/1/1991,19320,16962,2358,12.2,126154,117568,8586,6.8
St. John the Baptist,8/1/1991,18738,16632,2106,11.2,126150,117484,8666,6.9
St. John the Baptist,9/1/1991,18575,16642,1933,10.4,126650,117928,8722,6.9
St. John the Baptist,10/1/1991,18818,16885,1933,10.3,126642,117800,8842,7
St. John the Baptist,11/1/1991,18666,16876,1790,9.6,126701,117770,8931,7
St. John the Baptist,12/1/1991,18555,16760,1795,9.7,126664,117466,9198,7.3
St. John the Baptist,1/1/1992,18909,16847,2062,10.9,127261,117978,9283,7.3
St. John the Baptist,2/1/1992,18662,16919,1743,9.3,127207,117753,9454,7.4
St. John the Baptist,3/1/1992,18752,17032,1720,9.2,127604,118144,9460,7.4
St. John the Baptist,4/1/1992,18956,17210,1746,9.2,127841,118426,9415,7.4
St. John the Baptist,5/1/1992,19134,17233,1901,9.9,128119,118375,9744,7.6
St. John the Baptist,6/1/1992,19749,17449,2300,11.6,128459,118419,10040,7.8
St. John the Baptist,7/1/1992,18594,16128,2466,13.3,128563,118713,9850,7.7
St. John the Baptist,8/1/1992,18078,15791,2287,12.7,128613,118826,9787,7.6
St. John the Baptist,9/1/1992,17904,15690,2214,12.4,128501,118720,9781,7.6
St. John the Baptist,10/1/1992,17773,15888,1885,10.6,128026,118628,9398,7.3
St. John the Baptist,11/1/1992,17941,15920,2021,11.3,128441,118876,9565,7.4
St. John the Baptist,12/1/1992,18580,16384,2196,11.8,128554,118997,9557,7.4
St. John the Baptist,1/1/1993,18888,16358,2530,13.4,128400,119075,9325,7.3
St. John the Baptist,2/1/1993,18856,16529,2327,12.3,128458,119275,9183,7.1
St. John the Baptist,3/1/1993,18793,16616,2177,11.6,128598,119542,9056,7
St. John the Baptist,4/1/1993,19257,16750,2507,13,128584,119474,9110,7.1
St. John the Baptist,5/1/1993,19522,16903,2619,13.4,129264,120115,9149,7.1
St. John the Baptist,6/1/1993,20398,17066,3332,16.3,129411,120290,9121,7
St. John the Baptist,7/1/1993,19512,16864,2648,13.6,129397,120467,8930,6.9
St. John the Baptist,8/1/1993,19064,16590,2474,13,129619,120856,8763,6.8
St. John the Baptist,9/1/1993,18886,16527,2359,12.5,129268,120554,8714,6.7
St. John the Baptist,10/1/1993,19301,16822,2479,12.8,129573,120823,8750,6.8
St. John the Baptist,11/1/1993,19456,16918,2538,13,129711,121169,8542,6.6
St. John the Baptist,12/1/1993,19177,16869,2308,12,129941,121464,8477,6.5
St. John the Baptist,1/1/1994,19663,16844,2819,14.3,130596,121966,8630,6.6
St. John the Baptist,2/1/1994,19291,17025,2266,11.7,130669,122086,8583,6.6
St. John the Baptist,3/1/1994,19136,17096,2040,10.7,130400,121930,8470,6.5
St. John the Baptist,4/1/1994,19302,17215,2087,10.8,130621,122290,8331,6.4
St. John the Baptist,5/1/1994,19610,17346,2264,11.5,130779,122864,7915,6.1
St. John the Baptist,6/1/1994,19980,17444,2536,12.7,130561,122634,7927,6.1
St. John the Baptist,7/1/1994,19845,17306,2539,12.8,130652,122706,7946,6.1
St. John the Baptist,8/1/1994,19112,17074,2038,10.7,131275,123342,7933,6
St. John the Baptist,9/1/1994,18732,17110,1622,8.7,131421,123687,7734,5.9
St. John the Baptist,10/1/1994,19088,17331,1757,9.2,131744,124112,7632,5.8
St. John the Baptist,11/1/1994,19155,17448,1707,8.9,131891,124516,7375,5.6
St. John the Baptist,12/1/1994,19010,17325,1685,8.9,131951,124721,7230,5.5
St. John the Baptist,1/1/1995,19456,17201,2255,11.6,132038,124663,7375,5.6
St. John the Baptist,2/1/1995,19277,17345,1932,10,132115,124928,7187,5.4
St. John the Baptist,3/1/1995,19513,17491,2022,10.4,132108,124955,7153,5.4
St. John the Baptist,4/1/1995,19805,17581,2224,11.2,132590,124945,7645,5.8
St. John the Baptist,5/1/1995,19766,17620,2146,10.9,131851,124421,7430,5.6
St. John the Baptist,6/1/1995,20065,17732,2333,11.6,131949,124522,7427,5.6
St. John the Baptist,7/1/1995,19898,17625,2273,11.4,132343,124816,7527,5.7
St. John the Baptist,8/1/1995,19219,17300,1919,10,132336,124852,7484,5.7
St. John the Baptist,9/1/1995,19030,17350,1680,8.8,132611,125133,7478,5.6
St. John the Baptist,10/1/1995,19036,17501,1535,8.1,132716,125388,7328,5.5
St. John the Baptist,11/1/1995,19349,17566,1783,9.2,132614,125188,7426,5.6
St. John the Baptist,12/1/1995,18961,17429,1532,8.1,132511,125088,7423,5.6
St. John the Baptist,1/1/1996,19257,17429,1828,9.5,132616,125125,7491,5.6
St. John the Baptist,2/1/1996,19486,17638,1848,9.5,132952,125639,7313,5.5
St. John the Baptist,3/1/1996,19595,17833,1762,9,133180,125862,7318,5.5
St. John the Baptist,4/1/1996,19768,17938,1830,9.3,133409,125994,7415,5.6
St. John the Baptist,5/1/1996,19895,18059,1836,9.2,133667,126244,7423,5.6
St. John the Baptist,6/1/1996,20608,18207,2401,11.7,133697,126602,7095,5.3
St. John the Baptist,7/1/1996,20859,18087,2772,13.3,134284,126947,7337,5.5
St. John the Baptist,8/1/1996,20089,17793,2296,11.4,134054,127172,6882,5.1
St. John the Baptist,9/1/1996,20116,17926,2190,10.9,134515,127536,6979,5.2
St. John the Baptist,10/1/1996,20158,18071,2087,10.4,134921,127890,7031,5.2
St. John the Baptist,11/1/1996,20073,18159,1914,9.5,135007,127771,7236,5.4
St. John the Baptist,12/1/1996,19882,18093,1789,9,135113,127860,7253,5.4
St. John the Baptist,1/1/1997,19720,17876,1844,9.4,135456,128298,7158,5.3
St. John the Baptist,2/1/1997,19488,17970,1518,7.8,135400,128298,7102,5.2
St. John the Baptist,3/1/1997,19809,18222,1587,8,135891,128891,7000,5.2
St. John the Baptist,4/1/1997,19708,18339,1369,6.9,136016,129143,6873,5.1
St. John the Baptist,5/1/1997,19964,18433,1531,7.7,136119,129464,6655,4.9
St. John the Baptist,6/1/1997,20275,18474,1801,8.9,136211,129412,6799,5
St. John the Baptist,7/1/1997,20096,18410,1686,8.4,136477,129822,6655,4.9
St. John the Baptist,8/1/1997,19576,18087,1489,7.6,136618,130010,6608,4.8
St. John the Baptist,9/1/1997,19543,18125,1418,7.3,136675,130019,6656,4.9
St. John the Baptist,10/1/1997,19643,18293,1350,6.9,136633,130179,6454,4.7
St. John the Baptist,11/1/1997,19683,18476,1207,6.1,136961,130653,6308,4.6
St. John the Baptist,12/1/1997,19534,18429,1105,5.7,137155,130679,6476,4.7
St. John the Baptist,1/1/1998,19508,18330,1178,6,137095,130726,6368,4.6
St. John the Baptist,2/1/1998,19482,18480,1002,5.1,137112,130807,6306,4.6
St. John the Baptist,3/1/1998,19728,18665,1063,5.4,137236,130814,6422,4.7
St. John the Baptist,4/1/1998,19870,18832,1038,5.2,137150,131209,5941,4.3
St. John the Baptist,5/1/1998,20229,18940,1289,6.4,137372,131325,6047,4.4
St. John the Baptist,6/1/1998,20666,18926,1740,8.4,137455,131244,6212,4.5
St. John the Baptist,7/1/1998,20699,18761,1938,9.4,137588,131329,6259,4.5
St. John the Baptist,8/1/1998,20068,18388,1680,8.4,137570,131390,6179,4.5
St. John the Baptist,9/1/1998,20134,18501,1633,8.1,138286,131986,6300,4.6
St. John the Baptist,10/1/1998,20205,18564,1641,8.1,138279,131999,6280,4.5
St. John the Baptist,11/1/1998,20305,18684,1621,8,138381,132280,6100,4.4
St. John the Baptist,12/1/1998,20122,18643,1479,7.4,138634,132602,6032,4.4
St. John the Baptist,1/1/1999,20092,18650,1442,7.2,139003,133027,5976,4.3
St. John the Baptist,2/1/1999,20368,18752,1616,7.9,138967,132856,6111,4.4
St. John the Baptist,3/1/1999,20300,18925,1375,6.8,138730,132947,5783,4.2
St. John the Baptist,4/1/1999,20311,18957,1354,6.7,138959,132955,6004,4.3
St. John the Baptist,5/1/1999,20406,19034,1372,6.7,139107,133311,5796,4.2
St. John the Baptist,6/1/1999,20835,19069,1766,8.5,139329,133378,5951,4.3
St. John the Baptist,7/1/1999,20700,18897,1803,8.7,139439,133414,6025,4.3
St. John the Baptist,8/1/1999,19993,18520,1473,7.4,139430,133591,5838,4.2
St. John the Baptist,9/1/1999,19964,18574,1390,7,139622,133707,5915,4.2
St. John the Baptist,10/1/1999,20022,18715,1307,6.5,139771,133993,5778,4.1
St. John the Baptist,11/1/1999,20107,18895,1212,6,140025,134309,5716,4.1
St. John the Baptist,12/1/1999,20038,18787,1251,6.2,140177,134523,5653,4
St. John the Baptist,1/1/2000,19761,18499,1262,6.4,142267,136559,5708,4
St. John the Baptist,2/1/2000,19798,18637,1161,5.9,142456,136598,5858,4.1
St. John the Baptist,3/1/2000,19879,18801,1078,5.4,142434,136701,5733,4
St. John the Baptist,4/1/2000,19901,18911,990,5,142751,137270,5481,3.8
St. John the Baptist,5/1/2000,20194,18884,1310,6.5,142388,136630,5758,4
St. John the Baptist,6/1/2000,20477,18885,1592,7.8,142591,136940,5651,4
St. John the Baptist,7/1/2000,20275,18700,1575,7.8,142278,136531,5747,4
St. John the Baptist,8/1/2000,19795,18293,1502,7.6,142514,136662,5853,4.1
St. John the Baptist,9/1/2000,19621,18350,1271,6.5,142518,136893,5625,3.9
St. John the Baptist,10/1/2000,19696,18433,1263,6.4,142622,137088,5534,3.9
St. John the Baptist,11/1/2000,19995,18576,1419,7.1,142962,137322,5639,3.9
St. John the Baptist,12/1/2000,19885,18568,1317,6.6,143248,137614,5634,3.9
St. John the Baptist,1/1/2001,20109,18646,1463,7.3,143800,137778,6023,4.2
St. John the Baptist,2/1/2001,19996,18751,1245,6.2,143701,137612,6089,4.2
St. John the Baptist,3/1/2001,20146,18949,1197,5.9,143924,137783,6141,4.3
St. John the Baptist,4/1/2001,19982,18901,1081,5.4,143569,137299,6271,4.4
St. John the Baptist,5/1/2001,20120,18936,1184,5.9,143318,137092,6226,4.3
St. John the Baptist,6/1/2001,20444,18933,1511,7.4,143357,136873,6484,4.5
St. John the Baptist,7/1/2001,20303,18849,1454,7.2,143654,137071,6583,4.6
St. John the Baptist,8/1/2001,19678,18313,1365,6.9,143284,136241,7042,4.9
St. John the Baptist,9/1/2001,19779,18492,1287,6.5,143989,136846,7142,5
St. John the Baptist,10/1/2001,19870,18464,1406,7.1,144086,136392,7694,5.3
St. John the Baptist,11/1/2001,20085,18595,1490,7.4,144240,136238,8003,5.5
St. John the Baptist,12/1/2001,19868,18461,1407,7.1,144305,136047,8258,5.7
St. John the Baptist,1/1/2002,19795,18298,1497,7.6,143883,135701,8182,5.7
St. John the Baptist,2/1/2002,19819,18527,1292,6.5,144653,136438,8215,5.7
St. John the Baptist,3/1/2002,19959,18675,1284,6.4,144481,136177,8304,5.7
St. John the Baptist,4/1/2002,19945,18715,1230,6.2,144725,136126,8599,5.9
St. John the Baptist,5/1/2002,20116,18773,1343,6.7,144938,136539,8399,5.8
St. John the Baptist,6/1/2002,20442,18801,1641,8,144808,136415,8393,5.8
St. John the Baptist,7/1/2002,20286,18715,1571,7.7,144803,136413,8390,5.8
St. John the Baptist,8/1/2002,19763,18314,1449,7.3,145009,136705,8304,5.7
St. John the Baptist,9/1/2002,19785,18523,1262,6.4,145552,137302,8251,5.7
St. John the Baptist,10/1/2002,19852,18476,1376,6.9,145314,137008,8307,5.7
St. John the Baptist,11/1/2002,19987,18605,1382,6.9,145041,136521,8520,5.9
St. John the Baptist,12/1/2002,19777,18472,1305,6.6,145066,136426,8640,6
St. John the Baptist,1/1/2003,20046,18575,1471,7.3,145937,137417,8520,5.8
St. John the Baptist,2/1/2003,20120,18764,1356,6.7,146100,137482,8618,5.9
St. John the Baptist,3/1/2003,20231,18932,1299,6.4,146022,137434,8588,5.9
St. John the Baptist,4/1/2003,20216,18984,1232,6.1,146474,137633,8842,6
St. John the Baptist,5/1/2003,20368,19007,1361,6.7,146500,137544,8957,6.1
St. John the Baptist,6/1/2003,20742,19041,1701,8.2,147056,137790,9266,6.3
St. John the Baptist,7/1/2003,20465,18898,1567,7.7,146485,137474,9011,6.2
St. John the Baptist,8/1/2003,19871,18455,1416,7.1,146445,137549,8896,6.1
St. John the Baptist,9/1/2003,19888,18607,1281,6.4,146530,137609,8921,6.1
St. John the Baptist,10/1/2003,19916,18678,1238,6.2,146716,137984,8732,6
St. John the Baptist,11/1/2003,20246,18910,1336,6.6,147000,138424,8576,5.8
St. John the Baptist,12/1/2003,19991,18791,1200,6,146729,138411,8317,5.7
St. John the Baptist,1/1/2004,20127,18769,1358,6.7,146842,138472,8370,5.7
St. John the Baptist,2/1/2004,20179,18965,1214,6,146709,138542,8167,5.6
St. John the Baptist,3/1/2004,20398,19151,1247,6.1,146944,138453,8491,5.8
St. John the Baptist,4/1/2004,20545,19232,1313,6.4,146850,138680,8170,5.6
St. John the Baptist,5/1/2004,20730,19282,1448,7,147065,138852,8212,5.6
St. John the Baptist,6/1/2004,20985,19356,1629,7.8,147460,139174,8286,5.6
St. John the Baptist,7/1/2004,20857,19347,1510,7.2,147692,139556,8136,5.5
St. John the Baptist,8/1/2004,20323,18936,1387,6.8,147564,139573,7990,5.4
St. John the Baptist,9/1/2004,20313,19028,1285,6.3,147415,139487,7927,5.4
St. John the Baptist,10/1/2004,20393,19088,1305,6.4,147793,139732,8061,5.5
St. John the Baptist,11/1/2004,20685,19365,1320,6.4,148162,140231,7932,5.4
St. John the Baptist,12/1/2004,20488,19248,1240,6.1,148059,140125,7934,5.4
St. John the Baptist,1/1/2005,20685,19300,1385,6.7,148029,140245,7784,5.3
St. John the Baptist,2/1/2005,20693,19458,1235,6,148364,140385,7980,5.4
St. John the Baptist,3/1/2005,20780,19687,1093,5.3,148391,140654,7737,5.2
St. John the Baptist,4/1/2005,20947,19858,1089,5.2,148926,141254,7672,5.2
St. John the Baptist,5/1/2005,21172,19934,1238,5.8,149261,141609,7651,5.1
St. John the Baptist,6/1/2005,21426,19997,1429,6.7,149238,141714,7524,5
St. John the Baptist,7/1/2005,21423,19949,1474,6.9,149432,142026,7406,5
St. John the Baptist,8/1/2005,20842,19505,1337,6.4,149779,142434,7345,4.9
St. John the Baptist,7/1/2006,22791,21317,1474,6.5,151377,144202,7175,4.7
St. John the Baptist,8/1/2006,22513,21178,1335,5.9,151716,144625,7091,4.7
St. John the Baptist,9/1/2006,22325,21124,1201,5.4,151662,144815,6847,4.5
St. John the Baptist,10/1/2006,22778,21614,1164,5.1,152041,145314,6727,4.4
St. John the Baptist,11/1/2006,22928,21813,1115,4.9,152406,145534,6872,4.5
St. John the Baptist,12/1/2006,22969,21879,1090,4.7,152732,145970,6762,4.4
St. John the Baptist,1/1/2007,22379,21192,1187,5.3,153144,146028,7116,4.6
St. John the Baptist,2/1/2007,22379,21321,1058,4.7,152983,146057,6927,4.5
St. John the Baptist,3/1/2007,22625,21604,1021,4.5,153051,146320,6731,4.4
St. John the Baptist,4/1/2007,22408,21335,1073,4.8,152435,145586,6850,4.5
St. John the Baptist,5/1/2007,22381,21284,1097,4.9,152670,145903,6766,4.4
St. John the Baptist,6/1/2007,22728,21501,1227,5.4,153041,146063,6979,4.6
St. John the Baptist,7/1/2007,22743,21535,1208,5.3,153054,145905,7149,4.7
St. John the Baptist,8/1/2007,22399,21284,1115,5,152749,145682,7067,4.6
St. John the Baptist,9/1/2007,22291,21222,1069,4.8,153414,146244,7170,4.7
St. John the Baptist,10/1/2007,22713,21770,943,4.2,153183,145946,7237,4.7
St. John the Baptist,11/1/2007,22915,21954,961,4.2,153835,146595,7240,4.7
St. John the Baptist,12/1/2007,22960,21912,1048,4.6,153918,146273,7645,5
St. John the Baptist,1/1/2008,20648,19492,1156,5.6,154063,146378,7685,5
St. John the Baptist,2/1/2008,20533,19553,980,4.8,153653,146156,7497,4.9
St. John the Baptist,3/1/2008,20754,19742,1012,4.9,153908,146086,7822,5.1
St. John the Baptist,4/1/2008,20920,20007,913,4.4,153769,146132,7637,5
St. John the Baptist,5/1/2008,20864,19859,1005,4.8,154303,145908,8395,5.4
St. John the Baptist,6/1/2008,21261,20041,1220,5.7,154313,145737,8575,5.6
St. John the Baptist,7/1/2008,21248,20038,1210,5.7,154469,145532,8937,5.8
St. John the Baptist,8/1/2008,21178,19938,1240,5.9,154641,145203,9438,6.1
St. John the Baptist,9/1/2008,21677,19894,1783,8.2,154570,145076,9494,6.1
St. John the Baptist,10/1/2008,21362,20035,1327,6.2,154876,144802,10074,6.5
St. John the Baptist,11/1/2008,21245,19943,1302,6.1,154639,144100,10538,6.8
St. John the Baptist,12/1/2008,21342,19908,1434,6.7,154655,143369,11286,7.3
St. John the Baptist,1/1/2009,20396,18702,1694,8.3,154210,142152,12058,7.8
St. John the Baptist,2/1/2009,20430,18777,1653,8.1,154538,141640,12898,8.3
St. John the Baptist,3/1/2009,20467,18791,1676,8.2,154133,140707,13426,8.7
St. John the Baptist,4/1/2009,20572,18960,1612,7.8,154509,140656,13853,9
St. John the Baptist,5/1/2009,20543,18854,1689,8.2,154747,140248,14499,9.4
St. John the Baptist,6/1/2009,20817,18880,1937,9.3,154716,140009,14707,9.5
St. John the Baptist,7/1/2009,20847,19017,1830,8.8,154502,139901,14601,9.5
St. John the Baptist,8/1/2009,20729,18950,1779,8.6,154307,139492,14814,9.6
St. John the Baptist,9/1/2009,20536,18779,1757,8.6,153827,138818,15009,9.8
St. John the Baptist,10/1/2009,20604,18888,1716,8.3,153784,138432,15352,10
St. John the Baptist,11/1/2009,20684,18965,1719,8.3,153878,138659,15219,9.9
St. John the Baptist,12/1/2009,20619,18776,1843,8.9,153111,138013,15098,9.9
St. John the Baptist,1/1/2010,21276,19220,2056,9.7,153484,138438,15046,9.8
St. John the Baptist,2/1/2010,21130,19265,1865,8.8,153694,138581,15113,9.8
St. John the Baptist,3/1/2010,21375,19437,1938,9.1,153954,138751,15202,9.9
St. John the Baptist,4/1/2010,21523,19617,1906,8.9,154622,139297,15325,9.9
St. John the Baptist,5/1/2010,21444,19382,2062,9.6,154091,139241,14849,9.6
St. John the Baptist,6/1/2010,21795,19452,2343,10.8,153616,139141,14474,9.4
St. John the Baptist,7/1/2010,21809,19419,2390,11,153691,139179,14512,9.4
St. John the Baptist,8/1/2010,21541,19292,2249,10.4,154086,139438,14648,9.5
St. John the Baptist,9/1/2010,21594,19345,2249,10.4,153975,139396,14579,9.5
St. John the Baptist,10/1/2010,21557,19397,2160,10,153635,139119,14516,9.4
St. John the Baptist,11/1/2010,21641,19469,2172,10,154125,139044,15081,9.8
St. John the Baptist,12/1/2010,21636,19491,2145,9.9,153650,139301,14348,9.3
St. John the Baptist,1/1/2011,21051,18773,2278,10.8,153263,139250,14013,9.1
St. John the Baptist,2/1/2011,21015,18856,2159,10.3,153214,139394,13820,9
St. John the Baptist,3/1/2011,21146,19005,2141,10.1,153376,139639,13737,9
St. John the Baptist,4/1/2011,20975,19017,1958,9.3,153543,139586,13957,9.1
St. John the Baptist,5/1/2011,20921,18898,2023,9.7,153479,139624,13855,9
St. John the Baptist,6/1/2011,21145,18827,2318,11,153346,139384,13962,9.1
St. John the Baptist,7/1/2011,21068,18833,2235,10.6,153288,139524,13763,9
St. John the Baptist,8/1/2011,20918,18795,2123,10.1,153760,139942,13818,9
St. John the Baptist,9/1/2011,20950,18851,2099,10,154131,140183,13948,9
St. John the Baptist,10/1/2011,21033,19042,1991,9.5,153961,140368,13594,8.8
St. John the Baptist,11/1/2011,21033,19175,1858,8.8,154128,140826,13302,8.6
St. John the Baptist,12/1/2011,20955,19103,1852,8.8,153995,140902,13093,8.5
St. John the Baptist,1/1/2012,20462,18466,1996,9.8,154381,141584,12797,8.3
St. John the Baptist,2/1/2012,20394,18559,1835,9,154671,141858,12813,8.3
St. John the Baptist,3/1/2012,20531,18719,1812,8.8,154749,142036,12713,8.2
St. John the Baptist,4/1/2012,20652,18950,1702,8.2,154545,141899,12646,8.2
St. John the Baptist,5/1/2012,20673,18879,1794,8.7,154866,142206,12660,8.2
St. John the Baptist,6/1/2012,20832,18806,2026,9.7,155083,142391,12692,8.2
St. John the Baptist,7/1/2012,20835,18875,1960,9.4,154948,142292,12656,8.2
St. John the Baptist,8/1/2012,20554,18708,1846,9,154763,142291,12471,8.1
St. John the Baptist,9/1/2012,20567,18660,1907,9.3,155160,143044,12115,7.8
St. John the Baptist,10/1/2012,20642,18957,1685,8.2,155554,143431,12124,7.8
St. John the Baptist,11/1/2012,20534,19003,1531,7.5,155338,143333,12005,7.7
St. John the Baptist,12/1/2012,20555,18933,1622,7.9,155628,143330,12298,7.9
St. John the Baptist,1/1/2013,20036,18240,1796,9,155763,143292,12471,8
St. John the Baptist,2/1/2013,19979,18301,1678,8.4,155312,143362,11950,7.7
St. John the Baptist,3/1/2013,19991,18341,1650,8.3,155005,143316,11689,7.5
St. John the Baptist,4/1/2013,20068,18472,1596,8,155394,143635,11760,7.6
St. John the Baptist,5/1/2013,20075,18395,1680,8.4,155536,143882,11654,7.5
St. John the Baptist,6/1/2013,20383,18445,1938,9.5,155749,143999,11751,7.5
St. John the Baptist,7/1/2013,20211,18382,1829,9,155599,144264,11335,7.3
St. John the Baptist,8/1/2013,20112,18383,1729,8.6,155605,144326,11279,7.2
St. John the Baptist,9/1/2013,20032,18329,1703,8.5,155687,144418,11270,7.2
St. John the Baptist,10/1/2013,20038,18493,1545,7.7,154673,143537,11136,7.2
St. John the Baptist,11/1/2013,20123,18697,1426,7.1,155265,144479,10787,6.9
St. John the Baptist,12/1/2013,19985,18620,1365,6.8,155182,144778,10404,6.7
St. John the Baptist,1/1/2014,19707,18260,1447,7.3,155352,145150,10202,6.6
St. John the Baptist,2/1/2014,19788,18422,1366,6.9,155483,145134,10349,6.7
St. John the Baptist,3/1/2014,20055,18627,1428,7.1,156028,145648,10380,6.7
St. John the Baptist,4/1/2014,20019,18666,1353,6.8,155369,145667,9702,6.2
St. John the Baptist,5/1/2014,20098,18608,1490,7.4,155684,145825,9859,6.3
St. John the Baptist,6/1/2014,20468,18769,1699,8.3,155707,146247,9460,6.1
St. John the Baptist,7/1/2014,20562,18768,1794,8.7,156007,146399,9608,6.2
St. John the Baptist,8/1/2014,20468,18687,1781,8.7,156130,146530,9599,6.1
St. John the Baptist,9/1/2014,20344,18604,1740,8.6,156040,146778,9262,5.9
St. John the Baptist,10/1/2014,20547,18878,1669,8.1,156417,147427,8990,5.7
St. John the Baptist,11/1/2014,20644,19021,1623,7.9,156494,147404,9090,5.8
St. John the Baptist,12/1/2014,20487,18870,1617,7.9,156332,147615,8717,5.6
St. John the Baptist,1/1/2015,20235,18488,1747,8.6,157030,148145,8885,5.7
St. John the Baptist,2/1/2015,20194,18597,1597,7.9,156644,148045,8599,5.5
St. John the Baptist,3/1/2015,20318,18763,1555,7.7,156643,148128,8515,5.4
St. John the Baptist,4/1/2015,20532,19050,1482,7.2,157060,148511,8550,5.4
St. John the Baptist,5/1/2015,20487,18917,1570,7.7,157651,148817,8834,5.6
St. John the Baptist,6/1/2015,20543,18864,1679,8.2,157062,148816,8247,5.3
St. John the Baptist,7/1/2015,20403,18847,1556,7.6,156997,148830,8167,5.2
St. John the Baptist,8/1/2015,20141,18681,1460,7.2,157172,149181,7992,5.1
St. John the Baptist,9/1/2015,19982,18556,1426,7.1,156733,148826,7907,5
St. John the Baptist,10/1/2015,20173,18820,1353,6.7,157167,149246,7922,5
St. John the Baptist,11/1/2015,20143,18852,1291,6.4,157463,149463,8000,5.1
St. John the Baptist,12/1/2015,20115,18827,1288,6.4,158035,150128,7907,5
St. John the Baptist,1/1/2016,19931,18522,1409,7.1,158280,150653,7627,4.8
St. John the Baptist,2/1/2016,19961,18614,1347,6.7,158640,150939,7702,4.9
St. John the Baptist,3/1/2016,20084,18716,1368,6.8,159179,151218,7961,5
St. John the Baptist,4/1/2016,20133,18821,1312,6.5,159141,151074,8067,5.1
St. John the Baptist,5/1/2016,20043,18726,1317,6.6,158784,151132,7652,4.8
St. John the Baptist,6/1/2016,20278,18703,1575,7.8,158967,151223,7744,4.9
St. John the Baptist,7/1/2016,20246,18749,1497,7.4,159194,151554,7641,4.8
St. John the Baptist,8/1/2016,20049,18615,1434,7.2,159562,151779,7784,4.9
St. John the Baptist,9/1/2016,20069,18658,1411,7,159714,151761,7953,5
St. John the Baptist,10/1/2016,19994,18734,1260,6.3,159605,151793,7811,4.9
St. John the Baptist,11/1/2016,19960,18772,1188,6,159506,151954,7553,4.7
St. John the Baptist,12/1/2016,19838,18587,1251,6.3,159678,152157,7521,4.7
St. John the Baptist,1/1/2017,19560,18187,1373,7,159620,152152,7468,4.7
St. John the Baptist,2/1/2017,19693,18438,1255,6.4,159859,152480,7379,4.6
St. John the Baptist,3/1/2017,19693,18466,1227,6.2,160137,153065,7073,4.4
St. John the Baptist,4/1/2017,19782,18576,1206,6.1,160345,153255,7089,4.4
St. John the Baptist,5/1/2017,19651,18439,1212,6.2,160068,153069,7000,4.4
St. John the Baptist,6/1/2017,19778,18415,1363,6.9,160192,153318,6873,4.3
St. John the Baptist,7/1/2017,19766,18455,1311,6.6,160462,153569,6892,4.3
St. John the Baptist,8/1/2017,19665,18376,1289,6.6,160586,153503,7082,4.4
St. John the Baptist,9/1/2017,19739,18553,1186,6,161140,154286,6854,4.3
St. John the Baptist,10/1/2017,19650,18610,1040,5.3,160309,153609,6700,4.2
St. John the Baptist,11/1/2017,19689,18675,1014,5.2,160579,153805,6774,4.2
St. John the Baptist,12/1/2017,19635,18603,1032,5.3,160535,153904,6632,4.1
St. John the Baptist,1/1/2018,19502,18386,1116,5.7,160914,154425,6489,4
St. John the Baptist,2/1/2018,19596,18524,1072,5.5,161778,155197,6581,4.1
St. John the Baptist,3/1/2018,19608,18548,1060,5.4,161686,155214,6472,4
St. John the Baptist,4/1/2018,19736,18701,1035,5.2,161771,155312,6459,4
St. John the Baptist,5/1/2018,19576,18495,1081,5.5,161848,155652,6196,3.8
St. John the Baptist,6/1/2018,19775,18459,1316,6.7,162210,155762,6447,4
St. John the Baptist,7/1/2018,19695,18448,1247,6.3,162341,156146,6195,3.8
St. John the Baptist,8/1/2018,19451,18257,1194,6.1,161660,155504,6156,3.8
St. John the Baptist,9/1/2018,19415,18326,1089,5.6,162087,156015,6073,3.7
St. John the Baptist,10/1/2018,19551,18523,1028,5.3,162602,156391,6211,3.8
St. John the Baptist,11/1/2018,19537,18589,948,4.9,162836,156721,6115,3.8
St. John the Baptist,12/1/2018,19490,18464,1026,5.3,163206,156817,6389,3.9
St. John the Baptist,1/1/2019,19366,18228,1138,5.9,162963,156487,6475,4
St. John the Baptist,2/1/2019,19407,18425,982,5.1,162999,156863,6136,3.8
St. John the Baptist,3/1/2019,19291,18381,910,4.7,162904,156701,6202,3.8
St. John the Baptist,4/1/2019,19441,18587,854,4.4,162586,156625,5961,3.7
St. John the Baptist,5/1/2019,19395,18434,961,5,162751,156821,5930,3.6
St. John the Baptist,6/1/2019,19698,18492,1206,6.1,163168,157232,5935,3.6
St. John the Baptist,7/1/2019,19610,18446,1164,5.9,163590,157529,6061,3.7
St. John the Baptist,8/1/2019,19443,18326,1117,5.7,163774,157829,5945,3.6
St. John the Baptist,9/1/2019,19440,18397,1043,5.4,164092,158339,5753,3.5
St. John the Baptist,10/1/2019,19724,18602,1122,5.7,164416,158545,5871,3.6
St. John the Baptist,11/1/2019,19810,18727,1083,5.5,164496,158629,5868,3.6
St. John the Baptist,12/1/2019,19654,18585,1069,5.4,164699,158845,5853,3.6
St. John the Baptist,1/1/2020,19439,18326,1113,5.7,164377,158508,5869,3.6
St. John the Baptist,2/1/2020,19315,18400,915,4.7,164467,158714,5753,3.5
St. John the Baptist,3/1/2020,19464,17918,1546,7.9,162559,155353,7206,4.4
St. John the Baptist,4/1/2020,17987,14983,3004,16.7,156269,133185,23084,14.8
St. John the Baptist,5/1/2020,18588,15388,3200,17.2,158101,137173,20929,13.2
St. John the Baptist,6/1/2020,19182,16114,3068,16,159994,142342,17652,11
St. John the Baptist,7/1/2020,19173,16314,2859,14.9,160132,143779,16352,10.2
St. John the Baptist,8/1/2020,19044,16609,2435,12.8,160706,147245,13461,8.4
St. John the Baptist,9/1/2020,19148,16630,2518,13.2,160174,147620,12554,7.8
St. John the Baptist,10/1/2020,19319,17082,2237,11.6,161003,149931,11072,6.9
St. John the Baptist,11/1/2020,19065,17165,1900,10,160629,149934,10694,6.7
St. John the Baptist,12/1/2020,18947,17083,1864,9.8,160745,149975,10770,6.7
St. John the Baptist,1/1/2021,18798,16850,1948,10.4,160088,149852,10236,6.4
St. John the Baptist,2/1/2021,18906,17090,1816,9.6,160184,150189,9995,6.2
St. John the Baptist,3/1/2021,18909,17178,1731,9.2,160400,150644,9756,6.1
St. John the Baptist,4/1/2021,19146,17366,1780,9.3,160843,151081,9762,6.1
St. John the Baptist,5/1/2021,19142,17366,1776,9.3,160800,151535,9266,5.8
St. John the Baptist,6/1/2021,19443,17430,2013,10.4,161197,151734,9462,5.9
St. John the Baptist,7/1/2021,19450,17695,1755,9,161504,152773,8731,5.4
St. John the Baptist,8/1/2021,19145,17635,1510,7.9,161527,153250,8276,5.1
St. John the Baptist,9/1/2021,18686,17028,1658,8.9,161495,153843,7652,4.7
St. John the Baptist,10/1/2021,18863,17475,1388,7.4,161754,154475,7279,4.5
St. John the Baptist,11/1/2021,18983,17779,1204,6.3,162281,155530,6751,4.2
St. John the Baptist,12/1/2021,18830,17776,1054,5.6,162497,156099,6398,3.9
St. John the Baptist,1/1/2022,18838,17603,1235,6.6,163627,157115,6512,4
St. John the Baptist,2/1/2022,18957,17845,1112,5.9,163899,157598,6301,3.8
St. John the Baptist,3/1/2022,18968,17968,1000,5.3,164220,158206,6014,3.7
St. John the Baptist,4/1/2022,18938,18028,910,4.8,163893,157891,6002,3.7
St. John the Baptist,5/1/2022,18921,17995,926,4.9,164362,158378,5983,3.6
St. John the Baptist,6/1/2022,19137,18060,1077,5.6,164046,158094,5951,3.6
St. John the Baptist,7/1/2022,19099,18077,1022,5.4,164026,158258,5768,3.5
St. John the Baptist,8/1/2022,18918,17972,946,5,164654,158735,5919,3.6
St. John the Baptist,9/1/2022,18811,17965,846,4.5,164602,158810,5792,3.5
St. John the Baptist,10/1/2022,18835,18058,777,4.1,164648,158684,5964,3.6
St. John the Baptist,11/1/2022,18872,18114,758,4,164450,158507,5943,3.6
St. John the Baptist,12/1/2022,18834,18088,746,4,165025,159259,5766,3.5
St. John the Baptist,1/1/2023,18747,17871,876,4.7,165964,160217,5747,3.5
St. John the Baptist,2/1/2023,18849,18032,817,4.3,166358,160395,5962,3.6
St. John the Baptist,3/1/2023,18947,18155,792,4.2,166651,160812,5839,3.5
St. John the Baptist,4/1/2023,18965,18222,743,3.9,166725,160974,5751,3.4
St. John the Baptist,5/1/2023,18909,18093,816,4.3,166886,160796,6089,3.6
St. John the Baptist,6/1/2023,19045,18123,922,4.8,166937,160979,5958,3.6
St. John the Baptist,7/1/2023,18879,18060,819,4.3,167103,161183,5920,3.5
St. John the Baptist,8/1/2023,18843,17960,883,4.7,167759,161475,6284,3.7
St. John the Baptist,9/1/2023,18787,17934,853,4.5,167767,161442,6326,3.8
St. John the Baptist,10/1/2023,18835,17969,866,4.6,167690,161211,6479,3.9
St. John the Baptist,11/1/2023,18874,18025,849,4.5,168140,161886,6254,3.7
St. John the Baptist,12/1/2023,18664,17813,851,4.6,167439,161124,6315,3.8
St. John the Baptist,1/1/2024,18602,17624,978,5.3,167339,161190,6149,3.7
St. John the Baptist,2/1/2024,18693,17785,908,4.9,167475,161013,6462,3.9
St. John the Baptist,3/1/2024,18828,17947,881,4.7,167922,161425,6497,3.9
St. John the Baptist,4/1/2024,18901,18077,824,4.4,167988,161495,6492,3.9
St. John the Baptist,5/1/2024,18708,17852,856,4.6,167799,161164,6635,4
St. John the Baptist,6/1/2024,18982,17889,1093,5.8,168005,161155,6849,4.1
St. John the Baptist,7/1/2024,19136,18033,1103,5.8,168315,161219,7097,4.2
St. John the Baptist,8/1/2024,18917,17828,1089,5.8,168496,161425,7071,4.2
St. John the Baptist,9/1/2024,18845,17839,1006,5.3,168703,161802,6901,4.1
St. John the Baptist,10/1/2024,18946,17943,1003,5.3,168428,161456,6972,4.1
St. John the Baptist,11/1/2024,19022,18011,1011,5.3,168304,161183,7121,4.2
St. John the Baptist,12/1/2024,18780,17865,915,4.9,168547,161661,6886,4.1
St. John the Baptist,1/1/2025,18219,17214,1005,5.5,170744,163895,6849,4
St. John the Baptist,2/1/2025,18374,17489,885,4.8,170359,163307,7052,4.1
St. Landry,1/1/1990,28403,25614,2789,9.8,125833,119081,6752,5.4
St. Landry,2/1/1990,28477,25998,2479,8.7,125710,119059,6651,5.3
St. Landry,3/1/1990,28846,26446,2400,8.3,125801,119203,6598,5.2
St. Landry,4/1/1990,29046,26704,2342,8.1,125649,118852,6797,5.4
St. Landry,5/1/1990,28846,26874,1972,6.8,125893,119151,6742,5.4
St. Landry,6/1/1990,29627,27175,2452,8.3,125573,118983,6590,5.2
St. Landry,7/1/1990,30244,27775,2469,8.2,125732,118810,6922,5.5
St. Landry,8/1/1990,30592,28062,2530,8.3,125990,118802,7188,5.7
St. Landry,9/1/1990,30060,27348,2712,9,125892,118524,7368,5.9
St. Landry,10/1/1990,30077,27519,2558,8.5,125995,118536,7459,5.9
St. Landry,11/1/1990,30186,27509,2677,8.9,126070,118306,7764,6.2
St. Landry,12/1/1990,30101,27463,2638,8.8,126142,118241,7901,6.3
St. Landry,1/1/1991,30138,26685,3453,11.5,125955,117940,8015,6.4
St. Landry,2/1/1991,29773,26882,2891,9.7,126020,117755,8265,6.6
St. Landry,3/1/1991,30059,27290,2769,9.2,126238,117652,8586,6.8
St. Landry,4/1/1991,30261,27739,2522,8.3,126548,118109,8439,6.7
St. Landry,5/1/1991,30345,27590,2755,9.1,126176,117440,8736,6.9
St. Landry,6/1/1991,31318,27826,3492,11.2,126331,117639,8692,6.9
St. Landry,7/1/1991,31216,28169,3047,9.8,126154,117568,8586,6.8
St. Landry,8/1/1991,30836,27831,3005,9.7,126150,117484,8666,6.9
St. Landry,9/1/1991,30582,27684,2898,9.5,126650,117928,8722,6.9
St. Landry,10/1/1991,30400,27634,2766,9.1,126642,117800,8842,7
St. Landry,11/1/1991,30154,27617,2537,8.4,126701,117770,8931,7
St. Landry,12/1/1991,30085,27425,2660,8.8,126664,117466,9198,7.3
St. Landry,1/1/1992,29867,26500,3367,11.3,127261,117978,9283,7.3
St. Landry,2/1/1992,29549,26496,3053,10.3,127207,117753,9454,7.4
St. Landry,3/1/1992,29945,26768,3177,10.6,127604,118144,9460,7.4
St. Landry,4/1/1992,30034,26995,3039,10.1,127841,118426,9415,7.4
St. Landry,5/1/1992,29840,26802,3038,10.2,128119,118375,9744,7.6
St. Landry,6/1/1992,30690,26961,3729,12.2,128459,118419,10040,7.8
St. Landry,7/1/1992,31304,28076,3228,10.3,128563,118713,9850,7.7
St. Landry,8/1/1992,31104,27916,3188,10.2,128613,118826,9787,7.6
St. Landry,9/1/1992,30493,27468,3025,9.9,128501,118720,9781,7.6
St. Landry,10/1/1992,30023,27474,2549,8.5,128026,118628,9398,7.3
St. Landry,11/1/1992,30188,27638,2550,8.4,128441,118876,9565,7.4
St. Landry,12/1/1992,29596,27013,2583,8.7,128554,118997,9557,7.4
St. Landry,1/1/1993,29202,26163,3039,10.4,128400,119075,9325,7.3
St. Landry,2/1/1993,28945,26421,2524,8.7,128458,119275,9183,7.1
St. Landry,3/1/1993,29436,26731,2705,9.2,128598,119542,9056,7
St. Landry,4/1/1993,29792,26932,2860,9.6,128584,119474,9110,7.1
St. Landry,5/1/1993,29783,27017,2766,9.3,129264,120115,9149,7.1
St. Landry,6/1/1993,30133,26978,3155,10.5,129411,120290,9121,7
St. Landry,7/1/1993,30233,27425,2808,9.3,129397,120467,8930,6.9
St. Landry,8/1/1993,30125,27525,2600,8.6,129619,120856,8763,6.8
St. Landry,9/1/1993,29703,27190,2513,8.5,129268,120554,8714,6.7
St. Landry,10/1/1993,29822,27360,2462,8.3,129573,120823,8750,6.8
St. Landry,11/1/1993,29854,27463,2391,8,129711,121169,8542,6.6
St. Landry,12/1/1993,29859,27399,2460,8.2,129941,121464,8477,6.5
St. Landry,1/1/1994,29660,26453,3207,10.8,130596,121966,8630,6.6
St. Landry,2/1/1994,29561,26736,2825,9.6,130669,122086,8583,6.6
St. Landry,3/1/1994,29876,26993,2883,9.6,130400,121930,8470,6.5
St. Landry,4/1/1994,29996,27300,2696,9,130621,122290,8331,6.4
St. Landry,5/1/1994,30070,27458,2612,8.7,130779,122864,7915,6.1
St. Landry,6/1/1994,30483,27393,3090,10.1,130561,122634,7927,6.1
St. Landry,7/1/1994,31073,27985,3088,9.9,130652,122706,7946,6.1
St. Landry,8/1/1994,31366,28008,3358,10.7,131275,123342,7933,6
St. Landry,9/1/1994,30792,27707,3085,10,131421,123687,7734,5.9
St. Landry,10/1/1994,30715,27586,3129,10.2,131744,124112,7632,5.8
St. Landry,11/1/1994,30444,27774,2670,8.8,131891,124516,7375,5.6
St. Landry,12/1/1994,30122,27540,2582,8.6,131951,124721,7230,5.5
St. Landry,1/1/1995,30177,26881,3296,10.9,132038,124663,7375,5.6
St. Landry,2/1/1995,29944,27190,2754,9.2,132115,124928,7187,5.4
St. Landry,3/1/1995,30343,27583,2760,9.1,132108,124955,7153,5.4
St. Landry,4/1/1995,30592,27840,2752,9,132590,124945,7645,5.8
St. Landry,5/1/1995,30168,27651,2517,8.3,131851,124421,7430,5.6
St. Landry,6/1/1995,30474,27795,2679,8.8,131949,124522,7427,5.6
St. Landry,7/1/1995,30704,28183,2521,8.2,132343,124816,7527,5.7
St. Landry,8/1/1995,30505,28181,2324,7.6,132336,124852,7484,5.7
St. Landry,9/1/1995,30269,28005,2264,7.5,132611,125133,7478,5.6
St. Landry,10/1/1995,30267,28037,2230,7.4,132716,125388,7328,5.5
St. Landry,11/1/1995,30485,28223,2262,7.4,132614,125188,7426,5.6
St. Landry,12/1/1995,30274,28093,2181,7.2,132511,125088,7423,5.6
St. Landry,1/1/1996,30020,27243,2777,9.3,132616,125125,7491,5.6
St. Landry,2/1/1996,29966,27642,2324,7.8,132952,125639,7313,5.5
St. Landry,3/1/1996,30129,27911,2218,7.4,133180,125862,7318,5.5
St. Landry,4/1/1996,30443,28152,2291,7.5,133409,125994,7415,5.6
St. Landry,5/1/1996,30450,28185,2265,7.4,133667,126244,7423,5.6
St. Landry,6/1/1996,30974,28399,2575,8.3,133697,126602,7095,5.3
St. Landry,7/1/1996,31469,28932,2537,8.1,134284,126947,7337,5.5
St. Landry,8/1/1996,31584,29120,2464,7.8,134054,127172,6882,5.1
St. Landry,9/1/1996,31199,28911,2288,7.3,134515,127536,6979,5.2
St. Landry,10/1/1996,31271,29096,2175,7,134921,127890,7031,5.2
St. Landry,11/1/1996,30997,29118,1879,6.1,135007,127771,7236,5.4
St. Landry,12/1/1996,31009,29100,1909,6.2,135113,127860,7253,5.4
St. Landry,1/1/1997,30980,28399,2581,8.3,135456,128298,7158,5.3
St. Landry,2/1/1997,31022,28544,2478,8,135400,128298,7102,5.2
St. Landry,3/1/1997,31491,28954,2537,8.1,135891,128891,7000,5.2
St. Landry,4/1/1997,31696,29273,2423,7.6,136016,129143,6873,5.1
St. Landry,5/1/1997,31743,29351,2392,7.5,136119,129464,6655,4.9
St. Landry,6/1/1997,32171,29391,2780,8.6,136211,129412,6799,5
St. Landry,7/1/1997,32464,29903,2561,7.9,136477,129822,6655,4.9
St. Landry,8/1/1997,32000,29882,2118,6.6,136618,130010,6608,4.8
St. Landry,9/1/1997,31488,29498,1990,6.3,136675,130019,6656,4.9
St. Landry,10/1/1997,32283,29760,2523,7.8,136633,130179,6454,4.7
St. Landry,11/1/1997,31883,29705,2178,6.8,136961,130653,6308,4.6
St. Landry,12/1/1997,31852,29752,2100,6.6,137155,130679,6476,4.7
St. Landry,1/1/1998,31712,29022,2690,8.5,137095,130726,6368,4.6
St. Landry,2/1/1998,31409,29260,2149,6.8,137112,130807,6306,4.6
St. Landry,3/1/1998,31952,29533,2419,7.6,137236,130814,6422,4.7
St. Landry,4/1/1998,32145,29938,2207,6.9,137150,131209,5941,4.3
St. Landry,5/1/1998,32228,29964,2264,7,137372,131325,6047,4.4
St. Landry,6/1/1998,32833,30107,2726,8.3,137455,131244,6212,4.5
St. Landry,7/1/1998,32706,30434,2272,6.9,137588,131329,6259,4.5
St. Landry,8/1/1998,32929,30381,2548,7.7,137570,131390,6179,4.5
St. Landry,9/1/1998,32393,29995,2398,7.4,138286,131986,6300,4.6
St. Landry,10/1/1998,31805,29751,2054,6.5,138279,131999,6280,4.5
St. Landry,11/1/1998,31706,29754,1952,6.2,138381,132280,6100,4.4
St. Landry,12/1/1998,31347,29581,1766,5.6,138634,132602,6032,4.4
St. Landry,1/1/1999,31040,28747,2293,7.4,139003,133027,5976,4.3
St. Landry,2/1/1999,31074,28881,2193,7.1,138967,132856,6111,4.4
St. Landry,3/1/1999,31129,29009,2120,6.8,138730,132947,5783,4.2
St. Landry,4/1/1999,31280,29184,2096,6.7,138959,132955,6004,4.3
St. Landry,5/1/1999,31147,29097,2050,6.6,139107,133311,5796,4.2
St. Landry,6/1/1999,31733,29205,2528,8,139329,133378,5951,4.3
St. Landry,7/1/1999,31666,29286,2380,7.5,139439,133414,6025,4.3
St. Landry,8/1/1999,31535,29232,2303,7.3,139430,133591,5838,4.2
St. Landry,9/1/1999,31511,29029,2482,7.9,139622,133707,5915,4.2
St. Landry,10/1/1999,31520,29173,2347,7.4,139771,133993,5778,4.1
St. Landry,11/1/1999,31138,29224,1914,6.1,140025,134309,5716,4.1
St. Landry,12/1/1999,31014,29122,1892,6.1,140177,134523,5653,4
St. Landry,1/1/2000,32165,29979,2186,6.8,142267,136559,5708,4
St. Landry,2/1/2000,32108,30185,1923,6,142456,136598,5858,4.1
St. Landry,3/1/2000,32390,30379,2011,6.2,142434,136701,5733,4
St. Landry,4/1/2000,32523,30731,1792,5.5,142751,137270,5481,3.8
St. Landry,5/1/2000,32486,30522,1964,6,142388,136630,5758,4
St. Landry,6/1/2000,33136,30799,2337,7.1,142591,136940,5651,4
St. Landry,7/1/2000,33148,30976,2172,6.6,142278,136531,5747,4
St. Landry,8/1/2000,32795,30590,2205,6.7,142514,136662,5853,4.1
St. Landry,9/1/2000,32453,30356,2097,6.5,142518,136893,5625,3.9
St. Landry,10/1/2000,32635,30645,1990,6.1,142622,137088,5534,3.9
St. Landry,11/1/2000,32571,30563,2008,6.2,142962,137322,5639,3.9
St. Landry,12/1/2000,32696,30721,1975,6,143248,137614,5634,3.9
St. Landry,1/1/2001,32833,30403,2430,7.4,143800,137778,6023,4.2
St. Landry,2/1/2001,32703,30610,2093,6.4,143701,137612,6089,4.2
St. Landry,3/1/2001,33121,30974,2147,6.5,143924,137783,6141,4.3
St. Landry,4/1/2001,32693,30640,2053,6.3,143569,137299,6271,4.4
St. Landry,5/1/2001,32504,30463,2041,6.3,143318,137092,6226,4.3
St. Landry,6/1/2001,33272,30798,2474,7.4,143357,136873,6484,4.5
St. Landry,7/1/2001,33396,31178,2218,6.6,143654,137071,6583,4.6
St. Landry,8/1/2001,32859,30646,2213,6.7,143284,136241,7042,4.9
St. Landry,9/1/2001,32908,30618,2290,7,143989,136846,7142,5
St. Landry,10/1/2001,33057,30788,2269,6.9,144086,136392,7694,5.3
St. Landry,11/1/2001,32654,30445,2209,6.8,144240,136238,8003,5.5
St. Landry,12/1/2001,32635,30434,2201,6.7,144305,136047,8258,5.7
St. Landry,1/1/2002,32403,29930,2473,7.6,143883,135701,8182,5.7
St. Landry,2/1/2002,32403,30311,2092,6.5,144653,136438,8215,5.7
St. Landry,3/1/2002,32716,30526,2190,6.7,144481,136177,8304,5.7
St. Landry,4/1/2002,33188,31003,2185,6.6,144725,136126,8599,5.9
St. Landry,5/1/2002,33098,30871,2227,6.7,144938,136539,8399,5.8
St. Landry,6/1/2002,33789,31159,2630,7.8,144808,136415,8393,5.8
St. Landry,7/1/2002,33968,31569,2399,7.1,144803,136413,8390,5.8
St. Landry,8/1/2002,33598,31229,2369,7.1,145009,136705,8304,5.7
St. Landry,9/1/2002,33273,30954,2319,7,145552,137302,8251,5.7
St. Landry,10/1/2002,33213,30909,2304,6.9,145314,137008,8307,5.7
St. Landry,11/1/2002,33008,30747,2261,6.8,145041,136521,8520,5.9
St. Landry,12/1/2002,32902,30590,2312,7,145066,136426,8640,6
St. Landry,1/1/2003,33380,30743,2637,7.9,145937,137417,8520,5.8
St. Landry,2/1/2003,33220,30797,2423,7.3,146100,137482,8618,5.9
St. Landry,3/1/2003,33484,30990,2494,7.4,146022,137434,8588,5.9
St. Landry,4/1/2003,33728,31353,2375,7,146474,137633,8842,6
St. Landry,5/1/2003,33604,31179,2425,7.2,146500,137544,8957,6.1
St. Landry,6/1/2003,34669,31596,3073,8.9,147056,137790,9266,6.3
St. Landry,7/1/2003,34559,31738,2821,8.2,146485,137474,9011,6.2
St. Landry,8/1/2003,34146,31507,2639,7.7,146445,137549,8896,6.1
St. Landry,9/1/2003,33873,31356,2517,7.4,146530,137609,8921,6.1
St. Landry,10/1/2003,33616,31265,2351,7,146716,137984,8732,6
St. Landry,11/1/2003,33505,31294,2211,6.6,147000,138424,8576,5.8
St. Landry,12/1/2003,33417,31278,2139,6.4,146729,138411,8317,5.7
St. Landry,1/1/2004,33983,31498,2485,7.3,146842,138472,8370,5.7
St. Landry,2/1/2004,33618,31505,2113,6.3,146709,138542,8167,5.6
St. Landry,3/1/2004,33759,31543,2216,6.6,146944,138453,8491,5.8
St. Landry,4/1/2004,34074,31974,2100,6.2,146850,138680,8170,5.6
St. Landry,5/1/2004,34082,31906,2176,6.4,147065,138852,8212,5.6
St. Landry,6/1/2004,35268,32734,2534,7.2,147460,139174,8286,5.6
St. Landry,7/1/2004,35158,32858,2300,6.5,147692,139556,8136,5.5
St. Landry,8/1/2004,34741,32719,2022,5.8,147564,139573,7990,5.4
St. Landry,9/1/2004,34623,32565,2058,5.9,147415,139487,7927,5.4
St. Landry,10/1/2004,34736,32697,2039,5.9,147793,139732,8061,5.5
St. Landry,11/1/2004,34715,32695,2020,5.8,148162,140231,7932,5.4
St. Landry,12/1/2004,34683,32658,2025,5.8,148059,140125,7934,5.4
St. Landry,1/1/2005,35501,33193,2308,6.5,148029,140245,7784,5.3
St. Landry,2/1/2005,35173,33105,2068,5.9,148364,140385,7980,5.4
St. Landry,3/1/2005,35386,33407,1979,5.6,148391,140654,7737,5.2
St. Landry,4/1/2005,35632,33694,1938,5.4,148926,141254,7672,5.2
St. Landry,5/1/2005,35606,33536,2070,5.8,149261,141609,7651,5.1
St. Landry,6/1/2005,36716,34318,2398,6.5,149238,141714,7524,5
St. Landry,7/1/2005,36732,34596,2136,5.8,149432,142026,7406,5
St. Landry,8/1/2005,36072,34091,1981,5.5,149779,142434,7345,4.9
St. Landry,9/1/2005,40552,36275,4277,10.5,149954,142401,7553,5
St. Landry,10/1/2005,41187,36852,4335,10.5,150001,142548,7453,5
St. Landry,11/1/2005,40982,36686,4296,10.5,150065,142499,7566,5
St. Landry,12/1/2005,38394,36218,2176,5.7,150030,142752,7279,4.9
St. Landry,1/1/2006,38028,36225,1803,4.7,150214,143150,7064,4.7
St. Landry,2/1/2006,37455,36056,1399,3.7,150641,143457,7184,4.8
St. Landry,3/1/2006,37708,36245,1463,3.9,150813,143741,7072,4.7
St. Landry,4/1/2006,37624,36174,1450,3.9,150881,143761,7120,4.7
St. Landry,5/1/2006,37704,36123,1581,4.2,151069,144089,6980,4.6
St. Landry,6/1/2006,38772,36909,1863,4.8,151354,144353,7001,4.6
St. Landry,7/1/2006,38748,37147,1601,4.1,151377,144202,7175,4.7
St. Landry,8/1/2006,38141,36540,1601,4.2,151716,144625,7091,4.7
St. Landry,9/1/2006,38066,36462,1604,4.2,151662,144815,6847,4.5
St. Landry,10/1/2006,37981,36424,1557,4.1,152041,145314,6727,4.4
St. Landry,11/1/2006,37809,36197,1612,4.3,152406,145534,6872,4.5
St. Landry,12/1/2006,37661,36143,1518,4,152732,145970,6762,4.4
St. Landry,1/1/2007,37196,35378,1818,4.9,153144,146028,7116,4.6
St. Landry,2/1/2007,37072,35483,1589,4.3,152983,146057,6927,4.5
St. Landry,3/1/2007,37518,35950,1568,4.2,153051,146320,6731,4.4
St. Landry,4/1/2007,37655,36106,1549,4.1,152435,145586,6850,4.5
St. Landry,5/1/2007,37755,36060,1695,4.5,152670,145903,6766,4.4
St. Landry,6/1/2007,38393,36400,1993,5.2,153041,146063,6979,4.6
St. Landry,7/1/2007,38300,36479,1821,4.8,153054,145905,7149,4.7
St. Landry,8/1/2007,37734,36072,1662,4.4,152749,145682,7067,4.6
St. Landry,9/1/2007,37751,36066,1685,4.5,153414,146244,7170,4.7
St. Landry,10/1/2007,37312,35819,1493,4,153183,145946,7237,4.7
St. Landry,11/1/2007,37564,36057,1507,4,153835,146595,7240,4.7
St. Landry,12/1/2007,37170,35570,1600,4.3,153918,146273,7645,5
St. Landry,1/1/2008,37418,35564,1854,5,154063,146378,7685,5
St. Landry,2/1/2008,37236,35678,1558,4.2,153653,146156,7497,4.9
St. Landry,3/1/2008,37638,35931,1707,4.5,153908,146086,7822,5.1
St. Landry,4/1/2008,37801,36256,1545,4.1,153769,146132,7637,5
St. Landry,5/1/2008,37972,36184,1788,4.7,154303,145908,8395,5.4
St. Landry,6/1/2008,38682,36498,2184,5.6,154313,145737,8575,5.6
St. Landry,7/1/2008,38435,36401,2034,5.3,154469,145532,8937,5.8
St. Landry,8/1/2008,38107,36062,2045,5.4,154641,145203,9438,6.1
St. Landry,9/1/2008,38204,36159,2045,5.4,154570,145076,9494,6.1
St. Landry,10/1/2008,38256,36177,2079,5.4,154876,144802,10074,6.5
St. Landry,11/1/2008,38244,36191,2053,5.4,154639,144100,10538,6.8
St. Landry,12/1/2008,37816,35637,2179,5.8,154655,143369,11286,7.3
St. Landry,1/1/2009,37613,35184,2429,6.5,154210,142152,12058,7.8
St. Landry,2/1/2009,37821,35440,2381,6.3,154538,141640,12898,8.3
St. Landry,3/1/2009,38058,35523,2535,6.7,154133,140707,13426,8.7
St. Landry,4/1/2009,38120,35538,2582,6.8,154509,140656,13853,9
St. Landry,5/1/2009,38252,35511,2741,7.2,154747,140248,14499,9.4
St. Landry,6/1/2009,39271,36005,3266,8.3,154716,140009,14707,9.5
St. Landry,7/1/2009,39001,35871,3130,8,154502,139901,14601,9.5
St. Landry,8/1/2009,38457,35472,2985,7.8,154307,139492,14814,9.6
St. Landry,9/1/2009,38423,35500,2923,7.6,153827,138818,15009,9.8
St. Landry,10/1/2009,38561,35680,2881,7.5,153784,138432,15352,10
St. Landry,11/1/2009,38668,35927,2741,7.1,153878,138659,15219,9.9
St. Landry,12/1/2009,38245,35416,2829,7.4,153111,138013,15098,9.9
St. Landry,1/1/2010,33780,30572,3208,9.5,153484,138438,15046,9.8
St. Landry,2/1/2010,33700,30760,2940,8.7,153694,138581,15113,9.8
St. Landry,3/1/2010,34195,31258,2937,8.6,153954,138751,15202,9.9
St. Landry,4/1/2010,34376,31557,2819,8.2,154622,139297,15325,9.9
St. Landry,5/1/2010,34616,31580,3036,8.8,154091,139241,14849,9.6
St. Landry,6/1/2010,35076,31702,3374,9.6,153616,139141,14474,9.4
St. Landry,7/1/2010,35366,32072,3294,9.3,153691,139179,14512,9.4
St. Landry,8/1/2010,34814,31593,3221,9.3,154086,139438,14648,9.5
St. Landry,9/1/2010,34498,31376,3122,9,153975,139396,14579,9.5
St. Landry,10/1/2010,34007,30956,3051,9,153635,139119,14516,9.4
St. Landry,11/1/2010,34005,30938,3067,9,154125,139044,15081,9.8
St. Landry,12/1/2010,33627,30648,2979,8.9,153650,139301,14348,9.3
St. Landry,1/1/2011,33414,30050,3364,10.1,153263,139250,14013,9.1
St. Landry,2/1/2011,33332,30228,3104,9.3,153214,139394,13820,9
St. Landry,3/1/2011,33547,30525,3022,9,153376,139639,13737,9
St. Landry,4/1/2011,33594,30801,2793,8.3,153543,139586,13957,9.1
St. Landry,5/1/2011,33782,30828,2954,8.7,153479,139624,13855,9
St. Landry,6/1/2011,34359,31033,3326,9.7,153346,139384,13962,9.1
St. Landry,7/1/2011,34363,31236,3127,9.1,153288,139524,13763,9
St. Landry,8/1/2011,33442,30440,3002,9,153760,139942,13818,9
St. Landry,9/1/2011,33813,30809,3004,8.9,154131,140183,13948,9
St. Landry,10/1/2011,34109,31235,2874,8.4,153961,140368,13594,8.8
St. Landry,11/1/2011,33970,31258,2712,8,154128,140826,13302,8.6
St. Landry,12/1/2011,33708,31008,2700,8,153995,140902,13093,8.5
St. Landry,1/1/2012,33433,30466,2967,8.9,154381,141584,12797,8.3
St. Landry,2/1/2012,33369,30625,2744,8.2,154671,141858,12813,8.3
St. Landry,3/1/2012,33550,30811,2739,8.2,154749,142036,12713,8.2
St. Landry,4/1/2012,34008,31485,2523,7.4,154545,141899,12646,8.2
St. Landry,5/1/2012,34283,31600,2683,7.8,154866,142206,12660,8.2
St. Landry,6/1/2012,35066,32024,3042,8.7,155083,142391,12692,8.2
St. Landry,7/1/2012,33056,30117,2939,8.9,154948,142292,12656,8.2
St. Landry,8/1/2012,32467,29814,2653,8.2,154763,142291,12471,8.1
St. Landry,9/1/2012,33555,31069,2486,7.4,155160,143044,12115,7.8
St. Landry,10/1/2012,33522,31124,2398,7.2,155554,143431,12124,7.8
St. Landry,11/1/2012,33282,31085,2197,6.6,155338,143333,12005,7.7
St. Landry,12/1/2012,33269,30892,2377,7.1,155628,143330,12298,7.9
St. Landry,1/1/2013,33248,30415,2833,8.5,155763,143292,12471,8
St. Landry,2/1/2013,32987,30463,2524,7.7,155312,143362,11950,7.7
St. Landry,3/1/2013,33345,30813,2532,7.6,155005,143316,11689,7.5
St. Landry,4/1/2013,33781,31296,2485,7.4,155394,143635,11760,7.6
St. Landry,5/1/2013,33908,31280,2628,7.8,155536,143882,11654,7.5
St. Landry,6/1/2013,34665,31728,2937,8.5,155749,143999,11751,7.5
St. Landry,7/1/2013,34590,31867,2723,7.9,155599,144264,11335,7.3
St. Landry,8/1/2013,33914,31381,2533,7.5,155605,144326,11279,7.2
St. Landry,9/1/2013,33829,31351,2478,7.3,155687,144418,11270,7.2
St. Landry,10/1/2013,33455,31123,2332,7,154673,143537,11136,7.2
St. Landry,11/1/2013,33419,31248,2171,6.5,155265,144479,10787,6.9
St. Landry,12/1/2013,33260,31245,2015,6.1,155182,144778,10404,6.7
St. Landry,1/1/2014,33116,30834,2282,6.9,155352,145150,10202,6.6
St. Landry,2/1/2014,33042,30869,2173,6.6,155483,145134,10349,6.7
St. Landry,3/1/2014,33461,31209,2252,6.7,156028,145648,10380,6.7
St. Landry,4/1/2014,33505,31390,2115,6.3,155369,145667,9702,6.2
St. Landry,5/1/2014,33758,31331,2427,7.2,155684,145825,9859,6.3
St. Landry,6/1/2014,34545,31789,2756,8,155707,146247,9460,6.1
St. Landry,7/1/2014,34963,32081,2882,8.2,156007,146399,9608,6.2
St. Landry,8/1/2014,34581,31715,2866,8.3,156130,146530,9599,6.1
St. Landry,9/1/2014,34432,31672,2760,8,156040,146778,9262,5.9
St. Landry,10/1/2014,34372,31675,2697,7.8,156417,147427,8990,5.7
St. Landry,11/1/2014,34181,31504,2677,7.8,156494,147404,9090,5.8
St. Landry,12/1/2014,34092,31466,2626,7.7,156332,147615,8717,5.6
St. Landry,1/1/2015,33712,30757,2955,8.8,157030,148145,8885,5.7
St. Landry,2/1/2015,33537,30813,2724,8.1,156644,148045,8599,5.5
St. Landry,3/1/2015,33780,31079,2701,8,156643,148128,8515,5.4
St. Landry,4/1/2015,33887,31265,2622,7.7,157060,148511,8550,5.4
St. Landry,5/1/2015,33941,31140,2801,8.3,157651,148817,8834,5.6
St. Landry,6/1/2015,34352,31496,2856,8.3,157062,148816,8247,5.3
St. Landry,7/1/2015,34114,31232,2882,8.4,156997,148830,8167,5.2
St. Landry,8/1/2015,33511,30908,2603,7.8,157172,149181,7992,5.1
St. Landry,9/1/2015,33228,30645,2583,7.8,156733,148826,7907,5
St. Landry,10/1/2015,33165,30614,2551,7.7,157167,149246,7922,5
St. Landry,11/1/2015,33017,30591,2426,7.3,157463,149463,8000,5.1
St. Landry,12/1/2015,33036,30679,2357,7.1,158035,150128,7907,5
St. Landry,1/1/2016,32743,30082,2661,8.1,158280,150653,7627,4.8
St. Landry,2/1/2016,32837,30327,2510,7.6,158640,150939,7702,4.9
St. Landry,3/1/2016,33190,30592,2598,7.8,159179,151218,7961,5
St. Landry,4/1/2016,33059,30508,2551,7.7,159141,151074,8067,5.1
St. Landry,5/1/2016,33046,30442,2604,7.9,158784,151132,7652,4.8
St. Landry,6/1/2016,33677,30565,3112,9.2,158967,151223,7744,4.9
St. Landry,7/1/2016,33514,30527,2987,8.9,159194,151554,7641,4.8
St. Landry,8/1/2016,32876,30063,2813,8.6,159562,151779,7784,4.9
St. Landry,9/1/2016,32618,29860,2758,8.5,159714,151761,7953,5
St. Landry,10/1/2016,32154,29654,2500,7.8,159605,151793,7811,4.9
St. Landry,11/1/2016,32035,29767,2268,7.1,159506,151954,7553,4.7
St. Landry,12/1/2016,31802,29538,2264,7.1,159678,152157,7521,4.7
St. Landry,1/1/2017,31806,29311,2495,7.8,159620,152152,7468,4.7
St. Landry,2/1/2017,31865,29541,2324,7.3,159859,152480,7379,4.6
St. Landry,3/1/2017,32148,29954,2194,6.8,160137,153065,7073,4.4
St. Landry,4/1/2017,32139,30030,2109,6.6,160345,153255,7089,4.4
St. Landry,5/1/2017,31911,29791,2120,6.6,160068,153069,7000,4.4
St. Landry,6/1/2017,32773,30289,2484,7.6,160192,153318,6873,4.3
St. Landry,7/1/2017,32676,30317,2359,7.2,160462,153569,6892,4.3
St. Landry,8/1/2017,32184,29941,2243,7,160586,153503,7082,4.4
St. Landry,9/1/2017,31952,29928,2024,6.3,161140,154286,6854,4.3
St. Landry,10/1/2017,31641,29886,1755,5.5,160309,153609,6700,4.2
St. Landry,11/1/2017,31604,29847,1757,5.6,160579,153805,6774,4.2
St. Landry,12/1/2017,31579,29828,1751,5.5,160535,153904,6632,4.1
St. Landry,1/1/2018,31543,29580,1963,6.2,160914,154425,6489,4
St. Landry,2/1/2018,31839,29998,1841,5.8,161778,155197,6581,4.1
St. Landry,3/1/2018,32097,30189,1908,5.9,161686,155214,6472,4
St. Landry,4/1/2018,32021,30202,1819,5.7,161771,155312,6459,4
St. Landry,5/1/2018,32059,30167,1892,5.9,161848,155652,6196,3.8
St. Landry,6/1/2018,32661,30148,2513,7.7,162210,155762,6447,4
St. Landry,7/1/2018,32626,30298,2328,7.1,162341,156146,6195,3.8
St. Landry,8/1/2018,31900,29864,2036,6.4,161660,155504,6156,3.8
St. Landry,9/1/2018,31478,29560,1918,6.1,162087,156015,6073,3.7
St. Landry,10/1/2018,31629,29764,1865,5.9,162602,156391,6211,3.8
St. Landry,11/1/2018,31550,29824,1726,5.5,162836,156721,6115,3.8
St. Landry,12/1/2018,31474,29668,1806,5.7,163206,156817,6389,3.9
St. Landry,1/1/2019,31375,29295,2080,6.6,162963,156487,6475,4
St. Landry,2/1/2019,31351,29527,1824,5.8,162999,156863,6136,3.8
St. Landry,3/1/2019,31622,29927,1695,5.4,162904,156701,6202,3.8
St. Landry,4/1/2019,31595,30022,1573,5,162586,156625,5961,3.7
St. Landry,5/1/2019,31721,29949,1772,5.6,162751,156821,5930,3.6
St. Landry,6/1/2019,32521,30292,2229,6.9,163168,157232,5935,3.6
St. Landry,7/1/2019,32763,30582,2181,6.7,163590,157529,6061,3.7
St. Landry,8/1/2019,32185,30139,2046,6.4,163774,157829,5945,3.6
St. Landry,9/1/2019,32050,30092,1958,6.1,164092,158339,5753,3.5
St. Landry,10/1/2019,31997,30032,1965,6.1,164416,158545,5871,3.6
St. Landry,11/1/2019,31813,29907,1906,6,164496,158629,5868,3.6
St. Landry,12/1/2019,31682,29809,1873,5.9,164699,158845,5853,3.6
St. Landry,1/1/2020,31627,29593,2034,6.4,164377,158508,5869,3.6
St. Landry,2/1/2020,31499,29842,1657,5.3,164467,158714,5753,3.5
St. Landry,3/1/2020,32457,29668,2789,8.6,162559,155353,7206,4.4
St. Landry,4/1/2020,30659,27206,3453,11.3,156269,133185,23084,14.8
St. Landry,5/1/2020,31492,27741,3751,11.9,158101,137173,20929,13.2
St. Landry,6/1/2020,32331,28679,3652,11.3,159994,142342,17652,11
St. Landry,7/1/2020,32681,29084,3597,11,160132,143779,16352,10.2
St. Landry,8/1/2020,32246,29131,3115,9.7,160706,147245,13461,8.4
St. Landry,9/1/2020,32332,29127,3205,9.9,160174,147620,12554,7.8
St. Landry,10/1/2020,32238,29403,2835,8.8,161003,149931,11072,6.9
St. Landry,11/1/2020,32083,29581,2502,7.8,160629,149934,10694,6.7
St. Landry,12/1/2020,31933,29401,2532,7.9,160745,149975,10770,6.7
St. Landry,1/1/2021,31485,28880,2605,8.3,160088,149852,10236,6.4
St. Landry,2/1/2021,31637,29190,2447,7.7,160184,150189,9995,6.2
St. Landry,3/1/2021,31940,29617,2323,7.3,160400,150644,9756,6.1
St. Landry,4/1/2021,32036,29840,2196,6.9,160843,151081,9762,6.1
St. Landry,5/1/2021,32008,29784,2224,6.9,160800,151535,9266,5.8
St. Landry,6/1/2021,32599,30034,2565,7.9,161197,151734,9462,5.9
St. Landry,7/1/2021,32427,30191,2236,6.9,161504,152773,8731,5.4
St. Landry,8/1/2021,31702,29744,1958,6.2,161527,153250,8276,5.1
St. Landry,9/1/2021,32203,30453,1750,5.4,161495,153843,7652,4.7
St. Landry,10/1/2021,31552,30023,1529,4.8,161754,154475,7279,4.5
St. Landry,11/1/2021,31624,30221,1403,4.4,162281,155530,6751,4.2
St. Landry,12/1/2021,31449,30185,1264,4,162497,156099,6398,3.9
St. Landry,1/1/2022,31517,29946,1571,5,163627,157115,6512,4
St. Landry,2/1/2022,31758,30352,1406,4.4,163899,157598,6301,3.8
St. Landry,3/1/2022,31955,30615,1340,4.2,164220,158206,6014,3.7
St. Landry,4/1/2022,31873,30607,1266,4,163893,157891,6002,3.7
St. Landry,5/1/2022,31868,30497,1371,4.3,164362,158378,5983,3.6
St. Landry,6/1/2022,32464,30719,1745,5.4,164046,158094,5951,3.6
St. Landry,7/1/2022,32078,30480,1598,5,164026,158258,5768,3.5
St. Landry,8/1/2022,31394,29874,1520,4.8,164654,158735,5919,3.6
St. Landry,9/1/2022,31222,29845,1377,4.4,164602,158810,5792,3.5
St. Landry,10/1/2022,31247,29992,1255,4,164648,158684,5964,3.6
St. Landry,11/1/2022,31216,29996,1220,3.9,164450,158507,5943,3.6
St. Landry,12/1/2022,31167,29933,1234,4,165025,159259,5766,3.5
St. Landry,1/1/2023,31041,29566,1475,4.8,165964,160217,5747,3.5
St. Landry,2/1/2023,31295,29918,1377,4.4,166358,160395,5962,3.6
St. Landry,3/1/2023,31757,30439,1318,4.2,166651,160812,5839,3.5
St. Landry,4/1/2023,31955,30746,1209,3.8,166725,160974,5751,3.4
St. Landry,5/1/2023,31956,30541,1415,4.4,166886,160796,6089,3.6
St. Landry,6/1/2023,32456,30809,1647,5.1,166937,160979,5958,3.6
St. Landry,7/1/2023,32430,31012,1418,4.4,167103,161183,5920,3.5
St. Landry,8/1/2023,31877,30370,1507,4.7,167759,161475,6284,3.7
St. Landry,9/1/2023,31452,29977,1475,4.7,167767,161442,6326,3.8
St. Landry,10/1/2023,31554,30072,1482,4.7,167690,161211,6479,3.9
St. Landry,11/1/2023,31711,30256,1455,4.6,168140,161886,6254,3.7
St. Landry,12/1/2023,31426,29974,1452,4.6,167439,161124,6315,3.8
St. Landry,1/1/2024,31470,29804,1666,5.3,167339,161190,6149,3.7
St. Landry,2/1/2024,31493,29975,1518,4.8,167475,161013,6462,3.9
St. Landry,3/1/2024,31807,30315,1492,4.7,167922,161425,6497,3.9
St. Landry,4/1/2024,31825,30456,1369,4.3,167988,161495,6492,3.9
St. Landry,5/1/2024,31740,30234,1506,4.7,167799,161164,6635,4
St. Landry,6/1/2024,32381,30451,1930,6,168005,161155,6849,4.1
St. Landry,7/1/2024,32581,30641,1940,6,168315,161219,7097,4.2
St. Landry,8/1/2024,31912,30078,1834,5.7,168496,161425,7071,4.2
St. Landry,9/1/2024,31506,29786,1720,5.5,168703,161802,6901,4.1
St. Landry,10/1/2024,31418,29716,1702,5.4,168428,161456,6972,4.1
St. Landry,11/1/2024,31324,29656,1668,5.3,168304,161183,7121,4.2
St. Landry,12/1/2024,31152,29541,1611,5.2,168547,161661,6886,4.1
St. Landry,1/1/2025,31903,30229,1674,5.2,170744,163895,6849,4
St. Landry,2/1/2025,32103,30524,1579,4.9,170359,163307,7052,4.1
St. Martin,1/1/1990,18161,16824,1337,7.4,125833,119081,6752,5.4
St. Martin,2/1/1990,18159,17076,1083,6,125710,119059,6651,5.3
St. Martin,3/1/1990,18360,17369,991,5.4,125801,119203,6598,5.2
St. Martin,4/1/1990,18432,17540,892,4.8,125649,118852,6797,5.4
St. Martin,5/1/1990,18563,17651,912,4.9,125893,119151,6742,5.4
St. Martin,6/1/1990,18988,17849,1139,6,125573,118983,6590,5.2
St. Martin,7/1/1990,19275,18242,1033,5.4,125732,118810,6922,5.5
St. Martin,8/1/1990,19613,18431,1182,6,125990,118802,7188,5.7
St. Martin,9/1/1990,19070,17963,1107,5.8,125892,118524,7368,5.9
St. Martin,10/1/1990,19063,18075,988,5.2,125995,118536,7459,5.9
St. Martin,11/1/1990,19101,18069,1032,5.4,126070,118306,7764,6.2
St. Martin,12/1/1990,19246,18040,1206,6.3,126142,118241,7901,6.3
St. Martin,1/1/1991,19135,17467,1668,8.7,125955,117940,8015,6.4
St. Martin,2/1/1991,18875,17596,1279,6.8,126020,117755,8265,6.6
St. Martin,3/1/1991,19102,17862,1240,6.5,126238,117652,8586,6.8
St. Martin,4/1/1991,19364,18156,1208,6.2,126548,118109,8439,6.7
St. Martin,5/1/1991,19285,18059,1226,6.4,126176,117440,8736,6.9
St. Martin,6/1/1991,19566,18214,1352,6.9,126331,117639,8692,6.9
St. Martin,7/1/1991,19633,18437,1196,6.1,126154,117568,8586,6.8
St. Martin,8/1/1991,19528,18215,1313,6.7,126150,117484,8666,6.9
St. Martin,9/1/1991,19401,18119,1282,6.6,126650,117928,8722,6.9
St. Martin,10/1/1991,19381,18086,1295,6.7,126642,117800,8842,7
St. Martin,11/1/1991,19356,18077,1279,6.6,126701,117770,8931,7
St. Martin,12/1/1991,19324,17950,1374,7.1,126664,117466,9198,7.3
St. Martin,1/1/1992,19089,17398,1691,8.9,127261,117978,9283,7.3
St. Martin,2/1/1992,18971,17395,1576,8.3,127207,117753,9454,7.4
St. Martin,3/1/1992,19145,17574,1571,8.2,127604,118144,9460,7.4
St. Martin,4/1/1992,19294,17720,1574,8.2,127841,118426,9415,7.4
St. Martin,5/1/1992,19172,17596,1576,8.2,128119,118375,9744,7.6
St. Martin,6/1/1992,19521,17700,1821,9.3,128459,118419,10040,7.8
St. Martin,7/1/1992,20191,18432,1759,8.7,128563,118713,9850,7.7
St. Martin,8/1/1992,20043,18325,1718,8.6,128613,118826,9787,7.6
St. Martin,9/1/1992,19609,18032,1577,8,128501,118720,9781,7.6
St. Martin,10/1/1992,19386,18037,1349,7,128026,118628,9398,7.3
St. Martin,11/1/1992,19396,18145,1251,6.4,128441,118876,9565,7.4
St. Martin,12/1/1992,18919,17735,1184,6.3,128554,118997,9557,7.4
St. Martin,1/1/1993,18665,17152,1513,8.1,128400,119075,9325,7.3
St. Martin,2/1/1993,18608,17322,1286,6.9,128458,119275,9183,7.1
St. Martin,3/1/1993,18694,17524,1170,6.3,128598,119542,9056,7
St. Martin,4/1/1993,18805,17656,1149,6.1,128584,119474,9110,7.1
St. Martin,5/1/1993,18783,17713,1070,5.7,129264,120115,9149,7.1
St. Martin,6/1/1993,19062,17688,1374,7.2,129411,120290,9121,7
St. Martin,7/1/1993,19221,17980,1241,6.5,129397,120467,8930,6.9
St. Martin,8/1/1993,19326,18045,1281,6.6,129619,120856,8763,6.8
St. Martin,9/1/1993,19078,17826,1252,6.6,129268,120554,8714,6.7
St. Martin,10/1/1993,19167,17938,1229,6.4,129573,120823,8750,6.8
St. Martin,11/1/1993,19195,18004,1191,6.2,129711,121169,8542,6.6
St. Martin,12/1/1993,19102,17963,1139,6,129941,121464,8477,6.5
St. Martin,1/1/1994,19779,17647,2132,10.8,130596,121966,8630,6.6
St. Martin,2/1/1994,19286,17834,1452,7.5,130669,122086,8583,6.6
St. Martin,3/1/1994,19431,18005,1426,7.3,130400,121930,8470,6.5
St. Martin,4/1/1994,19707,18211,1496,7.6,130621,122290,8331,6.4
St. Martin,5/1/1994,19642,18316,1326,6.8,130779,122864,7915,6.1
St. Martin,6/1/1994,19886,18273,1613,8.1,130561,122634,7927,6.1
St. Martin,7/1/1994,20124,18668,1456,7.2,130652,122706,7946,6.1
St. Martin,8/1/1994,20173,18683,1490,7.4,131275,123342,7933,6
St. Martin,9/1/1994,20078,18484,1594,7.9,131421,123687,7734,5.9
St. Martin,10/1/1994,19964,18404,1560,7.8,131744,124112,7632,5.8
St. Martin,11/1/1994,19943,18527,1416,7.1,131891,124516,7375,5.6
St. Martin,12/1/1994,19655,18371,1284,6.5,131951,124721,7230,5.5
St. Martin,1/1/1995,19427,17784,1643,8.5,132038,124663,7375,5.6
St. Martin,2/1/1995,19283,17988,1295,6.7,132115,124928,7187,5.4
St. Martin,3/1/1995,19568,18249,1319,6.7,132108,124955,7153,5.4
St. Martin,4/1/1995,19635,18418,1217,6.2,132590,124945,7645,5.8
St. Martin,5/1/1995,19456,18293,1163,6,131851,124421,7430,5.6
St. Martin,6/1/1995,19817,18389,1428,7.2,131949,124522,7427,5.6
St. Martin,7/1/1995,20108,18646,1462,7.3,132343,124816,7527,5.7
St. Martin,8/1/1995,19971,18644,1327,6.6,132336,124852,7484,5.7
St. Martin,9/1/1995,19941,18526,1415,7.1,132611,125133,7478,5.6
St. Martin,10/1/1995,19861,18548,1313,6.6,132716,125388,7328,5.5
St. Martin,11/1/1995,19901,18672,1229,6.2,132614,125188,7426,5.6
St. Martin,12/1/1995,19788,18585,1203,6.1,132511,125088,7423,5.6
St. Martin,1/1/1996,19549,18117,1432,7.3,132616,125125,7491,5.6
St. Martin,2/1/1996,19569,18384,1185,6.1,132952,125639,7313,5.5
St. Martin,3/1/1996,19689,18560,1129,5.7,133180,125862,7318,5.5
St. Martin,4/1/1996,19896,18723,1173,5.9,133409,125994,7415,5.6
St. Martin,5/1/1996,19947,18743,1204,6,133667,126244,7423,5.6
St. Martin,6/1/1996,20265,18888,1377,6.8,133697,126602,7095,5.3
St. Martin,7/1/1996,20551,19242,1309,6.4,134284,126947,7337,5.5
St. Martin,8/1/1996,20544,19367,1177,5.7,134054,127172,6882,5.1
St. Martin,9/1/1996,20474,19228,1246,6.1,134515,127536,6979,5.2
St. Martin,10/1/1996,20567,19352,1215,5.9,134921,127890,7031,5.2
St. Martin,11/1/1996,20468,19366,1102,5.4,135007,127771,7236,5.4
St. Martin,12/1/1996,20397,19353,1044,5.1,135113,127860,7253,5.4
St. Martin,1/1/1997,20292,19034,1258,6.2,135456,128298,7158,5.3
St. Martin,2/1/1997,20183,19130,1053,5.2,135400,128298,7102,5.2
St. Martin,3/1/1997,20478,19404,1074,5.2,135891,128891,7000,5.2
St. Martin,4/1/1997,20554,19619,935,4.5,136016,129143,6873,5.1
St. Martin,5/1/1997,20606,19670,936,4.5,136119,129464,6655,4.9
St. Martin,6/1/1997,20963,19698,1265,6,136211,129412,6799,5
St. Martin,7/1/1997,21131,20039,1092,5.2,136477,129822,6655,4.9
St. Martin,8/1/1997,21025,20027,998,4.7,136618,130010,6608,4.8
St. Martin,9/1/1997,20783,19770,1013,4.9,136675,130019,6656,4.9
St. Martin,10/1/1997,21949,19946,2003,9.1,136633,130179,6454,4.7
St. Martin,11/1/1997,21682,19909,1773,8.2,136961,130653,6308,4.6
St. Martin,12/1/1997,21670,19939,1731,8,137155,130679,6476,4.7
St. Martin,1/1/1998,21853,19614,2239,10.2,137095,130726,6368,4.6
St. Martin,2/1/1998,21525,19774,1751,8.1,137112,130807,6306,4.6
St. Martin,3/1/1998,21868,19959,1909,8.7,137236,130814,6422,4.7
St. Martin,4/1/1998,21673,20233,1440,6.6,137150,131209,5941,4.3
St. Martin,5/1/1998,21648,20249,1399,6.5,137372,131325,6047,4.4
St. Martin,6/1/1998,21870,20347,1523,7,137455,131244,6212,4.5
St. Martin,7/1/1998,21940,20567,1373,6.3,137588,131329,6259,4.5
St. Martin,8/1/1998,21774,20532,1242,5.7,137570,131390,6179,4.5
St. Martin,9/1/1998,21618,20270,1348,6.2,138286,131986,6300,4.6
St. Martin,10/1/1998,21346,20105,1241,5.8,138279,131999,6280,4.5
St. Martin,11/1/1998,21254,20108,1146,5.4,138381,132280,6100,4.4
St. Martin,12/1/1998,21002,19993,1009,4.8,138634,132602,6032,4.4
St. Martin,1/1/1999,20678,19401,1277,6.2,139003,133027,5976,4.3
St. Martin,2/1/1999,20659,19491,1168,5.7,138967,132856,6111,4.4
St. Martin,3/1/1999,20812,19577,1235,5.9,138730,132947,5783,4.2
St. Martin,4/1/1999,20827,19696,1131,5.4,138959,132955,6004,4.3
St. Martin,5/1/1999,20682,19638,1044,5,139107,133311,5796,4.2
St. Martin,6/1/1999,21030,19709,1321,6.3,139329,133378,5951,4.3
St. Martin,7/1/1999,21050,19764,1286,6.1,139439,133414,6025,4.3
St. Martin,8/1/1999,20992,19729,1263,6,139430,133591,5838,4.2
St. Martin,9/1/1999,20925,19591,1334,6.4,139622,133707,5915,4.2
St. Martin,10/1/1999,20893,19688,1205,5.8,139771,133993,5778,4.1
St. Martin,11/1/1999,20819,19723,1096,5.3,140025,134309,5716,4.1
St. Martin,12/1/1999,20702,19653,1049,5.1,140177,134523,5653,4
St. Martin,1/1/2000,20765,19501,1264,6.1,142267,136559,5708,4
St. Martin,2/1/2000,20887,19755,1132,5.4,142456,136598,5858,4.1
St. Martin,3/1/2000,20911,19779,1132,5.4,142434,136701,5733,4
St. Martin,4/1/2000,21085,20111,974,4.6,142751,137270,5481,3.8
St. Martin,5/1/2000,21073,19956,1117,5.3,142388,136630,5758,4
St. Martin,6/1/2000,21302,19984,1318,6.2,142591,136940,5651,4
St. Martin,7/1/2000,21383,20196,1187,5.6,142278,136531,5747,4
St. Martin,8/1/2000,21587,20387,1200,5.6,142514,136662,5853,4.1
St. Martin,9/1/2000,21327,20166,1161,5.4,142518,136893,5625,3.9
St. Martin,10/1/2000,21539,20442,1097,5.1,142622,137088,5534,3.9
St. Martin,11/1/2000,21534,20435,1099,5.1,142962,137322,5639,3.9
St. Martin,12/1/2000,21705,20650,1055,4.9,143248,137614,5634,3.9
St. Martin,1/1/2001,21666,20427,1239,5.7,143800,137778,6023,4.2
St. Martin,2/1/2001,21664,20603,1061,4.9,143701,137612,6089,4.2
St. Martin,3/1/2001,21989,20755,1234,5.6,143924,137783,6141,4.3
St. Martin,4/1/2001,21861,20712,1149,5.3,143569,137299,6271,4.4
St. Martin,5/1/2001,21753,20647,1106,5.1,143318,137092,6226,4.3
St. Martin,6/1/2001,22031,20705,1326,6,143357,136873,6484,4.5
St. Martin,7/1/2001,22451,20983,1468,6.5,143654,137071,6583,4.6
St. Martin,8/1/2001,22473,21024,1449,6.4,143284,136241,7042,4.9
St. Martin,9/1/2001,22403,20829,1574,7,143989,136846,7142,5
St. Martin,10/1/2001,22538,20884,1654,7.3,144086,136392,7694,5.3
St. Martin,11/1/2001,22480,20755,1725,7.7,144240,136238,8003,5.5
St. Martin,12/1/2001,22471,20783,1688,7.5,144305,136047,8258,5.7
St. Martin,1/1/2002,22032,20084,1948,8.8,143883,135701,8182,5.7
St. Martin,2/1/2002,21997,20355,1642,7.5,144653,136438,8215,5.7
St. Martin,3/1/2002,21986,20316,1670,7.6,144481,136177,8304,5.7
St. Martin,4/1/2002,22140,20651,1489,6.7,144725,136126,8599,5.9
St. Martin,5/1/2002,21990,20497,1493,6.8,144938,136539,8399,5.8
St. Martin,6/1/2002,22177,20524,1653,7.5,144808,136415,8393,5.8
St. Martin,7/1/2002,22098,20661,1437,6.5,144803,136413,8390,5.8
St. Martin,8/1/2002,22097,20778,1319,6,145009,136705,8304,5.7
St. Martin,9/1/2002,21833,20588,1245,5.7,145552,137302,8251,5.7
St. Martin,10/1/2002,21758,20551,1207,5.5,145314,137008,8307,5.7
St. Martin,11/1/2002,21636,20455,1181,5.5,145041,136521,8520,5.9
St. Martin,12/1/2002,21550,20392,1158,5.4,145066,136426,8640,6
St. Martin,1/1/2003,21508,20128,1380,6.4,145937,137417,8520,5.8
St. Martin,2/1/2003,21635,20372,1263,5.8,146100,137482,8618,5.9
St. Martin,3/1/2003,21723,20402,1321,6.1,146022,137434,8588,5.9
St. Martin,4/1/2003,21729,20495,1234,5.7,146474,137633,8842,6
St. Martin,5/1/2003,21466,20165,1301,6.1,146500,137544,8957,6.1
St. Martin,6/1/2003,21984,20357,1627,7.4,147056,137790,9266,6.3
St. Martin,7/1/2003,21967,20469,1498,6.8,146485,137474,9011,6.2
St. Martin,8/1/2003,21741,20432,1309,6,146445,137549,8896,6.1
St. Martin,9/1/2003,21509,20302,1207,5.6,146530,137609,8921,6.1
St. Martin,10/1/2003,21501,20428,1073,5,146716,137984,8732,6
St. Martin,11/1/2003,21487,20420,1067,5,147000,138424,8576,5.8
St. Martin,12/1/2003,21663,20601,1062,4.9,146729,138411,8317,5.7
St. Martin,1/1/2004,21297,19961,1336,6.3,146842,138472,8370,5.7
St. Martin,2/1/2004,21294,20163,1131,5.3,146709,138542,8167,5.6
St. Martin,3/1/2004,21430,20236,1194,5.6,146944,138453,8491,5.8
St. Martin,4/1/2004,21459,20401,1058,4.9,146850,138680,8170,5.6
St. Martin,5/1/2004,21502,20357,1145,5.3,147065,138852,8212,5.6
St. Martin,6/1/2004,21910,20547,1363,6.2,147460,139174,8286,5.6
St. Martin,7/1/2004,21930,20648,1282,5.8,147692,139556,8136,5.5
St. Martin,8/1/2004,21771,20662,1109,5.1,147564,139573,7990,5.4
St. Martin,9/1/2004,21661,20504,1157,5.3,147415,139487,7927,5.4
St. Martin,10/1/2004,22055,20917,1138,5.2,147793,139732,8061,5.5
St. Martin,11/1/2004,22013,20926,1087,4.9,148162,140231,7932,5.4
St. Martin,12/1/2004,22065,20976,1089,4.9,148059,140125,7934,5.4
St. Martin,1/1/2005,21880,20558,1322,6,148029,140245,7784,5.3
St. Martin,2/1/2005,21907,20746,1161,5.3,148364,140385,7980,5.4
St. Martin,3/1/2005,21864,20757,1107,5.1,148391,140654,7737,5.2
St. Martin,4/1/2005,21854,20835,1019,4.7,148926,141254,7672,5.2
St. Martin,5/1/2005,21747,20676,1071,4.9,149261,141609,7651,5.1
St. Martin,6/1/2005,22106,20735,1371,6.2,149238,141714,7524,5
St. Martin,7/1/2005,22352,21106,1246,5.6,149432,142026,7406,5
St. Martin,8/1/2005,22175,21115,1060,4.8,149779,142434,7345,4.9
St. Martin,9/1/2005,24610,22533,2077,8.4,149954,142401,7553,5
St. Martin,10/1/2005,25032,23106,1926,7.7,150001,142548,7453,5
St. Martin,11/1/2005,24948,23006,1942,7.8,150065,142499,7566,5
St. Martin,12/1/2005,23915,22896,1019,4.3,150030,142752,7279,4.9
St. Martin,1/1/2006,23241,22356,885,3.8,150214,143150,7064,4.7
St. Martin,2/1/2006,23137,22407,730,3.2,150641,143457,7184,4.8
St. Martin,3/1/2006,23264,22466,798,3.4,150813,143741,7072,4.7
St. Martin,4/1/2006,23270,22511,759,3.3,150881,143761,7120,4.7
St. Martin,5/1/2006,23390,22585,805,3.4,151069,144089,6980,4.6
St. Martin,6/1/2006,23788,22741,1047,4.4,151354,144353,7001,4.6
St. Martin,7/1/2006,23933,23007,926,3.9,151377,144202,7175,4.7
St. Martin,8/1/2006,23593,22734,859,3.6,151716,144625,7091,4.7
St. Martin,9/1/2006,23538,22680,858,3.6,151662,144815,6847,4.5
St. Martin,10/1/2006,23504,22712,792,3.4,152041,145314,6727,4.4
St. Martin,11/1/2006,23574,22773,801,3.4,152406,145534,6872,4.5
St. Martin,12/1/2006,23468,22738,730,3.1,152732,145970,6762,4.4
St. Martin,1/1/2007,23299,22408,891,3.8,153144,146028,7116,4.6
St. Martin,2/1/2007,23200,22463,737,3.2,152983,146057,6927,4.5
St. Martin,3/1/2007,23458,22684,774,3.3,153051,146320,6731,4.4
St. Martin,4/1/2007,23534,22774,760,3.2,152435,145586,6850,4.5
St. Martin,5/1/2007,23610,22755,855,3.6,152670,145903,6766,4.4
St. Martin,6/1/2007,24060,22977,1083,4.5,153041,146063,6979,4.6
St. Martin,7/1/2007,24321,23320,1001,4.1,153054,145905,7149,4.7
St. Martin,8/1/2007,24032,23179,853,3.5,152749,145682,7067,4.6
St. Martin,9/1/2007,23873,23013,860,3.6,153414,146244,7170,4.7
St. Martin,10/1/2007,23765,23031,734,3.1,153183,145946,7237,4.7
St. Martin,11/1/2007,23959,23198,761,3.2,153835,146595,7240,4.7
St. Martin,12/1/2007,23927,23138,789,3.3,153918,146273,7645,5
St. Martin,1/1/2008,23669,22745,924,3.9,154063,146378,7685,5
St. Martin,2/1/2008,23616,22877,739,3.1,153653,146156,7497,4.9
St. Martin,3/1/2008,23815,22993,822,3.5,153908,146086,7822,5.1
St. Martin,4/1/2008,24062,23327,735,3.1,153769,146132,7637,5
St. Martin,5/1/2008,24128,23252,876,3.6,154303,145908,8395,5.4
St. Martin,6/1/2008,24562,23446,1116,4.5,154313,145737,8575,5.6
St. Martin,7/1/2008,24609,23562,1047,4.3,154469,145532,8937,5.8
St. Martin,8/1/2008,24351,23310,1041,4.3,154641,145203,9438,6.1
St. Martin,9/1/2008,24343,23307,1036,4.3,154570,145076,9494,6.1
St. Martin,10/1/2008,24517,23424,1093,4.5,154876,144802,10074,6.5
St. Martin,11/1/2008,24487,23421,1066,4.4,154639,144100,10538,6.8
St. Martin,12/1/2008,24357,23278,1079,4.4,154655,143369,11286,7.3
St. Martin,1/1/2009,23735,22500,1235,5.2,154210,142152,12058,7.8
St. Martin,2/1/2009,23859,22577,1282,5.4,154538,141640,12898,8.3
St. Martin,3/1/2009,23929,22568,1361,5.7,154133,140707,13426,8.7
St. Martin,4/1/2009,23924,22489,1435,6,154509,140656,13853,9
St. Martin,5/1/2009,23799,22249,1550,6.5,154747,140248,14499,9.4
St. Martin,6/1/2009,24252,22405,1847,7.6,154716,140009,14707,9.5
St. Martin,7/1/2009,24202,22408,1794,7.4,154502,139901,14601,9.5
St. Martin,8/1/2009,23841,22121,1720,7.2,154307,139492,14814,9.6
St. Martin,9/1/2009,23692,22035,1657,7,153827,138818,15009,9.8
St. Martin,10/1/2009,24244,22662,1582,6.5,153784,138432,15352,10
St. Martin,11/1/2009,24376,22839,1537,6.3,153878,138659,15219,9.9
St. Martin,12/1/2009,24178,22611,1567,6.5,153111,138013,15098,9.9
St. Martin,1/1/2010,23585,21739,1846,7.8,153484,138438,15046,9.8
St. Martin,2/1/2010,23617,21934,1683,7.1,153694,138581,15113,9.8
St. Martin,3/1/2010,23767,22072,1695,7.1,153954,138751,15202,9.9
St. Martin,4/1/2010,24112,22461,1651,6.8,154622,139297,15325,9.9
St. Martin,5/1/2010,24145,22408,1737,7.2,154091,139241,14849,9.6
St. Martin,6/1/2010,24442,22503,1939,7.9,153616,139141,14474,9.4
St. Martin,7/1/2010,24644,22726,1918,7.8,153691,139179,14512,9.4
St. Martin,8/1/2010,24327,22426,1901,7.8,154086,139438,14648,9.5
St. Martin,9/1/2010,24191,22358,1833,7.6,153975,139396,14579,9.5
St. Martin,10/1/2010,24280,22473,1807,7.4,153635,139119,14516,9.4
St. Martin,11/1/2010,24120,22364,1756,7.3,154125,139044,15081,9.8
St. Martin,12/1/2010,23871,22194,1677,7,153650,139301,14348,9.3
St. Martin,1/1/2011,23796,21911,1885,7.9,153263,139250,14013,9.1
St. Martin,2/1/2011,23810,22082,1728,7.3,153214,139394,13820,9
St. Martin,3/1/2011,23940,22248,1692,7.1,153376,139639,13737,9
St. Martin,4/1/2011,24073,22488,1585,6.6,153543,139586,13957,9.1
St. Martin,5/1/2011,24083,22426,1657,6.9,153479,139624,13855,9
St. Martin,6/1/2011,24366,22497,1869,7.7,153346,139384,13962,9.1
St. Martin,7/1/2011,24574,22801,1773,7.2,153288,139524,13763,9
St. Martin,8/1/2011,24395,22712,1683,6.9,153760,139942,13818,9
St. Martin,9/1/2011,24399,22723,1676,6.9,154131,140183,13948,9
St. Martin,10/1/2011,24481,22887,1594,6.5,153961,140368,13594,8.8
St. Martin,11/1/2011,24422,22935,1487,6.1,154128,140826,13302,8.6
St. Martin,12/1/2011,24212,22778,1434,5.9,153995,140902,13093,8.5
St. Martin,1/1/2012,23850,22251,1599,6.7,154381,141584,12797,8.3
St. Martin,2/1/2012,24067,22562,1505,6.3,154671,141858,12813,8.3
St. Martin,3/1/2012,24203,22733,1470,6.1,154749,142036,12713,8.2
St. Martin,4/1/2012,24458,23095,1363,5.6,154545,141899,12646,8.2
St. Martin,5/1/2012,24618,23139,1479,6,154866,142206,12660,8.2
St. Martin,6/1/2012,24952,23248,1704,6.8,155083,142391,12692,8.2
St. Martin,7/1/2012,24786,23174,1612,6.5,154948,142292,12656,8.2
St. Martin,8/1/2012,24285,22862,1423,5.9,154763,142291,12471,8.1
St. Martin,9/1/2012,24160,22878,1282,5.3,155160,143044,12115,7.8
St. Martin,10/1/2012,24454,23162,1292,5.3,155554,143431,12124,7.8
St. Martin,11/1/2012,24346,23151,1195,4.9,155338,143333,12005,7.7
St. Martin,12/1/2012,24301,22987,1314,5.4,155628,143330,12298,7.9
St. Martin,1/1/2013,24024,22443,1581,6.6,155763,143292,12471,8
St. Martin,2/1/2013,23941,22589,1352,5.6,155312,143362,11950,7.7
St. Martin,3/1/2013,24060,22729,1331,5.5,155005,143316,11689,7.5
St. Martin,4/1/2013,24330,23017,1313,5.4,155394,143635,11760,7.6
St. Martin,5/1/2013,24460,23032,1428,5.8,155536,143882,11654,7.5
St. Martin,6/1/2013,24857,23176,1681,6.8,155749,143999,11751,7.5
St. Martin,7/1/2013,24884,23325,1559,6.3,155599,144264,11335,7.3
St. Martin,8/1/2013,24492,23075,1417,5.8,155605,144326,11279,7.2
St. Martin,9/1/2013,24333,23018,1315,5.4,155687,144418,11270,7.2
St. Martin,10/1/2013,24220,22973,1247,5.1,154673,143537,11136,7.2
St. Martin,11/1/2013,24228,23061,1167,4.8,155265,144479,10787,6.9
St. Martin,12/1/2013,24013,22980,1033,4.3,155182,144778,10404,6.7
St. Martin,1/1/2014,23902,22670,1232,5.2,155352,145150,10202,6.6
St. Martin,2/1/2014,23940,22802,1138,4.8,155483,145134,10349,6.7
St. Martin,3/1/2014,24206,22980,1226,5.1,156028,145648,10380,6.7
St. Martin,4/1/2014,24372,23231,1141,4.7,155369,145667,9702,6.2
St. Martin,5/1/2014,24451,23113,1338,5.5,155684,145825,9859,6.3
St. Martin,6/1/2014,24697,23198,1499,6.1,155707,146247,9460,6.1
St. Martin,7/1/2014,25070,23454,1616,6.4,156007,146399,9608,6.2
St. Martin,8/1/2014,24884,23324,1560,6.3,156130,146530,9599,6.1
St. Martin,9/1/2014,24733,23251,1482,6,156040,146778,9262,5.9
St. Martin,10/1/2014,24886,23423,1463,5.9,156417,147427,8990,5.7
St. Martin,11/1/2014,24800,23310,1490,6,156494,147404,9090,5.8
St. Martin,12/1/2014,24586,23215,1371,5.6,156332,147615,8717,5.6
St. Martin,1/1/2015,24361,22751,1610,6.6,157030,148145,8885,5.7
St. Martin,2/1/2015,24140,22622,1518,6.3,156644,148045,8599,5.5
St. Martin,3/1/2015,24304,22734,1570,6.5,156643,148128,8515,5.4
St. Martin,4/1/2015,24172,22604,1568,6.5,157060,148511,8550,5.4
St. Martin,5/1/2015,24161,22449,1712,7.1,157651,148817,8834,5.6
St. Martin,6/1/2015,24214,22431,1783,7.4,157062,148816,8247,5.3
St. Martin,7/1/2015,24168,22423,1745,7.2,156997,148830,8167,5.2
St. Martin,8/1/2015,23849,22203,1646,6.9,157172,149181,7992,5.1
St. Martin,9/1/2015,23605,21963,1642,7,156733,148826,7907,5
St. Martin,10/1/2015,23683,22004,1679,7.1,157167,149246,7922,5
St. Martin,11/1/2015,23493,21921,1572,6.7,157463,149463,8000,5.1
St. Martin,12/1/2015,23323,21805,1518,6.5,158035,150128,7907,5
St. Martin,1/1/2016,23175,21418,1757,7.6,158280,150653,7627,4.8
St. Martin,2/1/2016,23181,21447,1734,7.5,158640,150939,7702,4.9
St. Martin,3/1/2016,23313,21546,1767,7.6,159179,151218,7961,5
St. Martin,4/1/2016,23146,21365,1781,7.7,159141,151074,8067,5.1
St. Martin,5/1/2016,23054,21250,1804,7.8,158784,151132,7652,4.8
St. Martin,6/1/2016,23264,21215,2049,8.8,158967,151223,7744,4.9
St. Martin,7/1/2016,23261,21297,1964,8.4,159194,151554,7641,4.8
St. Martin,8/1/2016,22831,20981,1850,8.1,159562,151779,7784,4.9
St. Martin,9/1/2016,22770,20925,1845,8.1,159714,151761,7953,5
St. Martin,10/1/2016,22582,20915,1667,7.4,159605,151793,7811,4.9
St. Martin,11/1/2016,22498,20968,1530,6.8,159506,151954,7553,4.7
St. Martin,12/1/2016,22383,20880,1503,6.7,159678,152157,7521,4.7
St. Martin,1/1/2017,22342,20696,1646,7.4,159620,152152,7468,4.7
St. Martin,2/1/2017,22450,20928,1522,6.8,159859,152480,7379,4.6
St. Martin,3/1/2017,22643,21189,1454,6.4,160137,153065,7073,4.4
St. Martin,4/1/2017,22594,21196,1398,6.2,160345,153255,7089,4.4
St. Martin,5/1/2017,22483,21099,1384,6.2,160068,153069,7000,4.4
St. Martin,6/1/2017,22757,21240,1517,6.7,160192,153318,6873,4.3
St. Martin,7/1/2017,22894,21437,1457,6.4,160462,153569,6892,4.3
St. Martin,8/1/2017,22622,21227,1395,6.2,160586,153503,7082,4.4
St. Martin,9/1/2017,22612,21317,1295,5.7,161140,154286,6854,4.3
St. Martin,10/1/2017,22309,21167,1142,5.1,160309,153609,6700,4.2
St. Martin,11/1/2017,22262,21155,1107,5,160579,153805,6774,4.2
St. Martin,12/1/2017,22150,21076,1074,4.8,160535,153904,6632,4.1
St. Martin,1/1/2018,21922,20754,1168,5.3,160914,154425,6489,4
St. Martin,2/1/2018,22129,20998,1131,5.1,161778,155197,6581,4.1
St. Martin,3/1/2018,22338,21219,1119,5,161686,155214,6472,4
St. Martin,4/1/2018,22352,21265,1087,4.9,161771,155312,6459,4
St. Martin,5/1/2018,22283,21144,1139,5.1,161848,155652,6196,3.8
St. Martin,6/1/2018,22572,21146,1426,6.3,162210,155762,6447,4
St. Martin,7/1/2018,22611,21274,1337,5.9,162341,156146,6195,3.8
St. Martin,8/1/2018,22136,20952,1184,5.3,161660,155504,6156,3.8
St. Martin,9/1/2018,22098,20977,1121,5.1,162087,156015,6073,3.7
St. Martin,10/1/2018,22321,21226,1095,4.9,162602,156391,6211,3.8
St. Martin,11/1/2018,22234,21196,1038,4.7,162836,156721,6115,3.8
St. Martin,12/1/2018,22142,21125,1017,4.6,163206,156817,6389,3.9
St. Martin,1/1/2019,21912,20717,1195,5.5,162963,156487,6475,4
St. Martin,2/1/2019,21997,20960,1037,4.7,162999,156863,6136,3.8
St. Martin,3/1/2019,22043,21077,966,4.4,162904,156701,6202,3.8
St. Martin,4/1/2019,22023,21122,901,4.1,162586,156625,5961,3.7
St. Martin,5/1/2019,22102,21086,1016,4.6,162751,156821,5930,3.6
St. Martin,6/1/2019,22379,21114,1265,5.7,163168,157232,5935,3.6
St. Martin,7/1/2019,22445,21189,1256,5.6,163590,157529,6061,3.7
St. Martin,8/1/2019,22205,21059,1146,5.2,163774,157829,5945,3.6
St. Martin,9/1/2019,22215,21141,1074,4.8,164092,158339,5753,3.5
St. Martin,10/1/2019,22377,21273,1104,4.9,164416,158545,5871,3.6
St. Martin,11/1/2019,22292,21212,1080,4.8,164496,158629,5868,3.6
St. Martin,12/1/2019,22091,21046,1045,4.7,164699,158845,5853,3.6
St. Martin,1/1/2020,21684,20577,1107,5.1,164377,158508,5869,3.6
St. Martin,2/1/2020,21635,20713,922,4.3,164467,158714,5753,3.5
St. Martin,3/1/2020,22059,20488,1571,7.1,162559,155353,7206,4.4
St. Martin,4/1/2020,20777,18274,2503,12,156269,133185,23084,14.8
St. Martin,5/1/2020,21259,18746,2513,11.8,158101,137173,20929,13.2
St. Martin,6/1/2020,21702,19284,2418,11.1,159994,142342,17652,11
St. Martin,7/1/2020,21921,19503,2418,11,160132,143779,16352,10.2
St. Martin,8/1/2020,21660,19686,1974,9.1,160706,147245,13461,8.4
St. Martin,9/1/2020,21763,19728,2035,9.4,160174,147620,12554,7.8
St. Martin,10/1/2020,21803,20076,1727,7.9,161003,149931,11072,6.9
St. Martin,11/1/2020,21652,20121,1531,7.1,160629,149934,10694,6.7
St. Martin,12/1/2020,21669,20089,1580,7.3,160745,149975,10770,6.7
St. Martin,1/1/2021,21506,19876,1630,7.6,160088,149852,10236,6.4
St. Martin,2/1/2021,21580,20042,1538,7.1,160184,150189,9995,6.2
St. Martin,3/1/2021,21649,20193,1456,6.7,160400,150644,9756,6.1
St. Martin,4/1/2021,21765,20352,1413,6.5,160843,151081,9762,6.1
St. Martin,5/1/2021,21667,20301,1366,6.3,160800,151535,9266,5.8
St. Martin,6/1/2021,22058,20498,1560,7.1,161197,151734,9462,5.9
St. Martin,7/1/2021,22080,20727,1353,6.1,161504,152773,8731,5.4
St. Martin,8/1/2021,21716,20546,1170,5.4,161527,153250,8276,5.1
St. Martin,9/1/2021,21927,20871,1056,4.8,161495,153843,7652,4.7
St. Martin,10/1/2021,21660,20736,924,4.3,161754,154475,7279,4.5
St. Martin,11/1/2021,21772,20939,833,3.8,162281,155530,6751,4.2
St. Martin,12/1/2021,21695,20954,741,3.4,162497,156099,6398,3.9
St. Martin,1/1/2022,21656,20741,915,4.2,163627,157115,6512,4
St. Martin,2/1/2022,21719,20890,829,3.8,163899,157598,6301,3.8
St. Martin,3/1/2022,21875,21092,783,3.6,164220,158206,6014,3.7
St. Martin,4/1/2022,21828,21113,715,3.3,163893,157891,6002,3.7
St. Martin,5/1/2022,21727,20957,770,3.5,164362,158378,5983,3.6
St. Martin,6/1/2022,22034,21055,979,4.4,164046,158094,5951,3.6
St. Martin,7/1/2022,22184,21289,895,4,164026,158258,5768,3.5
St. Martin,8/1/2022,21937,21082,855,3.9,164654,158735,5919,3.6
St. Martin,9/1/2022,21872,21078,794,3.6,164602,158810,5792,3.5
St. Martin,10/1/2022,21903,21177,726,3.3,164648,158684,5964,3.6
St. Martin,11/1/2022,21890,21202,688,3.1,164450,158507,5943,3.6
St. Martin,12/1/2022,21873,21185,688,3.1,165025,159259,5766,3.5
St. Martin,1/1/2023,21701,20890,811,3.7,165964,160217,5747,3.5
St. Martin,2/1/2023,21758,20991,767,3.5,166358,160395,5962,3.6
St. Martin,3/1/2023,21935,21214,721,3.3,166651,160812,5839,3.5
St. Martin,4/1/2023,21988,21320,668,3,166725,160974,5751,3.4
St. Martin,5/1/2023,21898,21126,772,3.5,166886,160796,6089,3.6
St. Martin,6/1/2023,22142,21260,882,4,166937,160979,5958,3.6
St. Martin,7/1/2023,22155,21435,720,3.2,167103,161183,5920,3.5
St. Martin,8/1/2023,21975,21193,782,3.6,167759,161475,6284,3.7
St. Martin,9/1/2023,22029,21150,879,4,167767,161442,6326,3.8
St. Martin,10/1/2023,22057,21193,864,3.9,167690,161211,6479,3.9
St. Martin,11/1/2023,22053,21255,798,3.6,168140,161886,6254,3.7
St. Martin,12/1/2023,21885,21051,834,3.8,167439,161124,6315,3.8
St. Martin,1/1/2024,21972,21015,957,4.4,167339,161190,6149,3.7
St. Martin,2/1/2024,21948,21010,938,4.3,167475,161013,6462,3.9
St. Martin,3/1/2024,22105,21209,896,4.1,167922,161425,6497,3.9
St. Martin,4/1/2024,22176,21374,802,3.6,167988,161495,6492,3.9
St. Martin,5/1/2024,21976,21111,865,3.9,167799,161164,6635,4
St. Martin,6/1/2024,22371,21281,1090,4.9,168005,161155,6849,4.1
St. Martin,7/1/2024,22516,21453,1063,4.7,168315,161219,7097,4.2
St. Martin,8/1/2024,22208,21174,1034,4.7,168496,161425,7071,4.2
St. Martin,9/1/2024,22120,21095,1025,4.6,168703,161802,6901,4.1
St. Martin,10/1/2024,22194,21184,1010,4.6,168428,161456,6972,4.1
St. Martin,11/1/2024,22145,21166,979,4.4,168304,161183,7121,4.2
St. Martin,12/1/2024,21975,21096,879,4,168547,161661,6886,4.1
St. Martin,1/1/2025,23081,22191,890,3.9,170744,163895,6849,4
St. Martin,2/1/2025,23200,22326,874,3.8,170359,163307,7052,4.1
St. Mary,1/1/1990,23807,21978,1829,7.7,125833,119081,6752,5.4
St. Mary,2/1/1990,23557,22001,1556,6.6,125710,119059,6651,5.3
St. Mary,3/1/1990,23700,22210,1490,6.3,125801,119203,6598,5.2
St. Mary,4/1/1990,23954,22452,1502,6.3,125649,118852,6797,5.4
St. Mary,5/1/1990,23817,22374,1443,6.1,125893,119151,6742,5.4
St. Mary,6/1/1990,24751,23089,1662,6.7,125573,118983,6590,5.2
St. Mary,7/1/1990,25253,23730,1523,6,125732,118810,6922,5.5
St. Mary,8/1/1990,25272,23646,1626,6.4,125990,118802,7188,5.7
St. Mary,9/1/1990,25118,23470,1648,6.6,125892,118524,7368,5.9
St. Mary,10/1/1990,24850,23330,1520,6.1,125995,118536,7459,5.9
St. Mary,11/1/1990,24747,23311,1436,5.8,126070,118306,7764,6.2
St. Mary,12/1/1990,24780,23282,1498,6,126142,118241,7901,6.3
St. Mary,1/1/1991,24718,22768,1950,7.9,125955,117940,8015,6.4
St. Mary,2/1/1991,25041,23206,1835,7.3,126020,117755,8265,6.6
St. Mary,3/1/1991,25167,23401,1766,7,126238,117652,8586,6.8
St. Mary,4/1/1991,25054,23355,1699,6.8,126548,118109,8439,6.7
St. Mary,5/1/1991,25575,23853,1722,6.7,126176,117440,8736,6.9
St. Mary,6/1/1991,26562,24393,2169,8.2,126331,117639,8692,6.9
St. Mary,7/1/1991,26065,24064,2001,7.7,126154,117568,8586,6.8
St. Mary,8/1/1991,25845,23704,2141,8.3,126150,117484,8666,6.9
St. Mary,9/1/1991,25371,23346,2025,8,126650,117928,8722,6.9
St. Mary,10/1/1991,25089,23100,1989,7.9,126642,117800,8842,7
St. Mary,11/1/1991,24847,22776,2071,8.3,126701,117770,8931,7
St. Mary,12/1/1991,24354,22219,2135,8.8,126664,117466,9198,7.3
St. Mary,1/1/1992,24638,21482,3156,12.8,127261,117978,9283,7.3
St. Mary,2/1/1992,24321,21448,2873,11.8,127207,117753,9454,7.4
St. Mary,3/1/1992,24544,21484,3060,12.5,127604,118144,9460,7.4
St. Mary,4/1/1992,24498,21510,2988,12.2,127841,118426,9415,7.4
St. Mary,5/1/1992,24451,21328,3123,12.8,128119,118375,9744,7.6
St. Mary,6/1/1992,25477,21737,3740,14.7,128459,118419,10040,7.8
St. Mary,7/1/1992,25512,22055,3457,13.6,128563,118713,9850,7.7
St. Mary,8/1/1992,25149,21760,3389,13.5,128613,118826,9787,7.6
St. Mary,9/1/1992,24936,21639,3297,13.2,128501,118720,9781,7.6
St. Mary,10/1/1992,24663,21911,2752,11.2,128026,118628,9398,7.3
St. Mary,11/1/1992,24349,21922,2427,10,128441,118876,9565,7.4
St. Mary,12/1/1992,23732,21426,2306,9.7,128554,118997,9557,7.4
St. Mary,1/1/1993,23073,20564,2509,10.9,128400,119075,9325,7.3
St. Mary,2/1/1993,23109,20880,2229,9.6,128458,119275,9183,7.1
St. Mary,3/1/1993,23245,21072,2173,9.3,128598,119542,9056,7
St. Mary,4/1/1993,23559,21406,2153,9.1,128584,119474,9110,7.1
St. Mary,5/1/1993,23691,21683,2008,8.5,129264,120115,9149,7.1
St. Mary,6/1/1993,24407,21968,2439,10,129411,120290,9121,7
St. Mary,7/1/1993,24619,22451,2168,8.8,129397,120467,8930,6.9
St. Mary,8/1/1993,24543,22424,2119,8.6,129619,120856,8763,6.8
St. Mary,9/1/1993,23714,21775,1939,8.2,129268,120554,8714,6.7
St. Mary,10/1/1993,23588,21599,1989,8.4,129573,120823,8750,6.8
St. Mary,11/1/1993,23628,21796,1832,7.8,129711,121169,8542,6.6
St. Mary,12/1/1993,23650,21857,1793,7.6,129941,121464,8477,6.5
St. Mary,1/1/1994,24005,21452,2553,10.6,130596,121966,8630,6.6
St. Mary,2/1/1994,23933,21581,2352,9.8,130669,122086,8583,6.6
St. Mary,3/1/1994,24118,21761,2357,9.8,130400,121930,8470,6.5
St. Mary,4/1/1994,23872,21692,2180,9.1,130621,122290,8331,6.4
St. Mary,5/1/1994,23653,21649,2004,8.5,130779,122864,7915,6.1
St. Mary,6/1/1994,24249,21786,2463,10.2,130561,122634,7927,6.1
St. Mary,7/1/1994,24434,22127,2307,9.4,130652,122706,7946,6.1
St. Mary,8/1/1994,24380,22173,2207,9.1,131275,123342,7933,6
St. Mary,9/1/1994,24217,22011,2206,9.1,131421,123687,7734,5.9
St. Mary,10/1/1994,24470,22400,2070,8.5,131744,124112,7632,5.8
St. Mary,11/1/1994,24477,22593,1884,7.7,131891,124516,7375,5.6
St. Mary,12/1/1994,24172,22346,1826,7.6,131951,124721,7230,5.5
St. Mary,1/1/1995,23715,21441,2274,9.6,132038,124663,7375,5.6
St. Mary,2/1/1995,23889,21837,2052,8.6,132115,124928,7187,5.4
St. Mary,3/1/1995,24082,21912,2170,9,132108,124955,7153,5.4
St. Mary,4/1/1995,24202,22113,2089,8.6,132590,124945,7645,5.8
St. Mary,5/1/1995,24170,22185,1985,8.2,131851,124421,7430,5.6
St. Mary,6/1/1995,24835,22454,2381,9.6,131949,124522,7427,5.6
St. Mary,7/1/1995,24838,22599,2239,9,132343,124816,7527,5.7
St. Mary,8/1/1995,24901,22668,2233,9,132336,124852,7484,5.7
St. Mary,9/1/1995,24433,22375,2058,8.4,132611,125133,7478,5.6
St. Mary,10/1/1995,23734,21828,1906,8,132716,125388,7328,5.5
St. Mary,11/1/1995,23428,21756,1672,7.1,132614,125188,7426,5.6
St. Mary,12/1/1995,23184,21647,1537,6.6,132511,125088,7423,5.6
St. Mary,1/1/1996,22621,20715,1906,8.4,132616,125125,7491,5.6
St. Mary,2/1/1996,22678,21150,1528,6.7,132952,125639,7313,5.5
St. Mary,3/1/1996,22805,21343,1462,6.4,133180,125862,7318,5.5
St. Mary,4/1/1996,23410,21976,1434,6.1,133409,125994,7415,5.6
St. Mary,5/1/1996,23866,22351,1515,6.3,133667,126244,7423,5.6
St. Mary,6/1/1996,24394,22570,1824,7.5,133697,126602,7095,5.3
St. Mary,7/1/1996,25185,23394,1791,7.1,134284,126947,7337,5.5
St. Mary,8/1/1996,25234,23267,1967,7.8,134054,127172,6882,5.1
St. Mary,9/1/1996,25033,23163,1870,7.5,134515,127536,6979,5.2
St. Mary,10/1/1996,24844,23144,1700,6.8,134921,127890,7031,5.2
St. Mary,11/1/1996,24487,22911,1576,6.4,135007,127771,7236,5.4
St. Mary,12/1/1996,24206,22714,1492,6.2,135113,127860,7253,5.4
St. Mary,1/1/1997,23731,21930,1801,7.6,135456,128298,7158,5.3
St. Mary,2/1/1997,24025,22524,1501,6.2,135400,128298,7102,5.2
St. Mary,3/1/1997,24078,22523,1555,6.5,135891,128891,7000,5.2
St. Mary,4/1/1997,24710,23248,1462,5.9,136016,129143,6873,5.1
St. Mary,5/1/1997,24892,23663,1229,4.9,136119,129464,6655,4.9
St. Mary,6/1/1997,25640,23957,1683,6.6,136211,129412,6799,5
St. Mary,7/1/1997,25917,24459,1458,5.6,136477,129822,6655,4.9
St. Mary,8/1/1997,27031,25544,1487,5.5,136618,130010,6608,4.8
St. Mary,9/1/1997,26293,24860,1433,5.5,136675,130019,6656,4.9
St. Mary,10/1/1997,26083,24790,1293,5,136633,130179,6454,4.7
St. Mary,11/1/1997,26212,24978,1234,4.7,136961,130653,6308,4.6
St. Mary,12/1/1997,26116,24946,1170,4.5,137155,130679,6476,4.7
St. Mary,1/1/1998,24583,23146,1437,5.8,137095,130726,6368,4.6
St. Mary,2/1/1998,24798,23555,1243,5,137112,130807,6306,4.6
St. Mary,3/1/1998,25351,23819,1532,6,137236,130814,6422,4.7
St. Mary,4/1/1998,25250,23853,1397,5.5,137150,131209,5941,4.3
St. Mary,5/1/1998,25282,23872,1410,5.6,137372,131325,6047,4.4
St. Mary,6/1/1998,26053,24333,1720,6.6,137455,131244,6212,4.5
St. Mary,7/1/1998,26515,24481,2034,7.7,137588,131329,6259,4.5
St. Mary,8/1/1998,26836,24470,2366,8.8,137570,131390,6179,4.5
St. Mary,9/1/1998,26377,23915,2462,9.3,138286,131986,6300,4.6
St. Mary,10/1/1998,25454,23203,2251,8.8,138279,131999,6280,4.5
St. Mary,11/1/1998,25252,23018,2234,8.8,138381,132280,6100,4.4
St. Mary,12/1/1998,25050,22798,2252,9,138634,132602,6032,4.4
St. Mary,1/1/1999,24893,22198,2695,10.8,139003,133027,5976,4.3
St. Mary,2/1/1999,24378,21762,2616,10.7,138967,132856,6111,4.4
St. Mary,3/1/1999,24295,21524,2771,11.4,138730,132947,5783,4.2
St. Mary,4/1/1999,23372,20717,2655,11.4,138959,132955,6004,4.3
St. Mary,5/1/1999,22982,20589,2393,10.4,139107,133311,5796,4.2
St. Mary,6/1/1999,23781,20918,2863,12,139329,133378,5951,4.3
St. Mary,7/1/1999,23989,21406,2583,10.8,139439,133414,6025,4.3
St. Mary,8/1/1999,23580,21118,2462,10.4,139430,133591,5838,4.2
St. Mary,9/1/1999,23025,20613,2412,10.5,139622,133707,5915,4.2
St. Mary,10/1/1999,23241,20917,2324,10,139771,133993,5778,4.1
St. Mary,11/1/1999,22799,20739,2060,9,140025,134309,5716,4.1
St. Mary,12/1/1999,22530,20612,1918,8.5,140177,134523,5653,4
St. Mary,1/1/2000,22906,21054,1852,8.1,142267,136559,5708,4
St. Mary,2/1/2000,22862,21044,1818,8,142456,136598,5858,4.1
St. Mary,3/1/2000,22893,21072,1821,8,142434,136701,5733,4
St. Mary,4/1/2000,22419,20956,1463,6.5,142751,137270,5481,3.8
St. Mary,5/1/2000,22341,20766,1575,7,142388,136630,5758,4
St. Mary,6/1/2000,22746,21028,1718,7.6,142591,136940,5651,4
St. Mary,7/1/2000,22238,20671,1567,7,142278,136531,5747,4
St. Mary,8/1/2000,22300,20681,1619,7.3,142514,136662,5853,4.1
St. Mary,9/1/2000,21917,20392,1525,7,142518,136893,5625,3.9
St. Mary,10/1/2000,22022,20608,1414,6.4,142622,137088,5534,3.9
St. Mary,11/1/2000,22013,20533,1480,6.7,142962,137322,5639,3.9
St. Mary,12/1/2000,22006,20601,1405,6.4,143248,137614,5634,3.9
St. Mary,1/1/2001,21989,20224,1765,8,143800,137778,6023,4.2
St. Mary,2/1/2001,22050,20597,1453,6.6,143701,137612,6089,4.2
St. Mary,3/1/2001,22212,20647,1565,7,143924,137783,6141,4.3
St. Mary,4/1/2001,22615,21186,1429,6.3,143569,137299,6271,4.4
St. Mary,5/1/2001,22495,21129,1366,6.1,143318,137092,6226,4.3
St. Mary,6/1/2001,22900,21293,1607,7,143357,136873,6484,4.5
St. Mary,7/1/2001,23041,21581,1460,6.3,143654,137071,6583,4.6
St. Mary,8/1/2001,22944,21426,1518,6.6,143284,136241,7042,4.9
St. Mary,9/1/2001,22747,21147,1600,7,143989,136846,7142,5
St. Mary,10/1/2001,23060,21410,1650,7.2,144086,136392,7694,5.3
St. Mary,11/1/2001,22826,21148,1678,7.4,144240,136238,8003,5.5
St. Mary,12/1/2001,22702,21046,1656,7.3,144305,136047,8258,5.7
St. Mary,1/1/2002,22121,20224,1897,8.6,143883,135701,8182,5.7
St. Mary,2/1/2002,21996,20378,1618,7.4,144653,136438,8215,5.7
St. Mary,3/1/2002,22025,20301,1724,7.8,144481,136177,8304,5.7
St. Mary,4/1/2002,22306,20693,1613,7.2,144725,136126,8599,5.9
St. Mary,5/1/2002,22017,20430,1587,7.2,144938,136539,8399,5.8
St. Mary,6/1/2002,22319,20506,1813,8.1,144808,136415,8393,5.8
St. Mary,7/1/2002,22395,20733,1662,7.4,144803,136413,8390,5.8
St. Mary,8/1/2002,22224,20590,1634,7.4,145009,136705,8304,5.7
St. Mary,9/1/2002,22034,20439,1595,7.2,145552,137302,8251,5.7
St. Mary,10/1/2002,22182,20636,1546,7,145314,137008,8307,5.7
St. Mary,11/1/2002,21995,20468,1527,6.9,145041,136521,8520,5.9
St. Mary,12/1/2002,21967,20450,1517,6.9,145066,136426,8640,6
St. Mary,1/1/2003,22180,20416,1764,8,145937,137417,8520,5.8
St. Mary,2/1/2003,22078,20465,1613,7.3,146100,137482,8618,5.9
St. Mary,3/1/2003,22299,20618,1681,7.5,146022,137434,8588,5.9
St. Mary,4/1/2003,22501,20895,1606,7.1,146474,137633,8842,6
St. Mary,5/1/2003,22459,20808,1651,7.4,146500,137544,8957,6.1
St. Mary,6/1/2003,22919,20965,1954,8.5,147056,137790,9266,6.3
St. Mary,7/1/2003,22559,20781,1778,7.9,146485,137474,9011,6.2
St. Mary,8/1/2003,22396,20724,1672,7.5,146445,137549,8896,6.1
St. Mary,9/1/2003,22031,20485,1546,7,146530,137609,8921,6.1
St. Mary,10/1/2003,22068,20638,1430,6.5,146716,137984,8732,6
St. Mary,11/1/2003,22050,20664,1386,6.3,147000,138424,8576,5.8
St. Mary,12/1/2003,21885,20511,1374,6.3,146729,138411,8317,5.7
St. Mary,1/1/2004,22267,20373,1894,8.5,146842,138472,8370,5.7
St. Mary,2/1/2004,21837,20254,1583,7.2,146709,138542,8167,5.6
St. Mary,3/1/2004,22030,20240,1790,8.1,146944,138453,8491,5.8
St. Mary,4/1/2004,21833,20077,1756,8,146850,138680,8170,5.6
St. Mary,5/1/2004,21633,19855,1778,8.2,147065,138852,8212,5.6
St. Mary,6/1/2004,22103,20042,2061,9.3,147460,139174,8286,5.6
St. Mary,7/1/2004,21852,19941,1911,8.7,147692,139556,8136,5.5
St. Mary,8/1/2004,21529,19682,1847,8.6,147564,139573,7990,5.4
St. Mary,9/1/2004,21438,19476,1962,9.2,147415,139487,7927,5.4
St. Mary,10/1/2004,21656,19803,1853,8.6,147793,139732,8061,5.5
St. Mary,11/1/2004,21573,19847,1726,8,148162,140231,7932,5.4
St. Mary,12/1/2004,21405,19754,1651,7.7,148059,140125,7934,5.4
St. Mary,1/1/2005,21634,19651,1983,9.2,148029,140245,7784,5.3
St. Mary,2/1/2005,21438,19655,1783,8.3,148364,140385,7980,5.4
St. Mary,3/1/2005,21385,19655,1730,8.1,148391,140654,7737,5.2
St. Mary,4/1/2005,21315,19715,1600,7.5,148926,141254,7672,5.2
St. Mary,5/1/2005,21391,19818,1573,7.4,149261,141609,7651,5.1
St. Mary,6/1/2005,21856,20077,1779,8.1,149238,141714,7524,5
St. Mary,7/1/2005,22028,20410,1618,7.3,149432,142026,7406,5
St. Mary,8/1/2005,21784,20264,1520,7,149779,142434,7345,4.9
St. Mary,9/1/2005,24674,21575,3099,12.6,149954,142401,7553,5
St. Mary,10/1/2005,24956,22185,2771,11.1,150001,142548,7453,5
St. Mary,11/1/2005,24950,22345,2605,10.4,150065,142499,7566,5
St. Mary,12/1/2005,23720,22140,1580,6.7,150030,142752,7279,4.9
St. Mary,1/1/2006,22901,21617,1284,5.6,150214,143150,7064,4.7
St. Mary,2/1/2006,22860,21835,1025,4.5,150641,143457,7184,4.8
St. Mary,3/1/2006,22991,21955,1036,4.5,150813,143741,7072,4.7
St. Mary,4/1/2006,23135,22164,971,4.2,150881,143761,7120,4.7
St. Mary,5/1/2006,23275,22264,1011,4.3,151069,144089,6980,4.6
St. Mary,6/1/2006,23857,22656,1201,5,151354,144353,7001,4.6
St. Mary,7/1/2006,24046,23026,1020,4.2,151377,144202,7175,4.7
St. Mary,8/1/2006,23760,22772,988,4.2,151716,144625,7091,4.7
St. Mary,9/1/2006,23563,22620,943,4,151662,144815,6847,4.5
St. Mary,10/1/2006,23728,22808,920,3.9,152041,145314,6727,4.4
St. Mary,11/1/2006,23544,22599,945,4,152406,145534,6872,4.5
St. Mary,12/1/2006,23400,22537,863,3.7,152732,145970,6762,4.4
St. Mary,1/1/2007,23009,21985,1024,4.5,153144,146028,7116,4.6
St. Mary,2/1/2007,22925,22014,911,4,152983,146057,6927,4.5
St. Mary,3/1/2007,23020,22097,923,4,153051,146320,6731,4.4
St. Mary,4/1/2007,23140,22220,920,4,152435,145586,6850,4.5
St. Mary,5/1/2007,23389,22404,985,4.2,152670,145903,6766,4.4
St. Mary,6/1/2007,23830,22663,1167,4.9,153041,146063,6979,4.6
St. Mary,7/1/2007,23837,22754,1083,4.5,153054,145905,7149,4.7
St. Mary,8/1/2007,23691,22709,982,4.1,152749,145682,7067,4.6
St. Mary,9/1/2007,23625,22651,974,4.1,153414,146244,7170,4.7
St. Mary,10/1/2007,23653,22806,847,3.6,153183,145946,7237,4.7
St. Mary,11/1/2007,23677,22832,845,3.6,153835,146595,7240,4.7
St. Mary,12/1/2007,23476,22590,886,3.8,153918,146273,7645,5
St. Mary,1/1/2008,23212,22184,1028,4.4,154063,146378,7685,5
St. Mary,2/1/2008,23133,22289,844,3.6,153653,146156,7497,4.9
St. Mary,3/1/2008,23461,22528,933,4,153908,146086,7822,5.1
St. Mary,4/1/2008,23410,22573,837,3.6,153769,146132,7637,5
St. Mary,5/1/2008,23432,22471,961,4.1,154303,145908,8395,5.4
St. Mary,6/1/2008,24018,22784,1234,5.1,154313,145737,8575,5.6
St. Mary,7/1/2008,24090,22920,1170,4.9,154469,145532,8937,5.8
St. Mary,8/1/2008,23829,22692,1137,4.8,154641,145203,9438,6.1
St. Mary,9/1/2008,23807,22349,1458,6.1,154570,145076,9494,6.1
St. Mary,10/1/2008,24043,22827,1216,5.1,154876,144802,10074,6.5
St. Mary,11/1/2008,23853,22707,1146,4.8,154639,144100,10538,6.8
St. Mary,12/1/2008,23511,22336,1175,5,154655,143369,11286,7.3
St. Mary,1/1/2009,23358,22007,1351,5.8,154210,142152,12058,7.8
St. Mary,2/1/2009,23151,21756,1395,6,154538,141640,12898,8.3
St. Mary,3/1/2009,23270,21806,1464,6.3,154133,140707,13426,8.7
St. Mary,4/1/2009,23123,21639,1484,6.4,154509,140656,13853,9
St. Mary,5/1/2009,23099,21460,1639,7.1,154747,140248,14499,9.4
St. Mary,6/1/2009,23771,21818,1953,8.2,154716,140009,14707,9.5
St. Mary,7/1/2009,23622,21670,1952,8.3,154502,139901,14601,9.5
St. Mary,8/1/2009,23259,21376,1883,8.1,154307,139492,14814,9.6
St. Mary,9/1/2009,22955,21118,1837,8,153827,138818,15009,9.8
St. Mary,10/1/2009,23118,21252,1866,8.1,153784,138432,15352,10
St. Mary,11/1/2009,23117,21251,1866,8.1,153878,138659,15219,9.9
St. Mary,12/1/2009,23031,21087,1944,8.4,153111,138013,15098,9.9
St. Mary,1/1/2010,25061,22813,2248,9,153484,138438,15046,9.8
St. Mary,2/1/2010,25069,22955,2114,8.4,153694,138581,15113,9.8
St. Mary,3/1/2010,25221,23034,2187,8.7,153954,138751,15202,9.9
St. Mary,4/1/2010,25079,22991,2088,8.3,154622,139297,15325,9.9
St. Mary,5/1/2010,24971,22815,2156,8.6,154091,139241,14849,9.6
St. Mary,6/1/2010,25511,23137,2374,9.3,153616,139141,14474,9.4
St. Mary,7/1/2010,25524,23194,2330,9.1,153691,139179,14512,9.4
St. Mary,8/1/2010,25268,22995,2273,9,154086,139438,14648,9.5
St. Mary,9/1/2010,25246,22988,2258,8.9,153975,139396,14579,9.5
St. Mary,10/1/2010,25242,23037,2205,8.7,153635,139119,14516,9.4
St. Mary,11/1/2010,25165,22999,2166,8.6,154125,139044,15081,9.8
St. Mary,12/1/2010,25085,22909,2176,8.7,153650,139301,14348,9.3
St. Mary,1/1/2011,24884,22454,2430,9.8,153263,139250,14013,9.1
St. Mary,2/1/2011,24741,22487,2254,9.1,153214,139394,13820,9
St. Mary,3/1/2011,24940,22743,2197,8.8,153376,139639,13737,9
St. Mary,4/1/2011,25006,22955,2051,8.2,153543,139586,13957,9.1
St. Mary,5/1/2011,25006,22924,2082,8.3,153479,139624,13855,9
St. Mary,6/1/2011,25395,23071,2324,9.2,153346,139384,13962,9.1
St. Mary,7/1/2011,25799,23605,2194,8.5,153288,139524,13763,9
St. Mary,8/1/2011,25547,23471,2076,8.1,153760,139942,13818,9
St. Mary,9/1/2011,25394,23364,2030,8,154131,140183,13948,9
St. Mary,10/1/2011,25554,23598,1956,7.7,153961,140368,13594,8.8
St. Mary,11/1/2011,25430,23566,1864,7.3,154128,140826,13302,8.6
St. Mary,12/1/2011,25253,23389,1864,7.4,153995,140902,13093,8.5
St. Mary,1/1/2012,24964,22925,2039,8.2,154381,141584,12797,8.3
St. Mary,2/1/2012,24935,22985,1950,7.8,154671,141858,12813,8.3
St. Mary,3/1/2012,25186,23271,1915,7.6,154749,142036,12713,8.2
St. Mary,4/1/2012,25383,23612,1771,7,154545,141899,12646,8.2
St. Mary,5/1/2012,25489,23650,1839,7.2,154866,142206,12660,8.2
St. Mary,6/1/2012,26075,23988,2087,8,155083,142391,12692,8.2
St. Mary,7/1/2012,26263,24254,2009,7.6,154948,142292,12656,8.2
St. Mary,8/1/2012,25874,24056,1818,7,154763,142291,12471,8.1
St. Mary,9/1/2012,25665,23986,1679,6.5,155160,143044,12115,7.8
St. Mary,10/1/2012,25705,24091,1614,6.3,155554,143431,12124,7.8
St. Mary,11/1/2012,25599,24119,1480,5.8,155338,143333,12005,7.7
St. Mary,12/1/2012,25487,23919,1568,6.2,155628,143330,12298,7.9
St. Mary,1/1/2013,24831,22998,1833,7.4,155763,143292,12471,8
St. Mary,2/1/2013,24635,22990,1645,6.7,155312,143362,11950,7.7
St. Mary,3/1/2013,24851,23251,1600,6.4,155005,143316,11689,7.5
St. Mary,4/1/2013,24915,23365,1550,6.2,155394,143635,11760,7.6
St. Mary,5/1/2013,24966,23329,1637,6.6,155536,143882,11654,7.5
St. Mary,6/1/2013,25527,23714,1813,7.1,155749,143999,11751,7.5
St. Mary,7/1/2013,25319,23603,1716,6.8,155599,144264,11335,7.3
St. Mary,8/1/2013,24978,23391,1587,6.4,155605,144326,11279,7.2
St. Mary,9/1/2013,24900,23391,1509,6.1,155687,144418,11270,7.2
St. Mary,10/1/2013,24657,23234,1423,5.8,154673,143537,11136,7.2
St. Mary,11/1/2013,25271,23959,1312,5.2,155265,144479,10787,6.9
St. Mary,12/1/2013,25052,23862,1190,4.8,155182,144778,10404,6.7
St. Mary,1/1/2014,24791,23432,1359,5.5,155352,145150,10202,6.6
St. Mary,2/1/2014,24575,23263,1312,5.3,155483,145134,10349,6.7
St. Mary,3/1/2014,24890,23532,1358,5.5,156028,145648,10380,6.7
St. Mary,4/1/2014,24666,23401,1265,5.1,155369,145667,9702,6.2
St. Mary,5/1/2014,24944,23474,1470,5.9,155684,145825,9859,6.3
St. Mary,6/1/2014,25475,23810,1665,6.5,155707,146247,9460,6.1
St. Mary,7/1/2014,25865,24097,1768,6.8,156007,146399,9608,6.2
St. Mary,8/1/2014,25644,23910,1734,6.8,156130,146530,9599,6.1
St. Mary,9/1/2014,25636,23956,1680,6.6,156040,146778,9262,5.9
St. Mary,10/1/2014,25399,23750,1649,6.5,156417,147427,8990,5.7
St. Mary,11/1/2014,25383,23686,1697,6.7,156494,147404,9090,5.8
St. Mary,12/1/2014,25110,23486,1624,6.5,156332,147615,8717,5.6
St. Mary,1/1/2015,24736,22926,1810,7.3,157030,148145,8885,5.7
St. Mary,2/1/2015,24614,22862,1752,7.1,156644,148045,8599,5.5
St. Mary,3/1/2015,24716,22933,1783,7.2,156643,148128,8515,5.4
St. Mary,4/1/2015,24598,22869,1729,7,157060,148511,8550,5.4
St. Mary,5/1/2015,24483,22620,1863,7.6,157651,148817,8834,5.6
St. Mary,6/1/2015,24738,22751,1987,8,157062,148816,8247,5.3
St. Mary,7/1/2015,24502,22561,1941,7.9,156997,148830,8167,5.2
St. Mary,8/1/2015,23850,22038,1812,7.6,157172,149181,7992,5.1
St. Mary,9/1/2015,23702,21928,1774,7.5,156733,148826,7907,5
St. Mary,10/1/2015,23433,21620,1813,7.7,157167,149246,7922,5
St. Mary,11/1/2015,23232,21434,1798,7.7,157463,149463,8000,5.1
St. Mary,12/1/2015,23084,21306,1778,7.7,158035,150128,7907,5
St. Mary,1/1/2016,22758,20808,1950,8.6,158280,150653,7627,4.8
St. Mary,2/1/2016,22599,20576,2023,9,158640,150939,7702,4.9
St. Mary,3/1/2016,22539,20447,2092,9.3,159179,151218,7961,5
St. Mary,4/1/2016,22341,20269,2072,9.3,159141,151074,8067,5.1
St. Mary,5/1/2016,22044,20009,2035,9.2,158784,151132,7652,4.8
St. Mary,6/1/2016,22451,20136,2315,10.3,158967,151223,7744,4.9
St. Mary,7/1/2016,22284,20077,2207,9.9,159194,151554,7641,4.8
St. Mary,8/1/2016,21647,19519,2128,9.8,159562,151779,7784,4.9
St. Mary,9/1/2016,21556,19430,2126,9.9,159714,151761,7953,5
St. Mary,10/1/2016,21268,19292,1976,9.3,159605,151793,7811,4.9
St. Mary,11/1/2016,20871,19065,1806,8.7,159506,151954,7553,4.7
St. Mary,12/1/2016,20805,18949,1856,8.9,159678,152157,7521,4.7
St. Mary,1/1/2017,20570,18623,1947,9.5,159620,152152,7468,4.7
St. Mary,2/1/2017,20459,18575,1884,9.2,159859,152480,7379,4.6
St. Mary,3/1/2017,20444,18685,1759,8.6,160137,153065,7073,4.4
St. Mary,4/1/2017,20547,18856,1691,8.2,160345,153255,7089,4.4
St. Mary,5/1/2017,20372,18712,1660,8.1,160068,153069,7000,4.4
St. Mary,6/1/2017,20665,18911,1754,8.5,160192,153318,6873,4.3
St. Mary,7/1/2017,20513,18860,1653,8.1,160462,153569,6892,4.3
St. Mary,8/1/2017,20230,18637,1593,7.9,160586,153503,7082,4.4
St. Mary,9/1/2017,20197,18726,1471,7.3,161140,154286,6854,4.3
St. Mary,10/1/2017,20087,18755,1332,6.6,160309,153609,6700,4.2
St. Mary,11/1/2017,19963,18722,1241,6.2,160579,153805,6774,4.2
St. Mary,12/1/2017,20048,18840,1208,6,160535,153904,6632,4.1
St. Mary,1/1/2018,20126,18798,1328,6.6,160914,154425,6489,4
St. Mary,2/1/2018,20074,18735,1339,6.7,161778,155197,6581,4.1
St. Mary,3/1/2018,20148,18807,1341,6.7,161686,155214,6472,4
St. Mary,4/1/2018,20062,18765,1297,6.5,161771,155312,6459,4
St. Mary,5/1/2018,19958,18655,1303,6.5,161848,155652,6196,3.8
St. Mary,6/1/2018,20418,18870,1548,7.6,162210,155762,6447,4
St. Mary,7/1/2018,20289,18830,1459,7.2,162341,156146,6195,3.8
St. Mary,8/1/2018,19870,18559,1311,6.6,161660,155504,6156,3.8
St. Mary,9/1/2018,19983,18764,1219,6.1,162087,156015,6073,3.7
St. Mary,10/1/2018,19952,18769,1183,5.9,162602,156391,6211,3.8
St. Mary,11/1/2018,19827,18711,1116,5.6,162836,156721,6115,3.8
St. Mary,12/1/2018,19878,18767,1111,5.6,163206,156817,6389,3.9
St. Mary,1/1/2019,19693,18481,1212,6.2,162963,156487,6475,4
St. Mary,2/1/2019,19503,18411,1092,5.6,162999,156863,6136,3.8
St. Mary,3/1/2019,19600,18556,1044,5.3,162904,156701,6202,3.8
St. Mary,4/1/2019,19470,18534,936,4.8,162586,156625,5961,3.7
St. Mary,5/1/2019,19561,18519,1042,5.3,162751,156821,5930,3.6
St. Mary,6/1/2019,20043,18807,1236,6.2,163168,157232,5935,3.6
St. Mary,7/1/2019,19984,18737,1247,6.2,163590,157529,6061,3.7
St. Mary,8/1/2019,19844,18653,1191,6,163774,157829,5945,3.6
St. Mary,9/1/2019,19909,18803,1106,5.6,164092,158339,5753,3.5
St. Mary,10/1/2019,19921,18762,1159,5.8,164416,158545,5871,3.6
St. Mary,11/1/2019,19858,18735,1123,5.7,164496,158629,5868,3.6
St. Mary,12/1/2019,19611,18564,1047,5.3,164699,158845,5853,3.6
St. Mary,1/1/2020,19106,18020,1086,5.7,164377,158508,5869,3.6
St. Mary,2/1/2020,19086,18174,912,4.8,164467,158714,5753,3.5
St. Mary,3/1/2020,19612,18011,1601,8.2,162559,155353,7206,4.4
St. Mary,4/1/2020,18695,16325,2370,12.7,156269,133185,23084,14.8
St. Mary,5/1/2020,19277,16737,2540,13.2,158101,137173,20929,13.2
St. Mary,6/1/2020,19534,17102,2432,12.5,159994,142342,17652,11
St. Mary,7/1/2020,19354,17012,2342,12.1,160132,143779,16352,10.2
St. Mary,8/1/2020,19236,17257,1979,10.3,160706,147245,13461,8.4
St. Mary,9/1/2020,19333,17302,2031,10.5,160174,147620,12554,7.8
St. Mary,10/1/2020,19457,17641,1816,9.3,161003,149931,11072,6.9
St. Mary,11/1/2020,19178,17602,1576,8.2,160629,149934,10694,6.7
St. Mary,12/1/2020,19153,17565,1588,8.3,160745,149975,10770,6.7
St. Mary,1/1/2021,18822,17202,1620,8.6,160088,149852,10236,6.4
St. Mary,2/1/2021,18687,17128,1559,8.3,160184,150189,9995,6.2
St. Mary,3/1/2021,18819,17338,1481,7.9,160400,150644,9756,6.1
St. Mary,4/1/2021,19009,17521,1488,7.8,160843,151081,9762,6.1
St. Mary,5/1/2021,18925,17496,1429,7.6,160800,151535,9266,5.8
St. Mary,6/1/2021,19351,17728,1623,8.4,161197,151734,9462,5.9
St. Mary,7/1/2021,19335,17903,1432,7.4,161504,152773,8731,5.4
St. Mary,8/1/2021,19045,17759,1286,6.8,161527,153250,8276,5.1
St. Mary,9/1/2021,19389,18254,1135,5.9,161495,153843,7652,4.7
St. Mary,10/1/2021,18997,18036,961,5.1,161754,154475,7279,4.5
St. Mary,11/1/2021,18983,18117,866,4.6,162281,155530,6751,4.2
St. Mary,12/1/2021,18793,18035,758,4,162497,156099,6398,3.9
St. Mary,1/1/2022,18750,17811,939,5,163627,157115,6512,4
St. Mary,2/1/2022,18817,17967,850,4.5,163899,157598,6301,3.8
St. Mary,3/1/2022,18993,18195,798,4.2,164220,158206,6014,3.7
St. Mary,4/1/2022,18806,18059,747,4,163893,157891,6002,3.7
St. Mary,5/1/2022,18815,18028,787,4.2,164362,158378,5983,3.6
St. Mary,6/1/2022,19249,18256,993,5.2,164046,158094,5951,3.6
St. Mary,7/1/2022,19188,18266,922,4.8,164026,158258,5768,3.5
St. Mary,8/1/2022,18989,18112,877,4.6,164654,158735,5919,3.6
St. Mary,9/1/2022,19010,18236,774,4.1,164602,158810,5792,3.5
St. Mary,10/1/2022,19139,18424,715,3.7,164648,158684,5964,3.6
St. Mary,11/1/2022,19185,18498,687,3.6,164450,158507,5943,3.6
St. Mary,12/1/2022,19424,18749,675,3.5,165025,159259,5766,3.5
St. Mary,1/1/2023,19262,18469,793,4.1,165964,160217,5747,3.5
St. Mary,2/1/2023,19162,18385,777,4.1,166358,160395,5962,3.6
St. Mary,3/1/2023,19283,18545,738,3.8,166651,160812,5839,3.5
St. Mary,4/1/2023,18879,18193,686,3.6,166725,160974,5751,3.4
St. Mary,5/1/2023,18803,18009,794,4.2,166886,160796,6089,3.6
St. Mary,6/1/2023,19088,18167,921,4.8,166937,160979,5958,3.6
St. Mary,7/1/2023,19067,18254,813,4.3,167103,161183,5920,3.5
St. Mary,8/1/2023,18866,17997,869,4.6,167759,161475,6284,3.7
St. Mary,9/1/2023,18974,18129,845,4.5,167767,161442,6326,3.8
St. Mary,10/1/2023,18987,18147,840,4.4,167690,161211,6479,3.9
St. Mary,11/1/2023,19022,18217,805,4.2,168140,161886,6254,3.7
St. Mary,12/1/2023,18866,18069,797,4.2,167439,161124,6315,3.8
St. Mary,1/1/2024,18683,17771,912,4.9,167339,161190,6149,3.7
St. Mary,2/1/2024,18637,17727,910,4.9,167475,161013,6462,3.9
St. Mary,3/1/2024,18799,17905,894,4.8,167922,161425,6497,3.9
St. Mary,4/1/2024,18683,17859,824,4.4,167988,161495,6492,3.9
St. Mary,5/1/2024,18608,17743,865,4.6,167799,161164,6635,4
St. Mary,6/1/2024,18928,17840,1088,5.7,168005,161155,6849,4.1
St. Mary,7/1/2024,18993,17880,1113,5.9,168315,161219,7097,4.2
St. Mary,8/1/2024,18751,17670,1081,5.8,168496,161425,7071,4.2
St. Mary,9/1/2024,18393,17362,1031,5.6,168703,161802,6901,4.1
St. Mary,10/1/2024,18320,17265,1055,5.8,168428,161456,6972,4.1
St. Mary,11/1/2024,18166,17157,1009,5.6,168304,161183,7121,4.2
St. Mary,12/1/2024,18045,17095,950,5.3,168547,161661,6886,4.1
St. Mary,1/1/2025,18063,17098,965,5.3,170744,163895,6849,4
St. Mary,2/1/2025,17957,17032,925,5.2,170359,163307,7052,4.1
St. Tammany,1/1/1990,66023,62293,3730,5.6,125833,119081,6752,5.4
St. Tammany,2/1/1990,66316,62815,3501,5.3,125710,119059,6651,5.3
St. Tammany,3/1/1990,66664,63339,3325,5,125801,119203,6598,5.2
St. Tammany,4/1/1990,67194,63782,3412,5.1,125649,118852,6797,5.4
St. Tammany,5/1/1990,67662,64277,3385,5,125893,119151,6742,5.4
St. Tammany,6/1/1990,69348,64976,4372,6.3,125573,118983,6590,5.2
St. Tammany,7/1/1990,68844,64542,4302,6.2,125732,118810,6922,5.5
St. Tammany,8/1/1990,67711,63475,4236,6.3,125990,118802,7188,5.7
St. Tammany,9/1/1990,67383,62984,4399,6.5,125892,118524,7368,5.9
St. Tammany,10/1/1990,68381,64012,4369,6.4,125995,118536,7459,5.9
St. Tammany,11/1/1990,68697,63824,4873,7.1,126070,118306,7764,6.2
St. Tammany,12/1/1990,68279,63556,4723,6.9,126142,118241,7901,6.3
St. Tammany,1/1/1991,70240,65152,5088,7.2,125955,117940,8015,6.4
St. Tammany,2/1/1991,70564,65554,5010,7.1,126020,117755,8265,6.6
St. Tammany,3/1/1991,70403,65842,4561,6.5,126238,117652,8586,6.8
St. Tammany,4/1/1991,71294,66821,4473,6.3,126548,118109,8439,6.7
St. Tammany,5/1/1991,71427,66643,4784,6.7,126176,117440,8736,6.9
St. Tammany,6/1/1991,73393,67689,5704,7.8,126331,117639,8692,6.9
St. Tammany,7/1/1991,72652,67298,5354,7.4,126154,117568,8586,6.8
St. Tammany,8/1/1991,70738,65993,4745,6.7,126150,117484,8666,6.9
St. Tammany,9/1/1991,70721,66035,4686,6.6,126650,117928,8722,6.9
St. Tammany,10/1/1991,71843,66991,4852,6.8,126642,117800,8842,7
St. Tammany,11/1/1991,71912,66957,4955,6.9,126701,117770,8931,7
St. Tammany,12/1/1991,71641,66499,5142,7.2,126664,117466,9198,7.3
St. Tammany,1/1/1992,74088,68313,5775,7.8,127261,117978,9283,7.3
St. Tammany,2/1/1992,74364,68613,5751,7.7,127207,117753,9454,7.4
St. Tammany,3/1/1992,74723,69071,5652,7.6,127604,118144,9460,7.4
St. Tammany,4/1/1992,75191,69796,5395,7.2,127841,118426,9415,7.4
St. Tammany,5/1/1992,75665,69887,5778,7.6,128119,118375,9744,7.6
St. Tammany,6/1/1992,77870,70762,7108,9.1,128459,118419,10040,7.8
St. Tammany,7/1/1992,72296,65409,6887,9.5,128563,118713,9850,7.7
St. Tammany,8/1/1992,70193,64043,6150,8.8,128613,118826,9787,7.6
St. Tammany,9/1/1992,69704,63634,6070,8.7,128501,118720,9781,7.6
St. Tammany,10/1/1992,70649,64437,6212,8.8,128026,118628,9398,7.3
St. Tammany,11/1/1992,71009,64565,6444,9.1,128441,118876,9565,7.4
St. Tammany,12/1/1992,72748,66449,6299,8.7,128554,118997,9557,7.4
St. Tammany,1/1/1993,74970,68149,6821,9.1,128400,119075,9325,7.3
St. Tammany,2/1/1993,75267,68857,6410,8.5,128458,119275,9183,7.1
St. Tammany,3/1/1993,75611,69229,6382,8.4,128598,119542,9056,7
St. Tammany,4/1/1993,75726,69784,5942,7.8,128584,119474,9110,7.1
St. Tammany,5/1/1993,76387,70422,5965,7.8,129264,120115,9149,7.1
St. Tammany,6/1/1993,78202,71095,7107,9.1,129411,120290,9121,7
St. Tammany,7/1/1993,76965,70256,6709,8.7,129397,120467,8930,6.9
St. Tammany,8/1/1993,75080,69115,5965,7.9,129619,120856,8763,6.8
St. Tammany,9/1/1993,74672,68852,5820,7.8,129268,120554,8714,6.7
St. Tammany,10/1/1993,76289,70084,6205,8.1,129573,120823,8750,6.8
St. Tammany,11/1/1993,76944,70483,6461,8.4,129711,121169,8542,6.6
St. Tammany,12/1/1993,76325,70275,6050,7.9,129941,121464,8477,6.5
St. Tammany,1/1/1994,78845,72341,6504,8.2,130596,121966,8630,6.6
St. Tammany,2/1/1994,79683,73118,6565,8.2,130669,122086,8583,6.6
St. Tammany,3/1/1994,79725,73426,6299,7.9,130400,121930,8470,6.5
St. Tammany,4/1/1994,79453,73935,5518,6.9,130621,122290,8331,6.4
St. Tammany,5/1/1994,80169,74495,5674,7.1,130779,122864,7915,6.1
St. Tammany,6/1/1994,81477,74918,6559,8.1,130561,122634,7927,6.1
St. Tammany,7/1/1994,80781,74329,6452,8,130652,122706,7946,6.1
St. Tammany,8/1/1994,79179,73333,5846,7.4,131275,123342,7933,6
St. Tammany,9/1/1994,79311,73480,5831,7.4,131421,123687,7734,5.9
St. Tammany,10/1/1994,80479,74433,6046,7.5,131744,124112,7632,5.8
St. Tammany,11/1/1994,80975,74933,6042,7.5,131891,124516,7375,5.6
St. Tammany,12/1/1994,79967,74405,5562,7,131951,124721,7230,5.5
St. Tammany,1/1/1995,82326,76193,6133,7.4,132038,124663,7375,5.6
St. Tammany,2/1/1995,82454,76826,5628,6.8,132115,124928,7187,5.4
St. Tammany,3/1/1995,82754,77472,5282,6.4,132108,124955,7153,5.4
St. Tammany,4/1/1995,83201,77869,5332,6.4,132590,124945,7645,5.8
St. Tammany,5/1/1995,83641,78050,5591,6.7,131851,124421,7430,5.6
St. Tammany,6/1/1995,84862,78535,6327,7.5,131949,124522,7427,5.6
St. Tammany,7/1/1995,84191,78057,6134,7.3,132343,124816,7527,5.7
St. Tammany,8/1/1995,81538,76621,4917,6,132336,124852,7484,5.7
St. Tammany,9/1/1995,81475,76845,4630,5.7,132611,125133,7478,5.6
St. Tammany,10/1/1995,82199,77516,4683,5.7,132716,125388,7328,5.5
St. Tammany,11/1/1995,82702,77806,4896,5.9,132614,125188,7426,5.6
St. Tammany,12/1/1995,81509,77195,4314,5.3,132511,125088,7423,5.6
St. Tammany,1/1/1996,83852,79373,4479,5.3,132616,125125,7491,5.6
St. Tammany,2/1/1996,84829,80330,4499,5.3,132952,125639,7313,5.5
St. Tammany,3/1/1996,85614,81220,4394,5.1,133180,125862,7318,5.5
St. Tammany,4/1/1996,85735,81701,4034,4.7,133409,125994,7415,5.6
St. Tammany,5/1/1996,86535,82249,4286,5,133667,126244,7423,5.6
St. Tammany,6/1/1996,88079,82915,5164,5.9,133697,126602,7095,5.3
St. Tammany,7/1/1996,87709,82375,5334,6.1,134284,126947,7337,5.5
St. Tammany,8/1/1996,85430,81038,4392,5.1,134054,127172,6882,5.1
St. Tammany,9/1/1996,85970,81641,4329,5,134515,127536,6979,5.2
St. Tammany,10/1/1996,86692,82302,4390,5.1,134921,127890,7031,5.2
St. Tammany,11/1/1996,87120,82706,4414,5.1,135007,127771,7236,5.4
St. Tammany,12/1/1996,86601,82401,4200,4.8,135113,127860,7253,5.4
St. Tammany,1/1/1997,88461,84310,4151,4.7,135456,128298,7158,5.3
St. Tammany,2/1/1997,88856,84756,4100,4.6,135400,128298,7102,5.2
St. Tammany,3/1/1997,90044,85950,4094,4.5,135891,128891,7000,5.2
St. Tammany,4/1/1997,90136,86498,3638,4,136016,129143,6873,5.1
St. Tammany,5/1/1997,90914,86945,3969,4.4,136119,129464,6655,4.9
St. Tammany,6/1/1997,92024,87139,4885,5.3,136211,129412,6799,5
St. Tammany,7/1/1997,91507,86838,4669,5.1,136477,129822,6655,4.9
St. Tammany,8/1/1997,89072,85313,3759,4.2,136618,130010,6608,4.8
St. Tammany,9/1/1997,89361,85493,3868,4.3,136675,130019,6656,4.9
St. Tammany,10/1/1997,90145,86285,3860,4.3,136633,130179,6454,4.7
St. Tammany,11/1/1997,90906,87145,3761,4.1,136961,130653,6308,4.6
St. Tammany,12/1/1997,90403,86926,3477,3.8,137155,130679,6476,4.7
St. Tammany,1/1/1998,91791,87949,3842,4.2,137095,130726,6368,4.6
St. Tammany,2/1/1998,92061,88669,3392,3.7,137112,130807,6306,4.6
St. Tammany,3/1/1998,93058,89554,3504,3.8,137236,130814,6422,4.7
St. Tammany,4/1/1998,93603,90365,3238,3.5,137150,131209,5941,4.3
St. Tammany,5/1/1998,94582,90880,3702,3.9,137372,131325,6047,4.4
St. Tammany,6/1/1998,95381,90811,4570,4.8,137455,131244,6212,4.5
St. Tammany,7/1/1998,94416,90017,4399,4.7,137588,131329,6259,4.5
St. Tammany,8/1/1998,92145,88230,3915,4.2,137570,131390,6179,4.5
St. Tammany,9/1/1998,92739,88770,3969,4.3,138286,131986,6300,4.6
St. Tammany,10/1/1998,92770,89078,3692,4,138279,131999,6280,4.5
St. Tammany,11/1/1998,93163,89651,3512,3.8,138381,132280,6100,4.4
St. Tammany,12/1/1998,92684,89453,3231,3.5,138634,132602,6032,4.4
St. Tammany,1/1/1999,94382,90836,3546,3.8,139003,133027,5976,4.3
St. Tammany,2/1/1999,94512,91345,3167,3.4,138967,132856,6111,4.4
St. Tammany,3/1/1999,95139,92182,2957,3.1,138730,132947,5783,4.2
St. Tammany,4/1/1999,95163,92334,2829,3,138959,132955,6004,4.3
St. Tammany,5/1/1999,95858,92714,3144,3.3,139107,133311,5796,4.2
St. Tammany,6/1/1999,96846,92883,3963,4.1,139329,133378,5951,4.3
St. Tammany,7/1/1999,95651,92048,3603,3.8,139439,133414,6025,4.3
St. Tammany,8/1/1999,93367,90215,3152,3.4,139430,133591,5838,4.2
St. Tammany,9/1/1999,93648,90470,3178,3.4,139622,133707,5915,4.2
St. Tammany,10/1/1999,94380,91156,3224,3.4,139771,133993,5778,4.1
St. Tammany,11/1/1999,95114,92043,3071,3.2,140025,134309,5716,4.1
St. Tammany,12/1/1999,94312,91512,2800,3,140177,134523,5653,4
St. Tammany,1/1/2000,95262,91426,3836,4,142267,136559,5708,4
St. Tammany,2/1/2000,95832,92109,3723,3.9,142456,136598,5858,4.1
St. Tammany,3/1/2000,96677,92922,3755,3.9,142434,136701,5733,4
St. Tammany,4/1/2000,96699,93465,3234,3.3,142751,137270,5481,3.8
St. Tammany,5/1/2000,97350,93324,4026,4.1,142388,136630,5758,4
St. Tammany,6/1/2000,98201,93332,4869,5,142591,136940,5651,4
St. Tammany,7/1/2000,97127,92426,4701,4.8,142278,136531,5747,4
St. Tammany,8/1/2000,94697,90403,4294,4.5,142514,136662,5853,4.1
St. Tammany,9/1/2000,94637,90693,3944,4.2,142518,136893,5625,3.9
St. Tammany,10/1/2000,95182,91099,4083,4.3,142622,137088,5534,3.9
St. Tammany,11/1/2000,95984,91806,4178,4.4,142962,137322,5639,3.9
St. Tammany,12/1/2000,95488,91774,3714,3.9,143248,137614,5634,3.9
St. Tammany,1/1/2001,97289,92770,4519,4.6,143800,137778,6023,4.2
St. Tammany,2/1/2001,97410,93289,4121,4.2,143701,137612,6089,4.2
St. Tammany,3/1/2001,98345,94274,4071,4.1,143924,137783,6141,4.3
St. Tammany,4/1/2001,97857,94042,3815,3.9,143569,137299,6271,4.4
St. Tammany,5/1/2001,98411,94209,4202,4.3,143318,137092,6226,4.3
St. Tammany,6/1/2001,99351,94198,5153,5.2,143357,136873,6484,4.5
St. Tammany,7/1/2001,98529,93775,4754,4.8,143654,137071,6583,4.6
St. Tammany,8/1/2001,95531,91114,4417,4.6,143284,136241,7042,4.9
St. Tammany,9/1/2001,96213,91999,4214,4.4,143989,136846,7142,5
St. Tammany,10/1/2001,96402,91866,4536,4.7,144086,136392,7694,5.3
St. Tammany,11/1/2001,97384,92515,4869,5,144240,136238,8003,5.5
St. Tammany,12/1/2001,96486,91850,4636,4.8,144305,136047,8258,5.7
St. Tammany,1/1/2002,97902,92697,5205,5.3,143883,135701,8182,5.7
St. Tammany,2/1/2002,98569,93857,4712,4.8,144653,136438,8215,5.7
St. Tammany,3/1/2002,98983,94601,4382,4.4,144481,136177,8304,5.7
St. Tammany,4/1/2002,99091,94810,4281,4.3,144725,136126,8599,5.9
St. Tammany,5/1/2002,99770,95107,4663,4.7,144938,136539,8399,5.8
St. Tammany,6/1/2002,100890,95245,5645,5.6,144808,136415,8393,5.8
St. Tammany,7/1/2002,100085,94812,5273,5.3,144803,136413,8390,5.8
St. Tammany,8/1/2002,97616,92780,4836,5,145009,136705,8304,5.7
St. Tammany,9/1/2002,98264,93834,4430,4.5,145552,137302,8251,5.7
St. Tammany,10/1/2002,98200,93595,4605,4.7,145314,137008,8307,5.7
St. Tammany,11/1/2002,99143,94248,4895,4.9,145041,136521,8520,5.9
St. Tammany,12/1/2002,98078,93575,4503,4.6,145066,136426,8640,6
St. Tammany,1/1/2003,100221,95278,4943,4.9,145937,137417,8520,5.8
St. Tammany,2/1/2003,100941,96253,4688,4.6,146100,137482,8618,5.9
St. Tammany,3/1/2003,101551,97108,4443,4.4,146022,137434,8588,5.9
St. Tammany,4/1/2003,101695,97384,4311,4.2,146474,137633,8842,6
St. Tammany,5/1/2003,102380,97493,4887,4.8,146500,137544,8957,6.1
St. Tammany,6/1/2003,103678,97672,6006,5.8,147056,137790,9266,6.3
St. Tammany,7/1/2003,102452,96942,5510,5.4,146485,137474,9011,6.2
St. Tammany,8/1/2003,99540,94670,4870,4.9,146445,137549,8896,6.1
St. Tammany,9/1/2003,99863,95451,4412,4.4,146530,137609,8921,6.1
St. Tammany,10/1/2003,100200,95808,4392,4.4,146716,137984,8732,6
St. Tammany,11/1/2003,101506,96996,4510,4.4,147000,138424,8576,5.8
St. Tammany,12/1/2003,100521,96392,4129,4.1,146729,138411,8317,5.7
St. Tammany,1/1/2004,102442,97700,4742,4.6,146842,138472,8370,5.7
St. Tammany,2/1/2004,102965,98730,4235,4.1,146709,138542,8167,5.6
St. Tammany,3/1/2004,103667,99691,3976,3.8,146944,138453,8491,5.8
St. Tammany,4/1/2004,103663,100116,3547,3.4,146850,138680,8170,5.6
St. Tammany,5/1/2004,104571,100375,4196,4,147065,138852,8212,5.6
St. Tammany,6/1/2004,105861,100766,5095,4.8,147460,139174,8286,5.6
St. Tammany,7/1/2004,105473,100710,4763,4.5,147692,139556,8136,5.5
St. Tammany,8/1/2004,102661,98574,4087,4,147564,139573,7990,5.4
St. Tammany,9/1/2004,103043,99055,3988,3.9,147415,139487,7927,5.4
St. Tammany,10/1/2004,103691,99367,4324,4.2,147793,139732,8061,5.5
St. Tammany,11/1/2004,105410,100812,4598,4.4,148162,140231,7932,5.4
St. Tammany,12/1/2004,104447,100195,4252,4.1,148059,140125,7934,5.4
St. Tammany,1/1/2005,106427,101654,4773,4.5,148029,140245,7784,5.3
St. Tammany,2/1/2005,107035,102480,4555,4.3,148364,140385,7980,5.4
St. Tammany,3/1/2005,107616,103687,3929,3.7,148391,140654,7737,5.2
St. Tammany,4/1/2005,108270,104588,3682,3.4,148926,141254,7672,5.2
St. Tammany,5/1/2005,109321,104989,4332,4,149261,141609,7651,5.1
St. Tammany,6/1/2005,110524,105318,5206,4.7,149238,141714,7524,5
St. Tammany,7/1/2005,109988,105066,4922,4.5,149432,142026,7406,5
St. Tammany,8/1/2005,107148,102730,4418,4.1,149779,142434,7345,4.9
St. Tammany,7/1/2006,116419,112333,4086,3.5,151377,144202,7175,4.7
St. Tammany,8/1/2006,115608,111602,4006,3.5,151716,144625,7091,4.7
St. Tammany,9/1/2006,115153,111313,3840,3.3,151662,144815,6847,4.5
St. Tammany,10/1/2006,117556,113897,3659,3.1,152041,145314,6727,4.4
St. Tammany,11/1/2006,118647,114944,3703,3.1,152406,145534,6872,4.5
St. Tammany,12/1/2006,118599,115293,3306,2.8,152732,145970,6762,4.4
St. Tammany,1/1/2007,115577,111705,3872,3.4,153144,146028,7116,4.6
St. Tammany,2/1/2007,115667,112388,3279,2.8,152983,146057,6927,4.5
St. Tammany,3/1/2007,117309,113882,3427,2.9,153051,146320,6731,4.4
St. Tammany,4/1/2007,115754,112461,3293,2.8,152435,145586,6850,4.5
St. Tammany,5/1/2007,115947,112195,3752,3.2,152670,145903,6766,4.4
St. Tammany,6/1/2007,117809,113344,4465,3.8,153041,146063,6979,4.6
St. Tammany,7/1/2007,117432,113521,3911,3.3,153054,145905,7149,4.7
St. Tammany,8/1/2007,115755,112191,3564,3.1,152749,145682,7067,4.6
St. Tammany,9/1/2007,115568,111872,3696,3.2,153414,146244,7170,4.7
St. Tammany,10/1/2007,117941,114752,3189,2.7,153183,145946,7237,4.7
St. Tammany,11/1/2007,119067,115732,3335,2.8,153835,146595,7240,4.7
St. Tammany,12/1/2007,118907,115501,3406,2.9,153918,146273,7645,5
St. Tammany,1/1/2008,109056,105101,3955,3.6,154063,146378,7685,5
St. Tammany,2/1/2008,108709,105430,3279,3,153653,146156,7497,4.9
St. Tammany,3/1/2008,110078,106448,3630,3.3,153908,146086,7822,5.1
St. Tammany,4/1/2008,111095,107879,3216,2.9,153769,146132,7637,5
St. Tammany,5/1/2008,110942,107080,3862,3.5,154303,145908,8395,5.4
St. Tammany,6/1/2008,112882,108065,4817,4.3,154313,145737,8575,5.6
St. Tammany,7/1/2008,112561,108051,4510,4,154469,145532,8937,5.8
St. Tammany,8/1/2008,112148,107500,4648,4.1,154641,145203,9438,6.1
St. Tammany,9/1/2008,111637,107274,4363,3.9,154570,145076,9494,6.1
St. Tammany,10/1/2008,112752,108035,4717,4.2,154876,144802,10074,6.5
St. Tammany,11/1/2008,112235,107532,4703,4.2,154639,144100,10538,6.8
St. Tammany,12/1/2008,112201,107350,4851,4.3,154655,143369,11286,7.3
St. Tammany,1/1/2009,107690,101987,5703,5.3,154210,142152,12058,7.8
St. Tammany,2/1/2009,107946,102392,5554,5.1,154538,141640,12898,8.3
St. Tammany,3/1/2009,108092,102466,5626,5.2,154133,140707,13426,8.7
St. Tammany,4/1/2009,108756,103392,5364,4.9,154509,140656,13853,9
St. Tammany,5/1/2009,108716,102817,5899,5.4,154747,140248,14499,9.4
St. Tammany,6/1/2009,109784,102953,6831,6.2,154716,140009,14707,9.5
St. Tammany,7/1/2009,109815,103705,6110,5.6,154502,139901,14601,9.5
St. Tammany,8/1/2009,109425,103342,6083,5.6,154307,139492,14814,9.6
St. Tammany,9/1/2009,108136,102403,5733,5.3,153827,138818,15009,9.8
St. Tammany,10/1/2009,108654,103000,5654,5.2,153784,138432,15352,10
St. Tammany,11/1/2009,108830,103420,5410,5,153878,138659,15219,9.9
St. Tammany,12/1/2009,107820,102393,5427,5,153111,138013,15098,9.9
St. Tammany,1/1/2010,107894,101508,6386,5.9,153484,138438,15046,9.8
St. Tammany,2/1/2010,107904,102187,5717,5.3,153694,138581,15113,9.8
St. Tammany,3/1/2010,109027,103195,5832,5.3,153954,138751,15202,9.9
St. Tammany,4/1/2010,109792,103879,5913,5.4,154622,139297,15325,9.9
St. Tammany,5/1/2010,108974,102712,6262,5.7,154091,139241,14849,9.6
St. Tammany,6/1/2010,110122,103011,7111,6.5,153616,139141,14474,9.4
St. Tammany,7/1/2010,109394,102629,6765,6.2,153691,139179,14512,9.4
St. Tammany,8/1/2010,109208,102285,6923,6.3,154086,139438,14648,9.5
St. Tammany,9/1/2010,109163,102535,6628,6.1,153975,139396,14579,9.5
St. Tammany,10/1/2010,109136,102467,6669,6.1,153635,139119,14516,9.4
St. Tammany,11/1/2010,109537,102969,6568,6,154125,139044,15081,9.8
St. Tammany,12/1/2010,108844,102846,5998,5.5,153650,139301,14348,9.3
St. Tammany,1/1/2011,108227,101224,7003,6.5,153263,139250,14013,9.1
St. Tammany,2/1/2011,108295,101998,6297,5.8,153214,139394,13820,9
St. Tammany,3/1/2011,108935,102748,6187,5.7,153376,139639,13737,9
St. Tammany,4/1/2011,108570,102628,5942,5.5,153543,139586,13957,9.1
St. Tammany,5/1/2011,108413,102092,6321,5.8,153479,139624,13855,9
St. Tammany,6/1/2011,108820,101778,7042,6.5,153346,139384,13962,9.1
St. Tammany,7/1/2011,108572,101763,6809,6.3,153288,139524,13763,9
St. Tammany,8/1/2011,108076,101543,6533,6,153760,139942,13818,9
St. Tammany,9/1/2011,108316,101793,6523,6,154131,140183,13948,9
St. Tammany,10/1/2011,109101,102675,6426,5.9,153961,140368,13594,8.8
St. Tammany,11/1/2011,109561,103522,6039,5.5,154128,140826,13302,8.6
St. Tammany,12/1/2011,108731,102988,5743,5.3,153995,140902,13093,8.5
St. Tammany,1/1/2012,108069,101451,6618,6.1,154381,141584,12797,8.3
St. Tammany,2/1/2012,108375,102139,6236,5.8,154671,141858,12813,8.3
St. Tammany,3/1/2012,109244,103122,6122,5.6,154749,142036,12713,8.2
St. Tammany,4/1/2012,109859,104096,5763,5.2,154545,141899,12646,8.2
St. Tammany,5/1/2012,110096,103747,6349,5.8,154866,142206,12660,8.2
St. Tammany,6/1/2012,110783,103526,7257,6.6,155083,142391,12692,8.2
St. Tammany,7/1/2012,110493,103749,6744,6.1,154948,142292,12656,8.2
St. Tammany,8/1/2012,109134,102942,6192,5.7,154763,142291,12471,8.1
St. Tammany,9/1/2012,108571,102807,5764,5.3,155160,143044,12115,7.8
St. Tammany,10/1/2012,109728,104064,5664,5.2,155554,143431,12124,7.8
St. Tammany,11/1/2012,109546,104348,5198,4.7,155338,143333,12005,7.7
St. Tammany,12/1/2012,109577,103981,5596,5.1,155628,143330,12298,7.9
St. Tammany,1/1/2013,110673,103761,6912,6.2,155763,143292,12471,8
St. Tammany,2/1/2013,110454,104516,5938,5.4,155312,143362,11950,7.7
St. Tammany,3/1/2013,110438,104585,5853,5.3,155005,143316,11689,7.5
St. Tammany,4/1/2013,110982,105103,5879,5.3,155394,143635,11760,7.6
St. Tammany,5/1/2013,111216,104704,6512,5.9,155536,143882,11654,7.5
St. Tammany,6/1/2013,112629,105197,7432,6.6,155749,143999,11751,7.5
St. Tammany,7/1/2013,111610,104816,6794,6.1,155599,144264,11335,7.3
St. Tammany,8/1/2013,111168,104836,6332,5.7,155605,144326,11279,7.2
St. Tammany,9/1/2013,110594,104732,5862,5.3,155687,144418,11270,7.2
St. Tammany,10/1/2013,111112,105329,5783,5.2,154673,143537,11136,7.2
St. Tammany,11/1/2013,111881,106587,5294,4.7,155265,144479,10787,6.9
St. Tammany,12/1/2013,111093,106363,4730,4.3,155182,144778,10404,6.7
St. Tammany,1/1/2014,111315,105806,5509,4.9,155352,145150,10202,6.6
St. Tammany,2/1/2014,112003,106874,5129,4.6,155483,145134,10349,6.7
St. Tammany,3/1/2014,113374,107863,5511,4.9,156028,145648,10380,6.7
St. Tammany,4/1/2014,113142,107939,5203,4.6,155369,145667,9702,6.2
St. Tammany,5/1/2014,113726,107669,6057,5.3,155684,145825,9859,6.3
St. Tammany,6/1/2014,115428,108571,6857,5.9,155707,146247,9460,6.1
St. Tammany,7/1/2014,115737,108413,7324,6.3,156007,146399,9608,6.2
St. Tammany,8/1/2014,115194,107900,7294,6.3,156130,146530,9599,6.1
St. Tammany,9/1/2014,114644,107657,6987,6.1,156040,146778,9262,5.9
St. Tammany,10/1/2014,115903,109017,6886,5.9,156417,147427,8990,5.7
St. Tammany,11/1/2014,116753,109803,6950,6,156494,147404,9090,5.8
St. Tammany,12/1/2014,115462,109166,6296,5.5,156332,147615,8717,5.6
St. Tammany,1/1/2015,116345,109208,7137,6.1,157030,148145,8885,5.7
St. Tammany,2/1/2015,116294,109828,6466,5.6,156644,148045,8599,5.5
St. Tammany,3/1/2015,116993,110594,6399,5.5,156643,148128,8515,5.4
St. Tammany,4/1/2015,118396,112228,6168,5.2,157060,148511,8550,5.4
St. Tammany,5/1/2015,118405,111882,6523,5.5,157651,148817,8834,5.6
St. Tammany,6/1/2015,118373,111463,6910,5.8,157062,148816,8247,5.3
St. Tammany,7/1/2015,117625,110990,6635,5.6,156997,148830,8167,5.2
St. Tammany,8/1/2015,116186,110057,6129,5.3,157172,149181,7992,5.1
St. Tammany,9/1/2015,115222,109187,6035,5.2,156733,148826,7907,5
St. Tammany,10/1/2015,116537,110672,5865,5,157167,149246,7922,5
St. Tammany,11/1/2015,116374,110866,5508,4.7,157463,149463,8000,5.1
St. Tammany,12/1/2015,115895,110883,5012,4.3,158035,150128,7907,5
St. Tammany,1/1/2016,116637,110595,6042,5.2,158280,150653,7627,4.8
St. Tammany,2/1/2016,116604,111146,5458,4.7,158640,150939,7702,4.9
St. Tammany,3/1/2016,117475,111735,5740,4.9,159179,151218,7961,5
St. Tammany,4/1/2016,117932,112531,5401,4.6,159141,151074,8067,5.1
St. Tammany,5/1/2016,117911,112326,5585,4.7,158784,151132,7652,4.8
St. Tammany,6/1/2016,118839,112134,6705,5.6,158967,151223,7744,4.9
St. Tammany,7/1/2016,118687,112151,6536,5.5,159194,151554,7641,4.8
St. Tammany,8/1/2016,117415,111207,6208,5.3,159562,151779,7784,4.9
St. Tammany,9/1/2016,117402,111190,6212,5.3,159714,151761,7953,5
St. Tammany,10/1/2016,117337,111729,5608,4.8,159605,151793,7811,4.9
St. Tammany,11/1/2016,117319,112054,5265,4.5,159506,151954,7553,4.7
St. Tammany,12/1/2016,115906,110994,4912,4.2,159678,152157,7521,4.7
St. Tammany,1/1/2017,115880,110243,5637,4.9,159620,152152,7468,4.7
St. Tammany,2/1/2017,117046,111828,5218,4.5,159859,152480,7379,4.6
St. Tammany,3/1/2017,117094,111971,5123,4.4,160137,153065,7073,4.4
St. Tammany,4/1/2017,117963,113021,4942,4.2,160345,153255,7089,4.4
St. Tammany,5/1/2017,117423,112515,4908,4.2,160068,153069,7000,4.4
St. Tammany,6/1/2017,118072,112458,5614,4.8,160192,153318,6873,4.3
St. Tammany,7/1/2017,117965,112417,5548,4.7,160462,153569,6892,4.3
St. Tammany,8/1/2017,117005,111579,5426,4.6,160586,153503,7082,4.4
St. Tammany,9/1/2017,117300,112289,5011,4.3,161140,154286,6854,4.3
St. Tammany,10/1/2017,117163,112862,4301,3.7,160309,153609,6700,4.2
St. Tammany,11/1/2017,117608,113261,4347,3.7,160579,153805,6774,4.2
St. Tammany,12/1/2017,116867,112788,4079,3.5,160535,153904,6632,4.1
St. Tammany,1/1/2018,117758,113087,4671,4,160914,154425,6489,4
St. Tammany,2/1/2018,118359,113897,4462,3.8,161778,155197,6581,4.1
St. Tammany,3/1/2018,118575,114000,4575,3.9,161686,155214,6472,4
St. Tammany,4/1/2018,119717,115186,4531,3.8,161771,155312,6459,4
St. Tammany,5/1/2018,119049,114304,4745,4,161848,155652,6196,3.8
St. Tammany,6/1/2018,120348,114091,6257,5.2,162210,155762,6447,4
St. Tammany,7/1/2018,120204,114362,5842,4.9,162341,156146,6195,3.8
St. Tammany,8/1/2018,118099,112844,5255,4.4,161660,155504,6156,3.8
St. Tammany,9/1/2018,117952,112987,4965,4.2,162087,156015,6073,3.7
St. Tammany,10/1/2018,118794,114030,4764,4,162602,156391,6211,3.8
St. Tammany,11/1/2018,118869,114359,4510,3.8,162836,156721,6115,3.8
St. Tammany,12/1/2018,117793,113480,4313,3.7,163206,156817,6389,3.9
St. Tammany,1/1/2019,119218,113898,5320,4.5,162963,156487,6475,4
St. Tammany,2/1/2019,119622,115182,4440,3.7,162999,156863,6136,3.8
St. Tammany,3/1/2019,119375,115193,4182,3.5,162904,156701,6202,3.8
St. Tammany,4/1/2019,120478,116572,3906,3.2,162586,156625,5961,3.7
St. Tammany,5/1/2019,120199,115620,4579,3.8,162751,156821,5930,3.6
St. Tammany,6/1/2019,122053,116347,5706,4.7,163168,157232,5935,3.6
St. Tammany,7/1/2019,121665,116108,5557,4.6,163590,157529,6061,3.7
St. Tammany,8/1/2019,120487,115339,5148,4.3,163774,157829,5945,3.6
St. Tammany,9/1/2019,120675,115677,4998,4.1,164092,158339,5753,3.5
St. Tammany,10/1/2019,121521,116561,4960,4.1,164416,158545,5871,3.6
St. Tammany,11/1/2019,121896,117128,4768,3.9,164496,158629,5868,3.6
St. Tammany,12/1/2019,120606,116173,4433,3.7,164699,158845,5853,3.6
St. Tammany,1/1/2020,121817,116859,4958,4.1,164377,158508,5869,3.6
St. Tammany,2/1/2020,121227,117328,3899,3.2,164467,158714,5753,3.5
St. Tammany,3/1/2020,121268,114349,6919,5.7,162559,155353,7206,4.4
St. Tammany,4/1/2020,110546,95881,14665,13.3,156269,133185,23084,14.8
St. Tammany,5/1/2020,111454,98531,12923,11.6,158101,137173,20929,13.2
St. Tammany,6/1/2020,114750,103371,11379,9.9,159994,142342,17652,11
St. Tammany,7/1/2020,114868,104700,10168,8.9,160132,143779,16352,10.2
St. Tammany,8/1/2020,114263,106563,7700,6.7,160706,147245,13461,8.4
St. Tammany,9/1/2020,114297,106653,7644,6.7,160174,147620,12554,7.8
St. Tammany,10/1/2020,116072,109443,6629,5.7,161003,149931,11072,6.9
St. Tammany,11/1/2020,115462,109835,5627,4.9,160629,149934,10694,6.7
St. Tammany,12/1/2020,114889,109311,5578,4.9,160745,149975,10770,6.7
St. Tammany,1/1/2021,113416,107647,5769,5.1,160088,149852,10236,6.4
St. Tammany,2/1/2021,114709,109323,5386,4.7,160184,150189,9995,6.2
St. Tammany,3/1/2021,115466,110394,5072,4.4,160400,150644,9756,6.1
St. Tammany,4/1/2021,116637,111516,5121,4.4,160843,151081,9762,6.1
St. Tammany,5/1/2021,116623,111660,4963,4.3,160800,151535,9266,5.8
St. Tammany,6/1/2021,117761,111957,5804,4.9,161197,151734,9462,5.9
St. Tammany,7/1/2021,118625,113589,5036,4.2,161504,152773,8731,5.4
St. Tammany,8/1/2021,117489,113051,4438,3.8,161527,153250,8276,5.1
St. Tammany,9/1/2021,113654,109286,4368,3.8,161495,153843,7652,4.7
St. Tammany,10/1/2021,115956,112206,3750,3.2,161754,154475,7279,4.5
St. Tammany,11/1/2021,116873,113580,3293,2.8,162281,155530,6751,4.2
St. Tammany,12/1/2021,116462,113490,2972,2.6,162497,156099,6398,3.9
St. Tammany,1/1/2022,116096,112397,3699,3.2,163627,157115,6512,4
St. Tammany,2/1/2022,117266,113935,3331,2.8,163899,157598,6301,3.8
St. Tammany,3/1/2022,118408,115144,3264,2.8,164220,158206,6014,3.7
St. Tammany,4/1/2022,118598,115614,2984,2.5,163893,157891,6002,3.7
St. Tammany,5/1/2022,119148,115867,3281,2.8,164362,158378,5983,3.6
St. Tammany,6/1/2022,120451,115912,4539,3.8,164046,158094,5951,3.6
St. Tammany,7/1/2022,119729,115713,4016,3.4,164026,158258,5768,3.5
St. Tammany,8/1/2022,118469,114794,3675,3.1,164654,158735,5919,3.6
St. Tammany,9/1/2022,118448,114893,3555,3,164602,158810,5792,3.5
St. Tammany,10/1/2022,118826,115506,3320,2.8,164648,158684,5964,3.6
St. Tammany,11/1/2022,118857,115736,3121,2.6,164450,158507,5943,3.6
St. Tammany,12/1/2022,118631,115443,3188,2.7,165025,159259,5766,3.5
St. Tammany,1/1/2023,118073,114340,3733,3.2,165964,160217,5747,3.5
St. Tammany,2/1/2023,118965,115351,3614,3,166358,160395,5962,3.6
St. Tammany,3/1/2023,119429,116017,3412,2.9,166651,160812,5839,3.5
St. Tammany,4/1/2023,119705,116549,3156,2.6,166725,160974,5751,3.4
St. Tammany,5/1/2023,119657,115935,3722,3.1,166886,160796,6089,3.6
St. Tammany,6/1/2023,120498,116003,4495,3.7,166937,160979,5958,3.6
St. Tammany,7/1/2023,119147,115360,3787,3.2,167103,161183,5920,3.5
St. Tammany,8/1/2023,118889,114803,4086,3.4,167759,161475,6284,3.7
St. Tammany,9/1/2023,119299,114859,4440,3.7,167767,161442,6326,3.8
St. Tammany,10/1/2023,119364,114951,4413,3.7,167690,161211,6479,3.9
St. Tammany,11/1/2023,119462,115323,4139,3.5,168140,161886,6254,3.7
St. Tammany,12/1/2023,118236,114044,4192,3.5,167439,161124,6315,3.8
St. Tammany,1/1/2024,117383,112693,4690,4,167339,161190,6149,3.7
St. Tammany,2/1/2024,118404,113687,4717,4,167475,161013,6462,3.9
St. Tammany,3/1/2024,119351,114795,4556,3.8,167922,161425,6497,3.9
St. Tammany,4/1/2024,119544,115542,4002,3.3,167988,161495,6492,3.9
St. Tammany,5/1/2024,118668,114458,4210,3.5,167799,161164,6635,4
St. Tammany,6/1/2024,119954,114471,5483,4.6,168005,161155,6849,4.1
St. Tammany,7/1/2024,120717,115434,5283,4.4,168315,161219,7097,4.2
St. Tammany,8/1/2024,119404,114157,5247,4.4,168496,161425,7071,4.2
St. Tammany,9/1/2024,119339,114165,5174,4.3,168703,161802,6901,4.1
St. Tammany,10/1/2024,119697,114540,5157,4.3,168428,161456,6972,4.1
St. Tammany,11/1/2024,119962,115018,4944,4.1,168304,161183,7121,4.2
St. Tammany,12/1/2024,118786,114205,4581,3.9,168547,161661,6886,4.1
St. Tammany,1/1/2025,126910,122055,4855,3.8,170744,163895,6849,4
St. Tammany,2/1/2025,128281,123442,4839,3.8,170359,163307,7052,4.1
Tangipahoa,1/1/1990,34378,31355,3023,8.8,125833,119081,6752,5.4
Tangipahoa,2/1/1990,34027,31254,2773,8.1,125710,119059,6651,5.3
Tangipahoa,3/1/1990,34215,31582,2633,7.7,125801,119203,6598,5.2
Tangipahoa,4/1/1990,34277,31545,2732,8,125649,118852,6797,5.4
Tangipahoa,5/1/1990,34544,31617,2927,8.5,125893,119151,6742,5.4
Tangipahoa,6/1/1990,35218,31633,3585,10.2,125573,118983,6590,5.2
Tangipahoa,7/1/1990,35443,31642,3801,10.7,125732,118810,6922,5.5
Tangipahoa,8/1/1990,35505,31685,3820,10.8,125990,118802,7188,5.7
Tangipahoa,9/1/1990,35458,31636,3822,10.8,125892,118524,7368,5.9
Tangipahoa,10/1/1990,35769,32355,3414,9.5,125995,118536,7459,5.9
Tangipahoa,11/1/1990,35614,32164,3450,9.7,126070,118306,7764,6.2
Tangipahoa,12/1/1990,35677,32147,3530,9.9,126142,118241,7901,6.3
Tangipahoa,1/1/1991,35429,31824,3605,10.2,125955,117940,8015,6.4
Tangipahoa,2/1/1991,35366,31972,3394,9.6,126020,117755,8265,6.6
Tangipahoa,3/1/1991,35571,32245,3326,9.4,126238,117652,8586,6.8
Tangipahoa,4/1/1991,35640,32150,3490,9.8,126548,118109,8439,6.7
Tangipahoa,5/1/1991,35511,31628,3883,10.9,126176,117440,8736,6.9
Tangipahoa,6/1/1991,36161,31612,4549,12.6,126331,117639,8692,6.9
Tangipahoa,7/1/1991,36812,32431,4381,11.9,126154,117568,8586,6.8
Tangipahoa,8/1/1991,36540,32480,4060,11.1,126150,117484,8666,6.9
Tangipahoa,9/1/1991,36342,32750,3592,9.9,126650,117928,8722,6.9
Tangipahoa,10/1/1991,36469,33207,3262,8.9,126642,117800,8842,7
Tangipahoa,11/1/1991,36339,33220,3119,8.6,126701,117770,8931,7
Tangipahoa,12/1/1991,36038,33026,3012,8.4,126664,117466,9198,7.3
Tangipahoa,1/1/1992,36477,33074,3403,9.3,127261,117978,9283,7.3
Tangipahoa,2/1/1992,36224,33297,2927,8.1,127207,117753,9454,7.4
Tangipahoa,3/1/1992,36714,33714,3000,8.2,127604,118144,9460,7.4
Tangipahoa,4/1/1992,37048,33884,3164,8.5,127841,118426,9415,7.4
Tangipahoa,5/1/1992,36845,33523,3322,9,128119,118375,9744,7.6
Tangipahoa,6/1/1992,38269,34103,4166,10.9,128459,118419,10040,7.8
Tangipahoa,7/1/1992,39470,35657,3813,9.7,128563,118713,9850,7.7
Tangipahoa,8/1/1992,38998,35191,3807,9.8,128613,118826,9787,7.6
Tangipahoa,9/1/1992,38956,35345,3611,9.3,128501,118720,9781,7.6
Tangipahoa,10/1/1992,38828,35820,3008,7.7,128026,118628,9398,7.3
Tangipahoa,11/1/1992,38673,35826,2847,7.4,128441,118876,9565,7.4
Tangipahoa,12/1/1992,38219,35111,3108,8.1,128554,118997,9557,7.4
Tangipahoa,1/1/1993,37200,33605,3595,9.7,128400,119075,9325,7.3
Tangipahoa,2/1/1993,37575,34357,3218,8.6,128458,119275,9183,7.1
Tangipahoa,3/1/1993,38066,34743,3323,8.7,128598,119542,9056,7
Tangipahoa,4/1/1993,37970,34596,3374,8.9,128584,119474,9110,7.1
Tangipahoa,5/1/1993,38413,34978,3435,8.9,129264,120115,9149,7.1
Tangipahoa,6/1/1993,39496,35364,4132,10.5,129411,120290,9121,7
Tangipahoa,7/1/1993,38748,34806,3942,10.2,129397,120467,8930,6.9
Tangipahoa,8/1/1993,38690,34791,3899,10.1,129619,120856,8763,6.8
Tangipahoa,9/1/1993,38756,35041,3715,9.6,129268,120554,8714,6.7
Tangipahoa,10/1/1993,40064,36310,3754,9.4,129573,120823,8750,6.8
Tangipahoa,11/1/1993,39974,36439,3535,8.8,129711,121169,8542,6.6
Tangipahoa,12/1/1993,39851,36424,3427,8.6,129941,121464,8477,6.5
Tangipahoa,1/1/1994,40621,36382,4239,10.4,130596,121966,8630,6.6
Tangipahoa,2/1/1994,40163,36371,3792,9.4,130669,122086,8583,6.6
Tangipahoa,3/1/1994,40589,36584,4005,9.9,130400,121930,8470,6.5
Tangipahoa,4/1/1994,40830,36584,4246,10.4,130621,122290,8331,6.4
Tangipahoa,5/1/1994,41453,37058,4395,10.6,130779,122864,7915,6.1
Tangipahoa,6/1/1994,41844,36951,4893,11.7,130561,122634,7927,6.1
Tangipahoa,7/1/1994,41618,36988,4630,11.1,130652,122706,7946,6.1
Tangipahoa,8/1/1994,41805,37092,4713,11.3,131275,123342,7933,6
Tangipahoa,9/1/1994,42051,37828,4223,10,131421,123687,7734,5.9
Tangipahoa,10/1/1994,42123,38070,4053,9.6,131744,124112,7632,5.8
Tangipahoa,11/1/1994,41842,38100,3742,8.9,131891,124516,7375,5.6
Tangipahoa,12/1/1994,41240,37748,3492,8.5,131951,124721,7230,5.5
Tangipahoa,1/1/1995,41357,37500,3857,9.3,132038,124663,7375,5.6
Tangipahoa,2/1/1995,40769,37520,3249,8,132115,124928,7187,5.4
Tangipahoa,3/1/1995,41059,37632,3427,8.3,132108,124955,7153,5.4
Tangipahoa,4/1/1995,42127,38318,3809,9,132590,124945,7645,5.8
Tangipahoa,5/1/1995,41800,38136,3664,8.8,131851,124421,7430,5.6
Tangipahoa,6/1/1995,42793,38389,4404,10.3,131949,124522,7427,5.6
Tangipahoa,7/1/1995,42383,38516,3867,9.1,132343,124816,7527,5.7
Tangipahoa,8/1/1995,42057,38315,3742,8.9,132336,124852,7484,5.7
Tangipahoa,9/1/1995,42176,38575,3601,8.5,132611,125133,7478,5.6
Tangipahoa,10/1/1995,41346,38195,3151,7.6,132716,125388,7328,5.5
Tangipahoa,11/1/1995,41145,38135,3010,7.3,132614,125188,7426,5.6
Tangipahoa,12/1/1995,40814,37665,3149,7.7,132511,125088,7423,5.6
Tangipahoa,1/1/1996,40516,36960,3556,8.8,132616,125125,7491,5.6
Tangipahoa,2/1/1996,41147,37912,3235,7.9,132952,125639,7313,5.5
Tangipahoa,3/1/1996,41512,38572,2940,7.1,133180,125862,7318,5.5
Tangipahoa,4/1/1996,42094,38461,3633,8.6,133409,125994,7415,5.6
Tangipahoa,5/1/1996,42134,38630,3504,8.3,133667,126244,7423,5.6
Tangipahoa,6/1/1996,43297,38923,4374,10.1,133697,126602,7095,5.3
Tangipahoa,7/1/1996,43211,38903,4308,10,134284,126947,7337,5.5
Tangipahoa,8/1/1996,43104,39231,3873,9,134054,127172,6882,5.1
Tangipahoa,9/1/1996,43377,39608,3769,8.7,134515,127536,6979,5.2
Tangipahoa,10/1/1996,42553,39080,3473,8.2,134921,127890,7031,5.2
Tangipahoa,11/1/1996,41790,38676,3114,7.5,135007,127771,7236,5.4
Tangipahoa,12/1/1996,41565,38458,3107,7.5,135113,127860,7253,5.4
Tangipahoa,1/1/1997,40914,37780,3134,7.7,135456,128298,7158,5.3
Tangipahoa,2/1/1997,40627,37846,2781,6.8,135400,128298,7102,5.2
Tangipahoa,3/1/1997,41558,38503,3055,7.4,135891,128891,7000,5.2
Tangipahoa,4/1/1997,41492,38695,2797,6.7,136016,129143,6873,5.1
Tangipahoa,5/1/1997,41560,38549,3011,7.2,136119,129464,6655,4.9
Tangipahoa,6/1/1997,42813,38727,4086,9.5,136211,129412,6799,5
Tangipahoa,7/1/1997,42717,38894,3823,8.9,136477,129822,6655,4.9
Tangipahoa,8/1/1997,42428,39058,3370,7.9,136618,130010,6608,4.8
Tangipahoa,9/1/1997,42320,38927,3393,8,136675,130019,6656,4.9
Tangipahoa,10/1/1997,41893,39012,2881,6.9,136633,130179,6454,4.7
Tangipahoa,11/1/1997,41752,39091,2661,6.4,136961,130653,6308,4.6
Tangipahoa,12/1/1997,41443,38897,2546,6.1,137155,130679,6476,4.7
Tangipahoa,1/1/1998,41085,38226,2859,7,137095,130726,6368,4.6
Tangipahoa,2/1/1998,41098,38518,2580,6.3,137112,130807,6306,4.6
Tangipahoa,3/1/1998,41541,38651,2890,7,137236,130814,6422,4.7
Tangipahoa,4/1/1998,41996,39030,2966,7.1,137150,131209,5941,4.3
Tangipahoa,5/1/1998,42639,39276,3363,7.9,137372,131325,6047,4.4
Tangipahoa,6/1/1998,43688,39763,3925,9,137455,131244,6212,4.5
Tangipahoa,7/1/1998,43245,39459,3786,8.8,137588,131329,6259,4.5
Tangipahoa,8/1/1998,43014,39164,3850,9,137570,131390,6179,4.5
Tangipahoa,9/1/1998,42984,39373,3611,8.4,138286,131986,6300,4.6
Tangipahoa,10/1/1998,42914,39858,3056,7.1,138279,131999,6280,4.5
Tangipahoa,11/1/1998,42386,39717,2669,6.3,138381,132280,6100,4.4
Tangipahoa,12/1/1998,42351,39755,2596,6.1,138634,132602,6032,4.4
Tangipahoa,1/1/1999,42478,39666,2812,6.6,139003,133027,5976,4.3
Tangipahoa,2/1/1999,41819,39458,2361,5.6,138967,132856,6111,4.4
Tangipahoa,3/1/1999,42425,40184,2241,5.3,138730,132947,5783,4.2
Tangipahoa,4/1/1999,42957,40635,2322,5.4,138959,132955,6004,4.3
Tangipahoa,5/1/1999,42988,40631,2357,5.5,139107,133311,5796,4.2
Tangipahoa,6/1/1999,44521,41218,3303,7.4,139329,133378,5951,4.3
Tangipahoa,7/1/1999,44418,41041,3377,7.6,139439,133414,6025,4.3
Tangipahoa,8/1/1999,44207,41019,3188,7.2,139430,133591,5838,4.2
Tangipahoa,9/1/1999,44173,41108,3065,6.9,139622,133707,5915,4.2
Tangipahoa,10/1/1999,43985,41386,2599,5.9,139771,133993,5778,4.1
Tangipahoa,11/1/1999,43783,41409,2374,5.4,140025,134309,5716,4.1
Tangipahoa,12/1/1999,43523,41119,2404,5.5,140177,134523,5653,4
Tangipahoa,1/1/2000,44585,41756,2829,6.3,142267,136559,5708,4
Tangipahoa,2/1/2000,44434,42047,2387,5.4,142456,136598,5858,4.1
Tangipahoa,3/1/2000,44689,42158,2531,5.7,142434,136701,5733,4
Tangipahoa,4/1/2000,44843,42569,2274,5.1,142751,137270,5481,3.8
Tangipahoa,5/1/2000,44743,42058,2685,6,142388,136630,5758,4
Tangipahoa,6/1/2000,45357,42067,3290,7.3,142591,136940,5651,4
Tangipahoa,7/1/2000,44864,41767,3097,6.9,142278,136531,5747,4
Tangipahoa,8/1/2000,45005,41826,3179,7.1,142514,136662,5853,4.1
Tangipahoa,9/1/2000,44878,41876,3002,6.7,142518,136893,5625,3.9
Tangipahoa,10/1/2000,45227,42383,2844,6.3,142622,137088,5534,3.9
Tangipahoa,11/1/2000,45485,42614,2871,6.3,142962,137322,5639,3.9
Tangipahoa,12/1/2000,45620,42805,2815,6.2,143248,137614,5634,3.9
Tangipahoa,1/1/2001,45077,41823,3254,7.2,143800,137778,6023,4.2
Tangipahoa,2/1/2001,45406,42587,2819,6.2,143701,137612,6089,4.2
Tangipahoa,3/1/2001,45986,43076,2910,6.3,143924,137783,6141,4.3
Tangipahoa,4/1/2001,45517,42680,2837,6.2,143569,137299,6271,4.4
Tangipahoa,5/1/2001,45436,42635,2801,6.2,143318,137092,6226,4.3
Tangipahoa,6/1/2001,46245,42800,3445,7.4,143357,136873,6484,4.5
Tangipahoa,7/1/2001,46147,43038,3109,6.7,143654,137071,6583,4.6
Tangipahoa,8/1/2001,46103,42896,3207,7,143284,136241,7042,4.9
Tangipahoa,9/1/2001,45848,42735,3113,6.8,143989,136846,7142,5
Tangipahoa,10/1/2001,46403,43151,3252,7,144086,136392,7694,5.3
Tangipahoa,11/1/2001,46094,42976,3118,6.8,144240,136238,8003,5.5
Tangipahoa,12/1/2001,46025,42912,3113,6.8,144305,136047,8258,5.7
Tangipahoa,1/1/2002,44804,41490,3314,7.4,143883,135701,8182,5.7
Tangipahoa,2/1/2002,45011,42176,2835,6.3,144653,136438,8215,5.7
Tangipahoa,3/1/2002,45163,42269,2894,6.4,144481,136177,8304,5.7
Tangipahoa,4/1/2002,45527,42558,2969,6.5,144725,136126,8599,5.9
Tangipahoa,5/1/2002,45328,42341,2987,6.6,144938,136539,8399,5.8
Tangipahoa,6/1/2002,46076,42423,3653,7.9,144808,136415,8393,5.8
Tangipahoa,7/1/2002,45708,42358,3350,7.3,144803,136413,8390,5.8
Tangipahoa,8/1/2002,46157,42735,3422,7.4,145009,136705,8304,5.7
Tangipahoa,9/1/2002,45933,42904,3029,6.6,145552,137302,8251,5.7
Tangipahoa,10/1/2002,46369,43500,2869,6.2,145314,137008,8307,5.7
Tangipahoa,11/1/2002,46097,43203,2894,6.3,145041,136521,8520,5.9
Tangipahoa,12/1/2002,46194,43093,3101,6.7,145066,136426,8640,6
Tangipahoa,1/1/2003,46114,42725,3389,7.3,145937,137417,8520,5.8
Tangipahoa,2/1/2003,46121,43177,2944,6.4,146100,137482,8618,5.9
Tangipahoa,3/1/2003,46391,43279,3112,6.7,146022,137434,8588,5.9
Tangipahoa,4/1/2003,46906,43874,3032,6.5,146474,137633,8842,6
Tangipahoa,5/1/2003,46769,43576,3193,6.8,146500,137544,8957,6.1
Tangipahoa,6/1/2003,47902,43751,4151,8.7,147056,137790,9266,6.3
Tangipahoa,7/1/2003,47619,43780,3839,8.1,146485,137474,9011,6.2
Tangipahoa,8/1/2003,47415,43875,3540,7.5,146445,137549,8896,6.1
Tangipahoa,9/1/2003,47181,43870,3311,7,146530,137609,8921,6.1
Tangipahoa,10/1/2003,47309,44266,3043,6.4,146716,137984,8732,6
Tangipahoa,11/1/2003,47238,44206,3032,6.4,147000,138424,8576,5.8
Tangipahoa,12/1/2003,46856,44009,2847,6.1,146729,138411,8317,5.7
Tangipahoa,1/1/2004,46970,43550,3420,7.3,146842,138472,8370,5.7
Tangipahoa,2/1/2004,46686,43777,2909,6.2,146709,138542,8167,5.6
Tangipahoa,3/1/2004,46702,43693,3009,6.4,146944,138453,8491,5.8
Tangipahoa,4/1/2004,47421,44390,3031,6.4,146850,138680,8170,5.6
Tangipahoa,5/1/2004,47387,44184,3203,6.8,147065,138852,8212,5.6
Tangipahoa,6/1/2004,48181,44338,3843,8,147460,139174,8286,5.6
Tangipahoa,7/1/2004,48489,44956,3533,7.3,147692,139556,8136,5.5
Tangipahoa,8/1/2004,48395,45238,3157,6.5,147564,139573,7990,5.4
Tangipahoa,9/1/2004,48158,45044,3114,6.5,147415,139487,7927,5.4
Tangipahoa,10/1/2004,48850,45898,2952,6,147793,139732,8061,5.5
Tangipahoa,11/1/2004,48595,45731,2864,5.9,148162,140231,7932,5.4
Tangipahoa,12/1/2004,48189,45360,2829,5.9,148059,140125,7934,5.4
Tangipahoa,1/1/2005,47580,44496,3084,6.5,148029,140245,7784,5.3
Tangipahoa,2/1/2005,47468,44764,2704,5.7,148364,140385,7980,5.4
Tangipahoa,3/1/2005,47764,45171,2593,5.4,148391,140654,7737,5.2
Tangipahoa,4/1/2005,48376,45850,2526,5.2,148926,141254,7672,5.2
Tangipahoa,5/1/2005,48190,45497,2693,5.6,149261,141609,7651,5.1
Tangipahoa,6/1/2005,48866,45535,3331,6.8,149238,141714,7524,5
Tangipahoa,7/1/2005,48946,45896,3050,6.2,149432,142026,7406,5
Tangipahoa,8/1/2005,48732,45896,2836,5.8,149779,142434,7345,4.9
Tangipahoa,9/1/2005,58886,46991,11895,20.2,149954,142401,7553,5
Tangipahoa,10/1/2005,58426,47812,10614,18.2,150001,142548,7453,5
Tangipahoa,11/1/2005,58112,47736,10376,17.9,150065,142499,7566,5
Tangipahoa,12/1/2005,51355,47434,3921,7.6,150030,142752,7279,4.9
Tangipahoa,1/1/2006,50242,47250,2992,6,150214,143150,7064,4.7
Tangipahoa,2/1/2006,49883,47534,2349,4.7,150641,143457,7184,4.8
Tangipahoa,3/1/2006,50735,48347,2388,4.7,150813,143741,7072,4.7
Tangipahoa,4/1/2006,50968,48636,2332,4.6,150881,143761,7120,4.7
Tangipahoa,5/1/2006,50890,48461,2429,4.8,151069,144089,6980,4.6
Tangipahoa,6/1/2006,52080,49191,2889,5.5,151354,144353,7001,4.6
Tangipahoa,7/1/2006,52241,49730,2511,4.8,151377,144202,7175,4.7
Tangipahoa,8/1/2006,52097,49708,2389,4.6,151716,144625,7091,4.7
Tangipahoa,9/1/2006,51747,49382,2365,4.6,151662,144815,6847,4.5
Tangipahoa,10/1/2006,52021,49785,2236,4.3,152041,145314,6727,4.4
Tangipahoa,11/1/2006,52069,49829,2240,4.3,152406,145534,6872,4.5
Tangipahoa,12/1/2006,51934,49752,2182,4.2,152732,145970,6762,4.4
Tangipahoa,1/1/2007,51811,49350,2461,4.7,153144,146028,7116,4.6
Tangipahoa,2/1/2007,51777,49687,2090,4,152983,146057,6927,4.5
Tangipahoa,3/1/2007,52229,50100,2129,4.1,153051,146320,6731,4.4
Tangipahoa,4/1/2007,51893,49769,2124,4.1,152435,145586,6850,4.5
Tangipahoa,5/1/2007,52076,49765,2311,4.4,152670,145903,6766,4.4
Tangipahoa,6/1/2007,53054,50218,2836,5.3,153041,146063,6979,4.6
Tangipahoa,7/1/2007,52744,50063,2681,5.1,153054,145905,7149,4.7
Tangipahoa,8/1/2007,52704,50310,2394,4.5,152749,145682,7067,4.6
Tangipahoa,9/1/2007,52885,50538,2347,4.4,153414,146244,7170,4.7
Tangipahoa,10/1/2007,52682,50625,2057,3.9,153183,145946,7237,4.7
Tangipahoa,11/1/2007,53269,51182,2087,3.9,153835,146595,7240,4.7
Tangipahoa,12/1/2007,53416,51068,2348,4.4,153918,146273,7645,5
Tangipahoa,1/1/2008,52514,49877,2637,5,154063,146378,7685,5
Tangipahoa,2/1/2008,52305,50176,2129,4.1,153653,146156,7497,4.9
Tangipahoa,3/1/2008,52790,50474,2316,4.4,153908,146086,7822,5.1
Tangipahoa,4/1/2008,52833,50763,2070,3.9,153769,146132,7637,5
Tangipahoa,5/1/2008,52589,50198,2391,4.5,154303,145908,8395,5.4
Tangipahoa,6/1/2008,53315,50201,3114,5.8,154313,145737,8575,5.6
Tangipahoa,7/1/2008,53211,50071,3140,5.9,154469,145532,8937,5.8
Tangipahoa,8/1/2008,53435,50375,3060,5.7,154641,145203,9438,6.1
Tangipahoa,9/1/2008,53745,50249,3496,6.5,154570,145076,9494,6.1
Tangipahoa,10/1/2008,53850,50672,3178,5.9,154876,144802,10074,6.5
Tangipahoa,11/1/2008,53721,50534,3187,5.9,154639,144100,10538,6.8
Tangipahoa,12/1/2008,52995,49577,3418,6.4,154655,143369,11286,7.3
Tangipahoa,1/1/2009,52628,48634,3994,7.6,154210,142152,12058,7.8
Tangipahoa,2/1/2009,52346,48805,3541,6.8,154538,141640,12898,8.3
Tangipahoa,3/1/2009,52840,49073,3767,7.1,154133,140707,13426,8.7
Tangipahoa,4/1/2009,53017,49415,3602,6.8,154509,140656,13853,9
Tangipahoa,5/1/2009,52974,49065,3909,7.4,154747,140248,14499,9.4
Tangipahoa,6/1/2009,53909,49253,4656,8.6,154716,140009,14707,9.5
Tangipahoa,7/1/2009,53788,49338,4450,8.3,154502,139901,14601,9.5
Tangipahoa,8/1/2009,53756,49590,4166,7.7,154307,139492,14814,9.6
Tangipahoa,9/1/2009,53188,49197,3991,7.5,153827,138818,15009,9.8
Tangipahoa,10/1/2009,52863,48993,3870,7.3,153784,138432,15352,10
Tangipahoa,11/1/2009,53192,49437,3755,7.1,153878,138659,15219,9.9
Tangipahoa,12/1/2009,52707,48683,4024,7.6,153111,138013,15098,9.9
Tangipahoa,1/1/2010,52180,47498,4682,9,153484,138438,15046,9.8
Tangipahoa,2/1/2010,52168,47957,4211,8.1,153694,138581,15113,9.8
Tangipahoa,3/1/2010,52897,48511,4386,8.3,153954,138751,15202,9.9
Tangipahoa,4/1/2010,53552,49194,4358,8.1,154622,139297,15325,9.9
Tangipahoa,5/1/2010,53760,48902,4858,9,154091,139241,14849,9.6
Tangipahoa,6/1/2010,54750,49192,5558,10.2,153616,139141,14474,9.4
Tangipahoa,7/1/2010,54596,49161,5435,10,153691,139179,14512,9.4
Tangipahoa,8/1/2010,54502,49227,5275,9.7,154086,139438,14648,9.5
Tangipahoa,9/1/2010,54176,49116,5060,9.3,153975,139396,14579,9.5
Tangipahoa,10/1/2010,54040,49175,4865,9,153635,139119,14516,9.4
Tangipahoa,11/1/2010,53987,49072,4915,9.1,154125,139044,15081,9.8
Tangipahoa,12/1/2010,53694,48825,4869,9.1,153650,139301,14348,9.3
Tangipahoa,1/1/2011,53170,47857,5313,10,153263,139250,14013,9.1
Tangipahoa,2/1/2011,53005,48164,4841,9.1,153214,139394,13820,9
Tangipahoa,3/1/2011,53005,48262,4743,8.9,153376,139639,13737,9
Tangipahoa,4/1/2011,53280,48811,4469,8.4,153543,139586,13957,9.1
Tangipahoa,5/1/2011,53364,48692,4672,8.8,153479,139624,13855,9
Tangipahoa,6/1/2011,53951,48484,5467,10.1,153346,139384,13962,9.1
Tangipahoa,7/1/2011,53655,48444,5211,9.7,153288,139524,13763,9
Tangipahoa,8/1/2011,53460,48436,5024,9.4,153760,139942,13818,9
Tangipahoa,9/1/2011,53816,48906,4910,9.1,154131,140183,13948,9
Tangipahoa,10/1/2011,53829,49219,4610,8.6,153961,140368,13594,8.8
Tangipahoa,11/1/2011,53881,49549,4332,8,154128,140826,13302,8.6
Tangipahoa,12/1/2011,53573,49215,4358,8.1,153995,140902,13093,8.5
Tangipahoa,1/1/2012,52651,47834,4817,9.1,154381,141584,12797,8.3
Tangipahoa,2/1/2012,52741,48341,4400,8.3,154671,141858,12813,8.3
Tangipahoa,3/1/2012,53079,48770,4309,8.1,154749,142036,12713,8.2
Tangipahoa,4/1/2012,53295,49261,4034,7.6,154545,141899,12646,8.2
Tangipahoa,5/1/2012,53776,49429,4347,8.1,154866,142206,12660,8.2
Tangipahoa,6/1/2012,54120,48966,5154,9.5,155083,142391,12692,8.2
Tangipahoa,7/1/2012,53679,48774,4905,9.1,154948,142292,12656,8.2
Tangipahoa,8/1/2012,53153,48794,4359,8.2,154763,142291,12471,8.1
Tangipahoa,9/1/2012,53079,49006,4073,7.7,155160,143044,12115,7.8
Tangipahoa,10/1/2012,53246,49385,3861,7.3,155554,143431,12124,7.8
Tangipahoa,11/1/2012,53222,49665,3557,6.7,155338,143333,12005,7.7
Tangipahoa,12/1/2012,53354,49520,3834,7.2,155628,143330,12298,7.9
Tangipahoa,1/1/2013,52714,48173,4541,8.6,155763,143292,12471,8
Tangipahoa,2/1/2013,52356,48377,3979,7.6,155312,143362,11950,7.7
Tangipahoa,3/1/2013,52474,48490,3984,7.6,155005,143316,11689,7.5
Tangipahoa,4/1/2013,52936,49023,3913,7.4,155394,143635,11760,7.6
Tangipahoa,5/1/2013,52999,48804,4195,7.9,155536,143882,11654,7.5
Tangipahoa,6/1/2013,53723,48814,4909,9.1,155749,143999,11751,7.5
Tangipahoa,7/1/2013,53641,49133,4508,8.4,155599,144264,11335,7.3
Tangipahoa,8/1/2013,53069,48856,4213,7.9,155605,144326,11279,7.2
Tangipahoa,9/1/2013,53358,49343,4015,7.5,155687,144418,11270,7.2
Tangipahoa,10/1/2013,52502,48786,3716,7.1,154673,143537,11136,7.2
Tangipahoa,11/1/2013,52651,49251,3400,6.5,155265,144479,10787,6.9
Tangipahoa,12/1/2013,52455,49162,3293,6.3,155182,144778,10404,6.7
Tangipahoa,1/1/2014,51948,48316,3632,7,155352,145150,10202,6.6
Tangipahoa,2/1/2014,52095,48769,3326,6.4,155483,145134,10349,6.7
Tangipahoa,3/1/2014,52682,49194,3488,6.6,156028,145648,10380,6.7
Tangipahoa,4/1/2014,52752,49453,3299,6.3,155369,145667,9702,6.2
Tangipahoa,5/1/2014,52973,49194,3779,7.1,155684,145825,9859,6.3
Tangipahoa,6/1/2014,53893,49385,4508,8.4,155707,146247,9460,6.1
Tangipahoa,7/1/2014,54279,49595,4684,8.6,156007,146399,9608,6.2
Tangipahoa,8/1/2014,54081,49602,4479,8.3,156130,146530,9599,6.1
Tangipahoa,9/1/2014,54332,50004,4328,8,156040,146778,9262,5.9
Tangipahoa,10/1/2014,54113,50037,4076,7.5,156417,147427,8990,5.7
Tangipahoa,11/1/2014,54258,50080,4178,7.7,156494,147404,9090,5.8
Tangipahoa,12/1/2014,54021,49987,4034,7.5,156332,147615,8717,5.6
Tangipahoa,1/1/2015,53617,49199,4418,8.2,157030,148145,8885,5.7
Tangipahoa,2/1/2015,53371,49412,3959,7.4,156644,148045,8599,5.5
Tangipahoa,3/1/2015,53746,49839,3907,7.3,156643,148128,8515,5.4
Tangipahoa,4/1/2015,54226,50449,3777,7,157060,148511,8550,5.4
Tangipahoa,5/1/2015,54316,50291,4025,7.4,157651,148817,8834,5.6
Tangipahoa,6/1/2015,54604,50247,4357,8,157062,148816,8247,5.3
Tangipahoa,7/1/2015,54505,50351,4154,7.6,156997,148830,8167,5.2
Tangipahoa,8/1/2015,53868,50036,3832,7.1,157172,149181,7992,5.1
Tangipahoa,9/1/2015,53682,49969,3713,6.9,156733,148826,7907,5
Tangipahoa,10/1/2015,53812,50304,3508,6.5,157167,149246,7922,5
Tangipahoa,11/1/2015,53908,50541,3367,6.2,157463,149463,8000,5.1
Tangipahoa,12/1/2015,53649,50391,3258,6.1,158035,150128,7907,5
Tangipahoa,1/1/2016,53434,49625,3809,7.1,158280,150653,7627,4.8
Tangipahoa,2/1/2016,53445,49957,3488,6.5,158640,150939,7702,4.9
Tangipahoa,3/1/2016,53804,50305,3499,6.5,159179,151218,7961,5
Tangipahoa,4/1/2016,53865,50459,3406,6.3,159141,151074,8067,5.1
Tangipahoa,5/1/2016,53983,50501,3482,6.5,158784,151132,7652,4.8
Tangipahoa,6/1/2016,54660,50392,4268,7.8,158967,151223,7744,4.9
Tangipahoa,7/1/2016,54584,50492,4092,7.5,159194,151554,7641,4.8
Tangipahoa,8/1/2016,54346,50531,3815,7,159562,151779,7784,4.9
Tangipahoa,9/1/2016,54715,50809,3906,7.1,159714,151761,7953,5
Tangipahoa,10/1/2016,54442,51038,3404,6.3,159605,151793,7811,4.9
Tangipahoa,11/1/2016,54373,51167,3206,5.9,159506,151954,7553,4.7
Tangipahoa,12/1/2016,54079,50847,3232,6,159678,152157,7521,4.7
Tangipahoa,1/1/2017,54054,50439,3615,6.7,159620,152152,7468,4.7
Tangipahoa,2/1/2017,54267,51038,3229,6,159859,152480,7379,4.6
Tangipahoa,3/1/2017,54625,51498,3127,5.7,160137,153065,7073,4.4
Tangipahoa,4/1/2017,54622,51552,3070,5.6,160345,153255,7089,4.4
Tangipahoa,5/1/2017,54522,51429,3093,5.7,160068,153069,7000,4.4
Tangipahoa,6/1/2017,55198,51537,3661,6.6,160192,153318,6873,4.3
Tangipahoa,7/1/2017,55171,51597,3574,6.5,160462,153569,6892,4.3
Tangipahoa,8/1/2017,54965,51612,3353,6.1,160586,153503,7082,4.4
Tangipahoa,9/1/2017,55117,52077,3040,5.5,161140,154286,6854,4.3
Tangipahoa,10/1/2017,54633,52101,2532,4.6,160309,153609,6700,4.2
Tangipahoa,11/1/2017,55035,52457,2578,4.7,160579,153805,6774,4.2
Tangipahoa,12/1/2017,54742,52195,2547,4.7,160535,153904,6632,4.1
Tangipahoa,1/1/2018,54044,51128,2916,5.4,160914,154425,6489,4
Tangipahoa,2/1/2018,54059,51368,2691,5,161778,155197,6581,4.1
Tangipahoa,3/1/2018,54265,51511,2754,5.1,161686,155214,6472,4
Tangipahoa,4/1/2018,54370,51633,2737,5,161771,155312,6459,4
Tangipahoa,5/1/2018,54169,51354,2815,5.2,161848,155652,6196,3.8
Tangipahoa,6/1/2018,55050,51261,3789,6.9,162210,155762,6447,4
Tangipahoa,7/1/2018,55104,51581,3523,6.4,162341,156146,6195,3.8
Tangipahoa,8/1/2018,54499,51306,3193,5.9,161660,155504,6156,3.8
Tangipahoa,9/1/2018,54361,51425,2936,5.4,162087,156015,6073,3.7
Tangipahoa,10/1/2018,54690,51932,2758,5,162602,156391,6211,3.8
Tangipahoa,11/1/2018,54851,52212,2639,4.8,162836,156721,6115,3.8
Tangipahoa,12/1/2018,54295,51480,2815,5.2,163206,156817,6389,3.9
Tangipahoa,1/1/2019,53757,50495,3262,6.1,162963,156487,6475,4
Tangipahoa,2/1/2019,53685,51021,2664,5,162999,156863,6136,3.8
Tangipahoa,3/1/2019,53960,51470,2490,4.6,162904,156701,6202,3.8
Tangipahoa,4/1/2019,54196,51878,2318,4.3,162586,156625,5961,3.7
Tangipahoa,5/1/2019,54044,51383,2661,4.9,162751,156821,5930,3.6
Tangipahoa,6/1/2019,54820,51365,3455,6.3,163168,157232,5935,3.6
Tangipahoa,7/1/2019,55085,51663,3422,6.2,163590,157529,6061,3.7
Tangipahoa,8/1/2019,54834,51727,3107,5.7,163774,157829,5945,3.6
Tangipahoa,9/1/2019,55263,52320,2943,5.3,164092,158339,5753,3.5
Tangipahoa,10/1/2019,55401,52490,2911,5.3,164416,158545,5871,3.6
Tangipahoa,11/1/2019,55900,53066,2834,5.1,164496,158629,5868,3.6
Tangipahoa,12/1/2019,55072,52306,2766,5,164699,158845,5853,3.6
Tangipahoa,1/1/2020,54835,51759,3076,5.6,164377,158508,5869,3.6
Tangipahoa,2/1/2020,54368,51984,2384,4.4,164467,158714,5753,3.5
Tangipahoa,3/1/2020,55752,51515,4237,7.6,162559,155353,7206,4.4
Tangipahoa,4/1/2020,52889,44751,8138,15.4,156269,133185,23084,14.8
Tangipahoa,5/1/2020,54657,46347,8310,15.2,158101,137173,20929,13.2
Tangipahoa,6/1/2020,56071,48253,7818,13.9,159994,142342,17652,11
Tangipahoa,7/1/2020,56443,49101,7342,13,160132,143779,16352,10.2
Tangipahoa,8/1/2020,56455,50564,5891,10.4,160706,147245,13461,8.4
Tangipahoa,9/1/2020,57290,51418,5872,10.2,160174,147620,12554,7.8
Tangipahoa,10/1/2020,57769,52670,5099,8.8,161003,149931,11072,6.9
Tangipahoa,11/1/2020,56752,52308,4444,7.8,160629,149934,10694,6.7
Tangipahoa,12/1/2020,55785,51302,4483,8,160745,149975,10770,6.7
Tangipahoa,1/1/2021,55329,50741,4588,8.3,160088,149852,10236,6.4
Tangipahoa,2/1/2021,55834,51628,4206,7.5,160184,150189,9995,6.2
Tangipahoa,3/1/2021,55924,51988,3936,7,160400,150644,9756,6.1
Tangipahoa,4/1/2021,55916,52030,3886,6.9,160843,151081,9762,6.1
Tangipahoa,5/1/2021,55722,51806,3916,7,160800,151535,9266,5.8
Tangipahoa,6/1/2021,56429,51835,4594,8.1,161197,151734,9462,5.9
Tangipahoa,7/1/2021,56976,52869,4107,7.2,161504,152773,8731,5.4
Tangipahoa,8/1/2021,55965,52425,3540,6.3,161527,153250,8276,5.1
Tangipahoa,9/1/2021,55154,51701,3453,6.3,161495,153843,7652,4.7
Tangipahoa,10/1/2021,55436,52664,2772,5,161754,154475,7279,4.5
Tangipahoa,11/1/2021,55793,53285,2508,4.5,162281,155530,6751,4.2
Tangipahoa,12/1/2021,55791,53541,2250,4,162497,156099,6398,3.9
Tangipahoa,1/1/2022,55742,52972,2770,5,163627,157115,6512,4
Tangipahoa,2/1/2022,56049,53564,2485,4.4,163899,157598,6301,3.8
Tangipahoa,3/1/2022,56235,53916,2319,4.1,164220,158206,6014,3.7
Tangipahoa,4/1/2022,56097,53947,2150,3.8,163893,157891,6002,3.7
Tangipahoa,5/1/2022,56131,53842,2289,4.1,164362,158378,5983,3.6
Tangipahoa,6/1/2022,56769,53727,3042,5.4,164046,158094,5951,3.6
Tangipahoa,7/1/2022,56531,53753,2778,4.9,164026,158258,5768,3.5
Tangipahoa,8/1/2022,56346,53750,2596,4.6,164654,158735,5919,3.6
Tangipahoa,9/1/2022,56513,54161,2352,4.2,164602,158810,5792,3.5
Tangipahoa,10/1/2022,56361,54212,2149,3.8,164648,158684,5964,3.6
Tangipahoa,11/1/2022,56512,54421,2091,3.7,164450,158507,5943,3.6
Tangipahoa,12/1/2022,56545,54396,2149,3.8,165025,159259,5766,3.5
Tangipahoa,1/1/2023,56223,53723,2500,4.4,165964,160217,5747,3.5
Tangipahoa,2/1/2023,56655,54320,2335,4.1,166358,160395,5962,3.6
Tangipahoa,3/1/2023,57313,55091,2222,3.9,166651,160812,5839,3.5
Tangipahoa,4/1/2023,57410,55375,2035,3.5,166725,160974,5751,3.4
Tangipahoa,5/1/2023,57157,54733,2424,4.2,166886,160796,6089,3.6
Tangipahoa,6/1/2023,57371,54417,2954,5.1,166937,160979,5958,3.6
Tangipahoa,7/1/2023,57365,54798,2567,4.5,167103,161183,5920,3.5
Tangipahoa,8/1/2023,57335,54664,2671,4.7,167759,161475,6284,3.7
Tangipahoa,9/1/2023,57451,54909,2542,4.4,167767,161442,6326,3.8
Tangipahoa,10/1/2023,57672,55142,2530,4.4,167690,161211,6479,3.9
Tangipahoa,11/1/2023,57738,55277,2461,4.3,168140,161886,6254,3.7
Tangipahoa,12/1/2023,57189,54667,2522,4.4,167439,161124,6315,3.8
Tangipahoa,1/1/2024,57255,54412,2843,5,167339,161190,6149,3.7
Tangipahoa,2/1/2024,57225,54515,2710,4.7,167475,161013,6462,3.9
Tangipahoa,3/1/2024,57588,54915,2673,4.6,167922,161425,6497,3.9
Tangipahoa,4/1/2024,57560,55138,2422,4.2,167988,161495,6492,3.9
Tangipahoa,5/1/2024,56920,54345,2575,4.5,167799,161164,6635,4
Tangipahoa,6/1/2024,58003,54625,3378,5.8,168005,161155,6849,4.1
Tangipahoa,7/1/2024,58664,55269,3395,5.8,168315,161219,7097,4.2
Tangipahoa,8/1/2024,58143,54867,3276,5.6,168496,161425,7071,4.2
Tangipahoa,9/1/2024,57936,54891,3045,5.3,168703,161802,6901,4.1
Tangipahoa,10/1/2024,58077,55075,3002,5.2,168428,161456,6972,4.1
Tangipahoa,11/1/2024,58239,55258,2981,5.1,168304,161183,7121,4.2
Tangipahoa,12/1/2024,57866,55074,2792,4.8,168547,161661,6886,4.1
Tangipahoa,1/1/2025,59980,57030,2950,4.9,170744,163895,6849,4
Tangipahoa,2/1/2025,60362,57597,2765,4.6,170359,163307,7052,4.1
Tensas,1/1/1990,2644,2352,292,11,125833,119081,6752,5.4
Tensas,2/1/1990,2501,2273,228,9.1,125710,119059,6651,5.3
Tensas,3/1/1990,2453,2285,168,6.8,125801,119203,6598,5.2
Tensas,4/1/1990,2539,2378,161,6.3,125649,118852,6797,5.4
Tensas,5/1/1990,2709,2548,161,5.9,125893,119151,6742,5.4
Tensas,6/1/1990,2735,2543,192,7,125573,118983,6590,5.2
Tensas,7/1/1990,2698,2501,197,7.3,125732,118810,6922,5.5
Tensas,8/1/1990,2738,2530,208,7.6,125990,118802,7188,5.7
Tensas,9/1/1990,2750,2572,178,6.5,125892,118524,7368,5.9
Tensas,10/1/1990,2687,2524,163,6.1,125995,118536,7459,5.9
Tensas,11/1/1990,2642,2432,210,7.9,126070,118306,7764,6.2
Tensas,12/1/1990,2508,2293,215,8.6,126142,118241,7901,6.3
Tensas,1/1/1991,2593,2251,342,13.2,125955,117940,8015,6.4
Tensas,2/1/1991,2657,2383,274,10.3,126020,117755,8265,6.6
Tensas,3/1/1991,2617,2403,214,8.2,126238,117652,8586,6.8
Tensas,4/1/1991,2660,2448,212,8,126548,118109,8439,6.7
Tensas,5/1/1991,2721,2479,242,8.9,126176,117440,8736,6.9
Tensas,6/1/1991,2837,2591,246,8.7,126331,117639,8692,6.9
Tensas,7/1/1991,2933,2674,259,8.8,126154,117568,8586,6.8
Tensas,8/1/1991,2792,2579,213,7.6,126150,117484,8666,6.9
Tensas,9/1/1991,2693,2476,217,8.1,126650,117928,8722,6.9
Tensas,10/1/1991,2833,2634,199,7,126642,117800,8842,7
Tensas,11/1/1991,2775,2577,198,7.1,126701,117770,8931,7
Tensas,12/1/1991,2697,2402,295,10.9,126664,117466,9198,7.3
Tensas,1/1/1992,2860,2501,359,12.6,127261,117978,9283,7.3
Tensas,2/1/1992,2949,2636,313,10.6,127207,117753,9454,7.4
Tensas,3/1/1992,2939,2692,247,8.4,127604,118144,9460,7.4
Tensas,4/1/1992,2925,2716,209,7.1,127841,118426,9415,7.4
Tensas,5/1/1992,2960,2758,202,6.8,128119,118375,9744,7.6
Tensas,6/1/1992,2953,2696,257,8.7,128459,118419,10040,7.8
Tensas,7/1/1992,3045,2821,224,7.4,128563,118713,9850,7.7
Tensas,8/1/1992,3001,2809,192,6.4,128613,118826,9787,7.6
Tensas,9/1/1992,3160,2960,200,6.3,128501,118720,9781,7.6
Tensas,10/1/1992,3092,2934,158,5.1,128026,118628,9398,7.3
Tensas,11/1/1992,3002,2821,181,6,128441,118876,9565,7.4
Tensas,12/1/1992,3018,2743,275,9.1,128554,118997,9557,7.4
Tensas,1/1/1993,3059,2690,369,12.1,128400,119075,9325,7.3
Tensas,2/1/1993,2968,2685,283,9.5,128458,119275,9183,7.1
Tensas,3/1/1993,3082,2808,274,8.9,128598,119542,9056,7
Tensas,4/1/1993,3103,2853,250,8.1,128584,119474,9110,7.1
Tensas,5/1/1993,3133,2894,239,7.6,129264,120115,9149,7.1
Tensas,6/1/1993,3173,2917,256,8.1,129411,120290,9121,7
Tensas,7/1/1993,3053,2838,215,7,129397,120467,8930,6.9
Tensas,8/1/1993,3098,2898,200,6.5,129619,120856,8763,6.8
Tensas,9/1/1993,3069,2876,193,6.3,129268,120554,8714,6.7
Tensas,10/1/1993,3110,2921,189,6.1,129573,120823,8750,6.8
Tensas,11/1/1993,2937,2736,201,6.8,129711,121169,8542,6.6
Tensas,12/1/1993,3079,2789,290,9.4,129941,121464,8477,6.5
Tensas,1/1/1994,3076,2715,361,11.7,130596,121966,8630,6.6
Tensas,2/1/1994,3118,2808,310,9.9,130669,122086,8583,6.6
Tensas,3/1/1994,3313,3017,296,8.9,130400,121930,8470,6.5
Tensas,4/1/1994,3266,3030,236,7.2,130621,122290,8331,6.4
Tensas,5/1/1994,3190,2928,262,8.2,130779,122864,7915,6.1
Tensas,6/1/1994,3088,2843,245,7.9,130561,122634,7927,6.1
Tensas,7/1/1994,3025,2787,238,7.9,130652,122706,7946,6.1
Tensas,8/1/1994,2988,2736,252,8.4,131275,123342,7933,6
Tensas,9/1/1994,3059,2841,218,7.1,131421,123687,7734,5.9
Tensas,10/1/1994,3230,3007,223,6.9,131744,124112,7632,5.8
Tensas,11/1/1994,3209,2972,237,7.4,131891,124516,7375,5.6
Tensas,12/1/1994,3118,2769,349,11.2,131951,124721,7230,5.5
Tensas,1/1/1995,3229,2826,403,12.5,132038,124663,7375,5.6
Tensas,2/1/1995,3118,2809,309,9.9,132115,124928,7187,5.4
Tensas,3/1/1995,3111,2795,316,10.2,132108,124955,7153,5.4
Tensas,4/1/1995,3087,2846,241,7.8,132590,124945,7645,5.8
Tensas,5/1/1995,3022,2808,214,7.1,131851,124421,7430,5.6
Tensas,6/1/1995,3255,2992,263,8.1,131949,124522,7427,5.6
Tensas,7/1/1995,3204,2962,242,7.6,132343,124816,7527,5.7
Tensas,8/1/1995,3131,2919,212,6.8,132336,124852,7484,5.7
Tensas,9/1/1995,3220,3020,200,6.2,132611,125133,7478,5.6
Tensas,10/1/1995,3294,3108,186,5.6,132716,125388,7328,5.5
Tensas,11/1/1995,3109,2840,269,8.7,132614,125188,7426,5.6
Tensas,12/1/1995,2934,2623,311,10.6,132511,125088,7423,5.6
Tensas,1/1/1996,3046,2671,375,12.3,132616,125125,7491,5.6
Tensas,2/1/1996,2955,2668,287,9.7,132952,125639,7313,5.5
Tensas,3/1/1996,2975,2734,241,8.1,133180,125862,7318,5.5
Tensas,4/1/1996,3147,2896,251,8,133409,125994,7415,5.6
Tensas,5/1/1996,2982,2733,249,8.4,133667,126244,7423,5.6
Tensas,6/1/1996,3091,2841,250,8.1,133697,126602,7095,5.3
Tensas,7/1/1996,3305,3053,252,7.6,134284,126947,7337,5.5
Tensas,8/1/1996,3010,2799,211,7,134054,127172,6882,5.1
Tensas,9/1/1996,3199,2954,245,7.7,134515,127536,6979,5.2
Tensas,10/1/1996,3049,2845,204,6.7,134921,127890,7031,5.2
Tensas,11/1/1996,2945,2688,257,8.7,135007,127771,7236,5.4
Tensas,12/1/1996,2830,2566,264,9.3,135113,127860,7253,5.4
Tensas,1/1/1997,2889,2517,372,12.9,135456,128298,7158,5.3
Tensas,2/1/1997,2927,2634,293,10,135400,128298,7102,5.2
Tensas,3/1/1997,2969,2691,278,9.4,135891,128891,7000,5.2
Tensas,4/1/1997,3045,2835,210,6.9,136016,129143,6873,5.1
Tensas,5/1/1997,2995,2796,199,6.6,136119,129464,6655,4.9
Tensas,6/1/1997,3225,2938,287,8.9,136211,129412,6799,5
Tensas,7/1/1997,3327,3090,237,7.1,136477,129822,6655,4.9
Tensas,8/1/1997,3111,2929,182,5.9,136618,130010,6608,4.8
Tensas,9/1/1997,3179,2975,204,6.4,136675,130019,6656,4.9
Tensas,10/1/1997,3055,2905,150,4.9,136633,130179,6454,4.7
Tensas,11/1/1997,3001,2798,203,6.8,136961,130653,6308,4.6
Tensas,12/1/1997,2882,2634,248,8.6,137155,130679,6476,4.7
Tensas,1/1/1998,3043,2739,304,10,137095,130726,6368,4.6
Tensas,2/1/1998,3016,2750,266,8.8,137112,130807,6306,4.6
Tensas,3/1/1998,3006,2726,280,9.3,137236,130814,6422,4.7
Tensas,4/1/1998,3050,2775,275,9,137150,131209,5941,4.3
Tensas,5/1/1998,3066,2796,270,8.8,137372,131325,6047,4.4
Tensas,6/1/1998,3154,2887,267,8.5,137455,131244,6212,4.5
Tensas,7/1/1998,3081,2881,200,6.5,137588,131329,6259,4.5
Tensas,8/1/1998,3143,2926,217,6.9,137570,131390,6179,4.5
Tensas,9/1/1998,3099,2889,210,6.8,138286,131986,6300,4.6
Tensas,10/1/1998,3063,2899,164,5.4,138279,131999,6280,4.5
Tensas,11/1/1998,3002,2821,181,6,138381,132280,6100,4.4
Tensas,12/1/1998,2972,2755,217,7.3,138634,132602,6032,4.4
Tensas,1/1/1999,2965,2663,302,10.2,139003,133027,5976,4.3
Tensas,2/1/1999,2810,2558,252,9,138967,132856,6111,4.4
Tensas,3/1/1999,2856,2639,217,7.6,138730,132947,5783,4.2
Tensas,4/1/1999,2928,2764,164,5.6,138959,132955,6004,4.3
Tensas,5/1/1999,2989,2819,170,5.7,139107,133311,5796,4.2
Tensas,6/1/1999,3064,2884,180,5.9,139329,133378,5951,4.3
Tensas,7/1/1999,3345,3159,186,5.6,139439,133414,6025,4.3
Tensas,8/1/1999,3340,3178,162,4.9,139430,133591,5838,4.2
Tensas,9/1/1999,3210,3050,160,5,139622,133707,5915,4.2
Tensas,10/1/1999,3270,3107,163,5,139771,133993,5778,4.1
Tensas,11/1/1999,3283,3077,206,6.3,140025,134309,5716,4.1
Tensas,12/1/1999,2981,2780,201,6.7,140177,134523,5653,4
Tensas,1/1/2000,2408,2202,206,8.6,142267,136559,5708,4
Tensas,2/1/2000,2313,2127,186,8,142456,136598,5858,4.1
Tensas,3/1/2000,2373,2181,192,8.1,142434,136701,5733,4
Tensas,4/1/2000,2427,2263,164,6.8,142751,137270,5481,3.8
Tensas,5/1/2000,2410,2230,180,7.5,142388,136630,5758,4
Tensas,6/1/2000,2441,2238,203,8.3,142591,136940,5651,4
Tensas,7/1/2000,2585,2406,179,6.9,142278,136531,5747,4
Tensas,8/1/2000,2599,2416,183,7,142514,136662,5853,4.1
Tensas,9/1/2000,2621,2459,162,6.2,142518,136893,5625,3.9
Tensas,10/1/2000,2524,2364,160,6.3,142622,137088,5534,3.9
Tensas,11/1/2000,2433,2250,183,7.5,142962,137322,5639,3.9
Tensas,12/1/2000,2484,2291,193,7.8,143248,137614,5634,3.9
Tensas,1/1/2001,2212,1975,237,10.7,143800,137778,6023,4.2
Tensas,2/1/2001,2215,2010,205,9.3,143701,137612,6089,4.2
Tensas,3/1/2001,2353,2118,235,10,143924,137783,6141,4.3
Tensas,4/1/2001,2221,2042,179,8.1,143569,137299,6271,4.4
Tensas,5/1/2001,2191,2020,171,7.8,143318,137092,6226,4.3
Tensas,6/1/2001,2232,2031,201,9,143357,136873,6484,4.5
Tensas,7/1/2001,2195,2025,170,7.7,143654,137071,6583,4.6
Tensas,8/1/2001,2204,2037,167,7.6,143284,136241,7042,4.9
Tensas,9/1/2001,2256,2083,173,7.7,143989,136846,7142,5
Tensas,10/1/2001,2409,2235,174,7.2,144086,136392,7694,5.3
Tensas,11/1/2001,2300,2121,179,7.8,144240,136238,8003,5.5
Tensas,12/1/2001,2257,2037,220,9.7,144305,136047,8258,5.7
Tensas,1/1/2002,2327,2059,268,11.5,143883,135701,8182,5.7
Tensas,2/1/2002,2241,2020,221,9.9,144653,136438,8215,5.7
Tensas,3/1/2002,2299,2072,227,9.9,144481,136177,8304,5.7
Tensas,4/1/2002,2225,2025,200,9,144725,136126,8599,5.9
Tensas,5/1/2002,2303,2117,186,8.1,144938,136539,8399,5.8
Tensas,6/1/2002,2241,2039,202,9,144808,136415,8393,5.8
Tensas,7/1/2002,2296,2111,185,8.1,144803,136413,8390,5.8
Tensas,8/1/2002,2316,2135,181,7.8,145009,136705,8304,5.7
Tensas,9/1/2002,2313,2141,172,7.4,145552,137302,8251,5.7
Tensas,10/1/2002,2464,2306,158,6.4,145314,137008,8307,5.7
Tensas,11/1/2002,2408,2233,175,7.3,145041,136521,8520,5.9
Tensas,12/1/2002,2420,2239,181,7.5,145066,136426,8640,6
Tensas,1/1/2003,2436,2178,258,10.6,145937,137417,8520,5.8
Tensas,2/1/2003,2295,2070,225,9.8,146100,137482,8618,5.9
Tensas,3/1/2003,2352,2106,246,10.5,146022,137434,8588,5.9
Tensas,4/1/2003,2380,2165,215,9,146474,137633,8842,6
Tensas,5/1/2003,2353,2153,200,8.5,146500,137544,8957,6.1
Tensas,6/1/2003,2430,2178,252,10.4,147056,137790,9266,6.3
Tensas,7/1/2003,2383,2154,229,9.6,146485,137474,9011,6.2
Tensas,8/1/2003,2488,2273,215,8.6,146445,137549,8896,6.1
Tensas,9/1/2003,2440,2243,197,8.1,146530,137609,8921,6.1
Tensas,10/1/2003,2560,2381,179,7,146716,137984,8732,6
Tensas,11/1/2003,2500,2315,185,7.4,147000,138424,8576,5.8
Tensas,12/1/2003,2354,2150,204,8.7,146729,138411,8317,5.7
Tensas,1/1/2004,2329,2095,234,10,146842,138472,8370,5.7
Tensas,2/1/2004,2239,2042,197,8.8,146709,138542,8167,5.6
Tensas,3/1/2004,2184,1985,199,9.1,146944,138453,8491,5.8
Tensas,4/1/2004,2202,2023,179,8.1,146850,138680,8170,5.6
Tensas,5/1/2004,2186,2010,176,8.1,147065,138852,8212,5.6
Tensas,6/1/2004,2213,2014,199,9,147460,139174,8286,5.6
Tensas,7/1/2004,2310,2132,178,7.7,147692,139556,8136,5.5
Tensas,8/1/2004,2330,2166,164,7,147564,139573,7990,5.4
Tensas,9/1/2004,2319,2156,163,7,147415,139487,7927,5.4
Tensas,10/1/2004,2369,2199,170,7.2,147793,139732,8061,5.5
Tensas,11/1/2004,2330,2149,181,7.8,148162,140231,7932,5.4
Tensas,12/1/2004,2201,2000,201,9.1,148059,140125,7934,5.4
Tensas,1/1/2005,2164,1920,244,11.3,148029,140245,7784,5.3
Tensas,2/1/2005,2039,1824,215,10.5,148364,140385,7980,5.4
Tensas,3/1/2005,2007,1803,204,10.2,148391,140654,7737,5.2
Tensas,4/1/2005,2144,1951,193,9,148926,141254,7672,5.2
Tensas,5/1/2005,2177,2007,170,7.8,149261,141609,7651,5.1
Tensas,6/1/2005,2249,2045,204,9.1,149238,141714,7524,5
Tensas,7/1/2005,2269,2074,195,8.6,149432,142026,7406,5
Tensas,8/1/2005,2191,2010,181,8.3,149779,142434,7345,4.9
Tensas,9/1/2005,2885,2173,712,24.7,149954,142401,7553,5
Tensas,10/1/2005,2875,2247,628,21.8,150001,142548,7453,5
Tensas,11/1/2005,2624,2035,589,22.4,150065,142499,7566,5
Tensas,12/1/2005,2254,1928,326,14.5,150030,142752,7279,4.9
Tensas,1/1/2006,2397,2146,251,10.5,150214,143150,7064,4.7
Tensas,2/1/2006,2334,2133,201,8.6,150641,143457,7184,4.8
Tensas,3/1/2006,2358,2174,184,7.8,150813,143741,7072,4.7
Tensas,4/1/2006,2438,2250,188,7.7,150881,143761,7120,4.7
Tensas,5/1/2006,2298,2123,175,7.6,151069,144089,6980,4.6
Tensas,6/1/2006,2313,2121,192,8.3,151354,144353,7001,4.6
Tensas,7/1/2006,2328,2170,158,6.8,151377,144202,7175,4.7
Tensas,8/1/2006,2335,2183,152,6.5,151716,144625,7091,4.7
Tensas,9/1/2006,2423,2280,143,5.9,151662,144815,6847,4.5
Tensas,10/1/2006,2406,2273,133,5.5,152041,145314,6727,4.4
Tensas,11/1/2006,2378,2234,144,6.1,152406,145534,6872,4.5
Tensas,12/1/2006,2172,2018,154,7.1,152732,145970,6762,4.4
Tensas,1/1/2007,2195,2007,188,8.6,153144,146028,7116,4.6
Tensas,2/1/2007,2268,2094,174,7.7,152983,146057,6927,4.5
Tensas,3/1/2007,2213,2057,156,7,153051,146320,6731,4.4
Tensas,4/1/2007,2216,2058,158,7.1,152435,145586,6850,4.5
Tensas,5/1/2007,2098,1949,149,7.1,152670,145903,6766,4.4
Tensas,6/1/2007,2079,1908,171,8.2,153041,146063,6979,4.6
Tensas,7/1/2007,2118,1949,169,8,153054,145905,7149,4.7
Tensas,8/1/2007,2198,2049,149,6.8,152749,145682,7067,4.6
Tensas,9/1/2007,2350,2196,154,6.6,153414,146244,7170,4.7
Tensas,10/1/2007,2339,2202,137,5.9,153183,145946,7237,4.7
Tensas,11/1/2007,2317,2177,140,6,153835,146595,7240,4.7
Tensas,12/1/2007,2214,2038,176,7.9,153918,146273,7645,5
Tensas,1/1/2008,2228,2041,187,8.4,154063,146378,7685,5
Tensas,2/1/2008,2200,2032,168,7.6,153653,146156,7497,4.9
Tensas,3/1/2008,2341,2175,166,7.1,153908,146086,7822,5.1
Tensas,4/1/2008,2195,2042,153,7,153769,146132,7637,5
Tensas,5/1/2008,2112,1962,150,7.1,154303,145908,8395,5.4
Tensas,6/1/2008,2051,1862,189,9.2,154313,145737,8575,5.6
Tensas,7/1/2008,2081,1881,200,9.6,154469,145532,8937,5.8
Tensas,8/1/2008,2101,1928,173,8.2,154641,145203,9438,6.1
Tensas,9/1/2008,2036,1879,157,7.7,154570,145076,9494,6.1
Tensas,10/1/2008,2094,1933,161,7.7,154876,144802,10074,6.5
Tensas,11/1/2008,2107,1936,171,8.1,154639,144100,10538,6.8
Tensas,12/1/2008,1911,1723,188,9.8,154655,143369,11286,7.3
Tensas,1/1/2009,1993,1746,247,12.4,154210,142152,12058,7.8
Tensas,2/1/2009,2018,1783,235,11.6,154538,141640,12898,8.3
Tensas,3/1/2009,2054,1817,237,11.5,154133,140707,13426,8.7
Tensas,4/1/2009,2058,1845,213,10.3,154509,140656,13853,9
Tensas,5/1/2009,2170,1961,209,9.6,154747,140248,14499,9.4
Tensas,6/1/2009,2159,1885,274,12.7,154716,140009,14707,9.5
Tensas,7/1/2009,2132,1820,312,14.6,154502,139901,14601,9.5
Tensas,8/1/2009,1998,1743,255,12.8,154307,139492,14814,9.6
Tensas,9/1/2009,1935,1692,243,12.6,153827,138818,15009,9.8
Tensas,10/1/2009,2071,1847,224,10.8,153784,138432,15352,10
Tensas,11/1/2009,2112,1885,227,10.7,153878,138659,15219,9.9
Tensas,12/1/2009,2067,1818,249,12,153111,138013,15098,9.9
Tensas,1/1/2010,1963,1672,291,14.8,153484,138438,15046,9.8
Tensas,2/1/2010,2071,1795,276,13.3,153694,138581,15113,9.8
Tensas,3/1/2010,2104,1837,267,12.7,153954,138751,15202,9.9
Tensas,4/1/2010,2113,1860,253,12,154622,139297,15325,9.9
Tensas,5/1/2010,2138,1872,266,12.4,154091,139241,14849,9.6
Tensas,6/1/2010,2131,1838,293,13.7,153616,139141,14474,9.4
Tensas,7/1/2010,2220,1928,292,13.2,153691,139179,14512,9.4
Tensas,8/1/2010,2199,1929,270,12.3,154086,139438,14648,9.5
Tensas,9/1/2010,2196,1926,270,12.3,153975,139396,14579,9.5
Tensas,10/1/2010,2170,1914,256,11.8,153635,139119,14516,9.4
Tensas,11/1/2010,2076,1805,271,13.1,154125,139044,15081,9.8
Tensas,12/1/2010,2003,1728,275,13.7,153650,139301,14348,9.3
Tensas,1/1/2011,1931,1644,287,14.9,153263,139250,14013,9.1
Tensas,2/1/2011,1958,1691,267,13.6,153214,139394,13820,9
Tensas,3/1/2011,1914,1650,264,13.8,153376,139639,13737,9
Tensas,4/1/2011,1955,1727,228,11.7,153543,139586,13957,9.1
Tensas,5/1/2011,2004,1770,234,11.7,153479,139624,13855,9
Tensas,6/1/2011,2009,1746,263,13.1,153346,139384,13962,9.1
Tensas,7/1/2011,2049,1794,255,12.4,153288,139524,13763,9
Tensas,8/1/2011,2051,1826,225,11,153760,139942,13818,9
Tensas,9/1/2011,2017,1794,223,11.1,154131,140183,13948,9
Tensas,10/1/2011,2007,1781,226,11.3,153961,140368,13594,8.8
Tensas,11/1/2011,1959,1746,213,10.9,154128,140826,13302,8.6
Tensas,12/1/2011,1931,1719,212,11,153995,140902,13093,8.5
Tensas,1/1/2012,1850,1618,232,12.5,154381,141584,12797,8.3
Tensas,2/1/2012,1887,1687,200,10.6,154671,141858,12813,8.3
Tensas,3/1/2012,1835,1636,199,10.8,154749,142036,12713,8.2
Tensas,4/1/2012,1709,1529,180,10.5,154545,141899,12646,8.2
Tensas,5/1/2012,1768,1583,185,10.5,154866,142206,12660,8.2
Tensas,6/1/2012,1789,1572,217,12.1,155083,142391,12692,8.2
Tensas,7/1/2012,1933,1717,216,11.2,154948,142292,12656,8.2
Tensas,8/1/2012,1873,1696,177,9.5,154763,142291,12471,8.1
Tensas,9/1/2012,1820,1657,163,9,155160,143044,12115,7.8
Tensas,10/1/2012,1819,1668,151,8.3,155554,143431,12124,7.8
Tensas,11/1/2012,1791,1642,149,8.3,155338,143333,12005,7.7
Tensas,12/1/2012,1772,1604,168,9.5,155628,143330,12298,7.9
Tensas,1/1/2013,1742,1552,190,10.9,155763,143292,12471,8
Tensas,2/1/2013,1708,1548,160,9.4,155312,143362,11950,7.7
Tensas,3/1/2013,1638,1477,161,9.8,155005,143316,11689,7.5
Tensas,4/1/2013,1656,1506,150,9.1,155394,143635,11760,7.6
Tensas,5/1/2013,1745,1578,167,9.6,155536,143882,11654,7.5
Tensas,6/1/2013,1788,1590,198,11.1,155749,143999,11751,7.5
Tensas,7/1/2013,1902,1711,191,10,155599,144264,11335,7.3
Tensas,8/1/2013,1873,1724,149,8,155605,144326,11279,7.2
Tensas,9/1/2013,1856,1711,145,7.8,155687,144418,11270,7.2
Tensas,10/1/2013,1776,1641,135,7.6,154673,143537,11136,7.2
Tensas,11/1/2013,1771,1642,129,7.3,155265,144479,10787,6.9
Tensas,12/1/2013,1717,1592,125,7.3,155182,144778,10404,6.7
Tensas,1/1/2014,1721,1580,141,8.2,155352,145150,10202,6.6
Tensas,2/1/2014,1750,1614,136,7.8,155483,145134,10349,6.7
Tensas,3/1/2014,1669,1530,139,8.3,156028,145648,10380,6.7
Tensas,4/1/2014,1668,1542,126,7.6,155369,145667,9702,6.2
Tensas,5/1/2014,1667,1507,160,9.6,155684,145825,9859,6.3
Tensas,6/1/2014,1785,1593,192,10.8,155707,146247,9460,6.1
Tensas,7/1/2014,1848,1652,196,10.6,156007,146399,9608,6.2
Tensas,8/1/2014,1846,1669,177,9.6,156130,146530,9599,6.1
Tensas,9/1/2014,1885,1707,178,9.4,156040,146778,9262,5.9
Tensas,10/1/2014,1836,1663,173,9.4,156417,147427,8990,5.7
Tensas,11/1/2014,1804,1634,170,9.4,156494,147404,9090,5.8
Tensas,12/1/2014,1818,1639,179,9.8,156332,147615,8717,5.6
Tensas,1/1/2015,1719,1524,195,11.3,157030,148145,8885,5.7
Tensas,2/1/2015,1710,1528,182,10.6,156644,148045,8599,5.5
Tensas,3/1/2015,1671,1500,171,10.2,156643,148128,8515,5.4
Tensas,4/1/2015,1650,1490,160,9.7,157060,148511,8550,5.4
Tensas,5/1/2015,1680,1512,168,10,157651,148817,8834,5.6
Tensas,6/1/2015,1796,1603,193,10.7,157062,148816,8247,5.3
Tensas,7/1/2015,1790,1596,194,10.8,156997,148830,8167,5.2
Tensas,8/1/2015,1744,1589,155,8.9,157172,149181,7992,5.1
Tensas,9/1/2015,1739,1590,149,8.6,156733,148826,7907,5
Tensas,10/1/2015,1700,1563,137,8.1,157167,149246,7922,5
Tensas,11/1/2015,1655,1517,138,8.3,157463,149463,8000,5.1
Tensas,12/1/2015,1645,1506,139,8.4,158035,150128,7907,5
Tensas,1/1/2016,1666,1507,159,9.5,158280,150653,7627,4.8
Tensas,2/1/2016,1652,1499,153,9.3,158640,150939,7702,4.9
Tensas,3/1/2016,1652,1494,158,9.6,159179,151218,7961,5
Tensas,4/1/2016,1597,1437,160,10,159141,151074,8067,5.1
Tensas,5/1/2016,1654,1496,158,9.6,158784,151132,7652,4.8
Tensas,6/1/2016,1727,1537,190,11,158967,151223,7744,4.9
Tensas,7/1/2016,1685,1497,188,11.2,159194,151554,7641,4.8
Tensas,8/1/2016,1659,1492,167,10.1,159562,151779,7784,4.9
Tensas,9/1/2016,1638,1476,162,9.9,159714,151761,7953,5
Tensas,10/1/2016,1558,1412,146,9.4,159605,151793,7811,4.9
Tensas,11/1/2016,1535,1407,128,8.3,159506,151954,7553,4.7
Tensas,12/1/2016,1481,1346,135,9.1,159678,152157,7521,4.7
Tensas,1/1/2017,1553,1395,158,10.2,159620,152152,7468,4.7
Tensas,2/1/2017,1537,1387,150,9.8,159859,152480,7379,4.6
Tensas,3/1/2017,1558,1420,138,8.9,160137,153065,7073,4.4
Tensas,4/1/2017,1575,1445,130,8.3,160345,153255,7089,4.4
Tensas,5/1/2017,1658,1516,142,8.6,160068,153069,7000,4.4
Tensas,6/1/2017,1709,1557,152,8.9,160192,153318,6873,4.3
Tensas,7/1/2017,1643,1488,155,9.4,160462,153569,6892,4.3
Tensas,8/1/2017,1545,1411,134,8.7,160586,153503,7082,4.4
Tensas,9/1/2017,1488,1367,121,8.1,161140,154286,6854,4.3
Tensas,10/1/2017,1448,1352,96,6.6,160309,153609,6700,4.2
Tensas,11/1/2017,1449,1350,99,6.8,160579,153805,6774,4.2
Tensas,12/1/2017,1434,1337,97,6.8,160535,153904,6632,4.1
Tensas,1/1/2018,1424,1314,110,7.7,160914,154425,6489,4
Tensas,2/1/2018,1440,1333,107,7.4,161778,155197,6581,4.1
Tensas,3/1/2018,1455,1348,107,7.4,161686,155214,6472,4
Tensas,4/1/2018,1448,1333,115,7.9,161771,155312,6459,4
Tensas,5/1/2018,1488,1378,110,7.4,161848,155652,6196,3.8
Tensas,6/1/2018,1539,1385,154,10,162210,155762,6447,4
Tensas,7/1/2018,1527,1386,141,9.2,162341,156146,6195,3.8
Tensas,8/1/2018,1476,1360,116,7.9,161660,155504,6156,3.8
Tensas,9/1/2018,1413,1309,104,7.4,162087,156015,6073,3.7
Tensas,10/1/2018,1403,1314,89,6.3,162602,156391,6211,3.8
Tensas,11/1/2018,1355,1276,79,5.8,162836,156721,6115,3.8
Tensas,12/1/2018,1344,1260,84,6.3,163206,156817,6389,3.9
Tensas,1/1/2019,1335,1230,105,7.9,162963,156487,6475,4
Tensas,2/1/2019,1371,1274,97,7.1,162999,156863,6136,3.8
Tensas,3/1/2019,1356,1269,87,6.4,162904,156701,6202,3.8
Tensas,4/1/2019,1337,1241,96,7.2,162586,156625,5961,3.7
Tensas,5/1/2019,1379,1271,108,7.8,162751,156821,5930,3.6
Tensas,6/1/2019,1420,1274,146,10.3,163168,157232,5935,3.6
Tensas,7/1/2019,1415,1263,152,10.7,163590,157529,6061,3.7
Tensas,8/1/2019,1480,1353,127,8.6,163774,157829,5945,3.6
Tensas,9/1/2019,1471,1364,107,7.3,164092,158339,5753,3.5
Tensas,10/1/2019,1413,1307,106,7.5,164416,158545,5871,3.6
Tensas,11/1/2019,1348,1236,112,8.3,164496,158629,5868,3.6
Tensas,12/1/2019,1341,1242,99,7.4,164699,158845,5853,3.6
Tensas,1/1/2020,1309,1191,118,9,164377,158508,5869,3.6
Tensas,2/1/2020,1337,1232,105,7.9,164467,158714,5753,3.5
Tensas,3/1/2020,1443,1254,189,13.1,162559,155353,7206,4.4
Tensas,4/1/2020,1245,1143,102,8.2,156269,133185,23084,14.8
Tensas,5/1/2020,1280,1157,123,9.6,158101,137173,20929,13.2
Tensas,6/1/2020,1330,1184,146,11,159994,142342,17652,11
Tensas,7/1/2020,1292,1158,134,10.4,160132,143779,16352,10.2
Tensas,8/1/2020,1362,1251,111,8.1,160706,147245,13461,8.4
Tensas,9/1/2020,1386,1272,114,8.2,160174,147620,12554,7.8
Tensas,10/1/2020,1380,1281,99,7.2,161003,149931,11072,6.9
Tensas,11/1/2020,1301,1211,90,6.9,160629,149934,10694,6.7
Tensas,12/1/2020,1327,1236,91,6.9,160745,149975,10770,6.7
Tensas,1/1/2021,1325,1230,95,7.2,160088,149852,10236,6.4
Tensas,2/1/2021,1319,1222,97,7.4,160184,150189,9995,6.2
Tensas,3/1/2021,1317,1220,97,7.4,160400,150644,9756,6.1
Tensas,4/1/2021,1342,1260,82,6.1,160843,151081,9762,6.1
Tensas,5/1/2021,1315,1230,85,6.5,160800,151535,9266,5.8
Tensas,6/1/2021,1342,1244,98,7.3,161197,151734,9462,5.9
Tensas,7/1/2021,1277,1187,90,7,161504,152773,8731,5.4
Tensas,8/1/2021,1278,1204,74,5.8,161527,153250,8276,5.1
Tensas,9/1/2021,1339,1273,66,4.9,161495,153843,7652,4.7
Tensas,10/1/2021,1328,1264,64,4.8,161754,154475,7279,4.5
Tensas,11/1/2021,1268,1209,59,4.7,162281,155530,6751,4.2
Tensas,12/1/2021,1274,1221,53,4.2,162497,156099,6398,3.9
Tensas,1/1/2022,1283,1212,71,5.5,163627,157115,6512,4
Tensas,2/1/2022,1296,1237,59,4.6,163899,157598,6301,3.8
Tensas,3/1/2022,1295,1237,58,4.5,164220,158206,6014,3.7
Tensas,4/1/2022,1330,1273,57,4.3,163893,157891,6002,3.7
Tensas,5/1/2022,1327,1264,63,4.7,164362,158378,5983,3.6
Tensas,6/1/2022,1344,1266,78,5.8,164046,158094,5951,3.6
Tensas,7/1/2022,1374,1291,83,6,164026,158258,5768,3.5
Tensas,8/1/2022,1303,1236,67,5.1,164654,158735,5919,3.6
Tensas,9/1/2022,1309,1243,66,5,164602,158810,5792,3.5
Tensas,10/1/2022,1268,1208,60,4.7,164648,158684,5964,3.6
Tensas,11/1/2022,1234,1176,58,4.7,164450,158507,5943,3.6
Tensas,12/1/2022,1245,1186,59,4.7,165025,159259,5766,3.5
Tensas,1/1/2023,1290,1219,71,5.5,165964,160217,5747,3.5
Tensas,2/1/2023,1289,1218,71,5.5,166358,160395,5962,3.6
Tensas,3/1/2023,1291,1228,63,4.9,166651,160812,5839,3.5
Tensas,4/1/2023,1308,1254,54,4.1,166725,160974,5751,3.4
Tensas,5/1/2023,1315,1251,64,4.9,166886,160796,6089,3.6
Tensas,6/1/2023,1383,1286,97,7,166937,160979,5958,3.6
Tensas,7/1/2023,1365,1283,82,6,167103,161183,5920,3.5
Tensas,8/1/2023,1304,1242,62,4.8,167759,161475,6284,3.7
Tensas,9/1/2023,1348,1280,68,5,167767,161442,6326,3.8
Tensas,10/1/2023,1315,1251,64,4.9,167690,161211,6479,3.9
Tensas,11/1/2023,1306,1244,62,4.7,168140,161886,6254,3.7
Tensas,12/1/2023,1317,1249,68,5.2,167439,161124,6315,3.8
Tensas,1/1/2024,1327,1244,83,6.3,167339,161190,6149,3.7
Tensas,2/1/2024,1253,1173,80,6.4,167475,161013,6462,3.9
Tensas,3/1/2024,1280,1194,86,6.7,167922,161425,6497,3.9
Tensas,4/1/2024,1295,1221,74,5.7,167988,161495,6492,3.9
Tensas,5/1/2024,1287,1203,84,6.5,167799,161164,6635,4
Tensas,6/1/2024,1405,1277,128,9.1,168005,161155,6849,4.1
Tensas,7/1/2024,1409,1283,126,8.9,168315,161219,7097,4.2
Tensas,8/1/2024,1374,1270,104,7.6,168496,161425,7071,4.2
Tensas,9/1/2024,1377,1281,96,7,168703,161802,6901,4.1
Tensas,10/1/2024,1360,1262,98,7.2,168428,161456,6972,4.1
Tensas,11/1/2024,1305,1204,101,7.7,168304,161183,7121,4.2
Tensas,12/1/2024,1301,1213,88,6.8,168547,161661,6886,4.1
Tensas,1/1/2025,1119,1021,98,8.8,170744,163895,6849,4
Tensas,2/1/2025,1072,984,88,8.2,170359,163307,7052,4.1
Terrebonne,1/1/1990,38498,36587,1911,5,125833,119081,6752,5.4
Terrebonne,2/1/1990,38643,36815,1828,4.7,125710,119059,6651,5.3
Terrebonne,3/1/1990,39106,37349,1757,4.5,125801,119203,6598,5.2
Terrebonne,4/1/1990,39761,37951,1810,4.6,125649,118852,6797,5.4
Terrebonne,5/1/1990,39672,38192,1480,3.7,125893,119151,6742,5.4
Terrebonne,6/1/1990,40869,39142,1727,4.2,125573,118983,6590,5.2
Terrebonne,7/1/1990,41466,39739,1727,4.2,125732,118810,6922,5.5
Terrebonne,8/1/1990,41045,39097,1948,4.7,125990,118802,7188,5.7
Terrebonne,9/1/1990,40204,38301,1903,4.7,125892,118524,7368,5.9
Terrebonne,10/1/1990,40893,39135,1758,4.3,125995,118536,7459,5.9
Terrebonne,11/1/1990,40805,39088,1717,4.2,126070,118306,7764,6.2
Terrebonne,12/1/1990,40752,38982,1770,4.3,126142,118241,7901,6.3
Terrebonne,1/1/1991,40075,37982,2093,5.2,125955,117940,8015,6.4
Terrebonne,2/1/1991,40776,38427,2349,5.8,126020,117755,8265,6.6
Terrebonne,3/1/1991,41103,38842,2261,5.5,126238,117652,8586,6.8
Terrebonne,4/1/1991,41397,39110,2287,5.5,126548,118109,8439,6.7
Terrebonne,5/1/1991,40874,38999,1875,4.6,126176,117440,8736,6.9
Terrebonne,6/1/1991,42005,39821,2184,5.2,126331,117639,8692,6.9
Terrebonne,7/1/1991,42158,40052,2106,5,126154,117568,8586,6.8
Terrebonne,8/1/1991,41779,39541,2238,5.4,126150,117484,8666,6.9
Terrebonne,9/1/1991,41589,39218,2371,5.7,126650,117928,8722,6.9
Terrebonne,10/1/1991,41568,39369,2199,5.3,126642,117800,8842,7
Terrebonne,11/1/1991,41574,39301,2273,5.5,126701,117770,8931,7
Terrebonne,12/1/1991,41192,38673,2519,6.1,126664,117466,9198,7.3
Terrebonne,1/1/1992,41102,37673,3429,8.3,127261,117978,9283,7.3
Terrebonne,2/1/1992,41099,37664,3435,8.4,127207,117753,9454,7.4
Terrebonne,3/1/1992,41510,37946,3564,8.6,127604,118144,9460,7.4
Terrebonne,4/1/1992,41532,37994,3538,8.5,127841,118426,9415,7.4
Terrebonne,5/1/1992,41273,37746,3527,8.5,128119,118375,9744,7.6
Terrebonne,6/1/1992,41716,37876,3840,9.2,128459,118419,10040,7.8
Terrebonne,7/1/1992,43215,39620,3595,8.3,128563,118713,9850,7.7
Terrebonne,8/1/1992,42214,38648,3566,8.4,128613,118826,9787,7.6
Terrebonne,9/1/1992,41924,38345,3579,8.5,128501,118720,9781,7.6
Terrebonne,10/1/1992,41956,38827,3129,7.5,128026,118628,9398,7.3
Terrebonne,11/1/1992,41589,38986,2603,6.3,128441,118876,9565,7.4
Terrebonne,12/1/1992,40614,38158,2456,6,128554,118997,9557,7.4
Terrebonne,1/1/1993,40048,37294,2754,6.9,128400,119075,9325,7.3
Terrebonne,2/1/1993,39916,37415,2501,6.3,128458,119275,9183,7.1
Terrebonne,3/1/1993,40256,37656,2600,6.5,128598,119542,9056,7
Terrebonne,4/1/1993,40160,37589,2571,6.4,128584,119474,9110,7.1
Terrebonne,5/1/1993,40545,37931,2614,6.4,129264,120115,9149,7.1
Terrebonne,6/1/1993,41187,38638,2549,6.2,129411,120290,9121,7
Terrebonne,7/1/1993,41429,39206,2223,5.4,129397,120467,8930,6.9
Terrebonne,8/1/1993,41180,38876,2304,5.6,129619,120856,8763,6.8
Terrebonne,9/1/1993,40766,38497,2269,5.6,129268,120554,8714,6.7
Terrebonne,10/1/1993,41467,39114,2353,5.7,129573,120823,8750,6.8
Terrebonne,11/1/1993,41647,39428,2219,5.3,129711,121169,8542,6.6
Terrebonne,12/1/1993,41561,39545,2016,4.9,129941,121464,8477,6.5
Terrebonne,1/1/1994,41092,38503,2589,6.3,130596,121966,8630,6.6
Terrebonne,2/1/1994,41068,38559,2509,6.1,130669,122086,8583,6.6
Terrebonne,3/1/1994,41581,38966,2615,6.3,130400,121930,8470,6.5
Terrebonne,4/1/1994,41762,39177,2585,6.2,130621,122290,8331,6.4
Terrebonne,5/1/1994,41767,39471,2296,5.5,130779,122864,7915,6.1
Terrebonne,6/1/1994,42311,39796,2515,5.9,130561,122634,7927,6.1
Terrebonne,7/1/1994,42820,40478,2342,5.5,130652,122706,7946,6.1
Terrebonne,8/1/1994,42878,40494,2384,5.6,131275,123342,7933,6
Terrebonne,9/1/1994,42345,40080,2265,5.3,131421,123687,7734,5.9
Terrebonne,10/1/1994,42608,40503,2105,4.9,131744,124112,7632,5.8
Terrebonne,11/1/1994,42718,40674,2044,4.8,131891,124516,7375,5.6
Terrebonne,12/1/1994,42289,40371,1918,4.5,131951,124721,7230,5.5
Terrebonne,1/1/1995,41675,39362,2313,5.6,132038,124663,7375,5.6
Terrebonne,2/1/1995,41800,39449,2351,5.6,132115,124928,7187,5.4
Terrebonne,3/1/1995,42103,39664,2439,5.8,132108,124955,7153,5.4
Terrebonne,4/1/1995,42378,39866,2512,5.9,132590,124945,7645,5.8
Terrebonne,5/1/1995,42399,40225,2174,5.1,131851,124421,7430,5.6
Terrebonne,6/1/1995,42891,40640,2251,5.2,131949,124522,7427,5.6
Terrebonne,7/1/1995,43209,41064,2145,5,132343,124816,7527,5.7
Terrebonne,8/1/1995,43184,40827,2357,5.5,132336,124852,7484,5.7
Terrebonne,9/1/1995,42719,40579,2140,5,132611,125133,7478,5.6
Terrebonne,10/1/1995,42652,40633,2019,4.7,132716,125388,7328,5.5
Terrebonne,11/1/1995,42540,40659,1881,4.4,132614,125188,7426,5.6
Terrebonne,12/1/1995,42446,40592,1854,4.4,132511,125088,7423,5.6
Terrebonne,1/1/1996,42561,40129,2432,5.7,132616,125125,7491,5.6
Terrebonne,2/1/1996,42710,40523,2187,5.1,132952,125639,7313,5.5
Terrebonne,3/1/1996,43380,41151,2229,5.1,133180,125862,7318,5.5
Terrebonne,4/1/1996,43513,41268,2245,5.2,133409,125994,7415,5.6
Terrebonne,5/1/1996,43765,41706,2059,4.7,133667,126244,7423,5.6
Terrebonne,6/1/1996,44180,42281,1899,4.3,133697,126602,7095,5.3
Terrebonne,7/1/1996,45148,43392,1756,3.9,134284,126947,7337,5.5
Terrebonne,8/1/1996,45287,43459,1828,4,134054,127172,6882,5.1
Terrebonne,9/1/1996,45030,43398,1632,3.6,134515,127536,6979,5.2
Terrebonne,10/1/1996,44999,43415,1584,3.5,134921,127890,7031,5.2
Terrebonne,11/1/1996,45161,43564,1597,3.5,135007,127771,7236,5.4
Terrebonne,12/1/1996,45160,43678,1482,3.3,135113,127860,7253,5.4
Terrebonne,1/1/1997,44454,42624,1830,4.1,135456,128298,7158,5.3
Terrebonne,2/1/1997,44636,43011,1625,3.6,135400,128298,7102,5.2
Terrebonne,3/1/1997,45490,43508,1982,4.4,135891,128891,7000,5.2
Terrebonne,4/1/1997,46142,44338,1804,3.9,136016,129143,6873,5.1
Terrebonne,5/1/1997,46089,44478,1611,3.5,136119,129464,6655,4.9
Terrebonne,6/1/1997,46763,44863,1900,4.1,136211,129412,6799,5
Terrebonne,7/1/1997,48241,46538,1703,3.5,136477,129822,6655,4.9
Terrebonne,8/1/1997,47939,46342,1597,3.3,136618,130010,6608,4.8
Terrebonne,9/1/1997,47705,46172,1533,3.2,136675,130019,6656,4.9
Terrebonne,10/1/1997,48012,46681,1331,2.8,136633,130179,6454,4.7
Terrebonne,11/1/1997,48437,47168,1269,2.6,136961,130653,6308,4.6
Terrebonne,12/1/1997,48326,47104,1222,2.5,137155,130679,6476,4.7
Terrebonne,1/1/1998,47955,46432,1523,3.2,137095,130726,6368,4.6
Terrebonne,2/1/1998,48051,46629,1422,3,137112,130807,6306,4.6
Terrebonne,3/1/1998,48530,46805,1725,3.6,137236,130814,6422,4.7
Terrebonne,4/1/1998,48966,47323,1643,3.4,137150,131209,5941,4.3
Terrebonne,5/1/1998,49008,47510,1498,3.1,137372,131325,6047,4.4
Terrebonne,6/1/1998,49861,48177,1684,3.4,137455,131244,6212,4.5
Terrebonne,7/1/1998,50225,48670,1555,3.1,137588,131329,6259,4.5
Terrebonne,8/1/1998,49575,47883,1692,3.4,137570,131390,6179,4.5
Terrebonne,9/1/1998,49008,47265,1743,3.6,138286,131986,6300,4.6
Terrebonne,10/1/1998,48591,46963,1628,3.4,138279,131999,6280,4.5
Terrebonne,11/1/1998,48551,46980,1571,3.2,138381,132280,6100,4.4
Terrebonne,12/1/1998,48645,46967,1678,3.4,138634,132602,6032,4.4
Terrebonne,1/1/1999,47937,45719,2218,4.6,139003,133027,5976,4.3
Terrebonne,2/1/1999,47708,45599,2109,4.4,138967,132856,6111,4.4
Terrebonne,3/1/1999,47842,45608,2234,4.7,138730,132947,5783,4.2
Terrebonne,4/1/1999,47189,45138,2051,4.3,138959,132955,6004,4.3
Terrebonne,5/1/1999,46803,44986,1817,3.9,139107,133311,5796,4.2
Terrebonne,6/1/1999,47849,45699,2150,4.5,139329,133378,5951,4.3
Terrebonne,7/1/1999,47897,45834,2063,4.3,139439,133414,6025,4.3
Terrebonne,8/1/1999,47438,45557,1881,4,139430,133591,5838,4.2
Terrebonne,9/1/1999,47154,45280,1874,4,139622,133707,5915,4.2
Terrebonne,10/1/1999,47410,45661,1749,3.7,139771,133993,5778,4.1
Terrebonne,11/1/1999,47277,45744,1533,3.2,140025,134309,5716,4.1
Terrebonne,12/1/1999,46809,45415,1394,3,140177,134523,5653,4
Terrebonne,1/1/2000,44286,42313,1973,4.5,142267,136559,5708,4
Terrebonne,2/1/2000,44534,42647,1887,4.2,142456,136598,5858,4.1
Terrebonne,3/1/2000,44803,42683,2120,4.7,142434,136701,5733,4
Terrebonne,4/1/2000,45383,43576,1807,4,142751,137270,5481,3.8
Terrebonne,5/1/2000,45679,43709,1970,4.3,142388,136630,5758,4
Terrebonne,6/1/2000,46380,44029,2351,5.1,142591,136940,5651,4
Terrebonne,7/1/2000,46463,44202,2261,4.9,142278,136531,5747,4
Terrebonne,8/1/2000,46037,43769,2268,4.9,142514,136662,5853,4.1
Terrebonne,9/1/2000,45671,43483,2188,4.8,142518,136893,5625,3.9
Terrebonne,10/1/2000,46013,43939,2074,4.5,142622,137088,5534,3.9
Terrebonne,11/1/2000,46019,44067,1952,4.2,142962,137322,5639,3.9
Terrebonne,12/1/2000,46298,44482,1816,3.9,143248,137614,5634,3.9
Terrebonne,1/1/2001,46275,43936,2339,5.1,143800,137778,6023,4.2
Terrebonne,2/1/2001,46410,44369,2041,4.4,143701,137612,6089,4.2
Terrebonne,3/1/2001,46895,44749,2146,4.6,143924,137783,6141,4.3
Terrebonne,4/1/2001,47083,44981,2102,4.5,143569,137299,6271,4.4
Terrebonne,5/1/2001,46678,44734,1944,4.2,143318,137092,6226,4.3
Terrebonne,6/1/2001,47506,45064,2442,5.1,143357,136873,6484,4.5
Terrebonne,7/1/2001,48255,46143,2112,4.4,143654,137071,6583,4.6
Terrebonne,8/1/2001,47910,45842,2068,4.3,143284,136241,7042,4.9
Terrebonne,9/1/2001,47478,45286,2192,4.6,143989,136846,7142,5
Terrebonne,10/1/2001,47764,45581,2183,4.6,144086,136392,7694,5.3
Terrebonne,11/1/2001,47088,44903,2185,4.6,144240,136238,8003,5.5
Terrebonne,12/1/2001,46884,44675,2209,4.7,144305,136047,8258,5.7
Terrebonne,1/1/2002,46525,44076,2449,5.3,143883,135701,8182,5.7
Terrebonne,2/1/2002,46751,44537,2214,4.7,144653,136438,8215,5.7
Terrebonne,3/1/2002,46898,44612,2286,4.9,144481,136177,8304,5.7
Terrebonne,4/1/2002,47803,45409,2394,5,144725,136126,8599,5.9
Terrebonne,5/1/2002,47503,45293,2210,4.7,144938,136539,8399,5.8
Terrebonne,6/1/2002,48441,45899,2542,5.2,144808,136415,8393,5.8
Terrebonne,7/1/2002,49188,46936,2252,4.6,144803,136413,8390,5.8
Terrebonne,8/1/2002,49116,46956,2160,4.4,145009,136705,8304,5.7
Terrebonne,9/1/2002,48633,46435,2198,4.5,145552,137302,8251,5.7
Terrebonne,10/1/2002,48819,46683,2136,4.4,145314,137008,8307,5.7
Terrebonne,11/1/2002,48619,46431,2188,4.5,145041,136521,8520,5.9
Terrebonne,12/1/2002,48601,46448,2153,4.4,145066,136426,8640,6
Terrebonne,1/1/2003,48518,46053,2465,5.1,145937,137417,8520,5.8
Terrebonne,2/1/2003,48529,46250,2279,4.7,146100,137482,8618,5.9
Terrebonne,3/1/2003,48811,46404,2407,4.9,146022,137434,8588,5.9
Terrebonne,4/1/2003,48681,46387,2294,4.7,146474,137633,8842,6
Terrebonne,5/1/2003,48571,46164,2407,5,146500,137544,8957,6.1
Terrebonne,6/1/2003,49414,46497,2917,5.9,147056,137790,9266,6.3
Terrebonne,7/1/2003,49902,47218,2684,5.4,146485,137474,9011,6.2
Terrebonne,8/1/2003,49058,46720,2338,4.8,146445,137549,8896,6.1
Terrebonne,9/1/2003,48549,46215,2334,4.8,146530,137609,8921,6.1
Terrebonne,10/1/2003,48794,46668,2126,4.4,146716,137984,8732,6
Terrebonne,11/1/2003,48368,46267,2101,4.3,147000,138424,8576,5.8
Terrebonne,12/1/2003,48063,46003,2060,4.3,146729,138411,8317,5.7
Terrebonne,1/1/2004,48036,45509,2527,5.3,146842,138472,8370,5.7
Terrebonne,2/1/2004,47984,45736,2248,4.7,146709,138542,8167,5.6
Terrebonne,3/1/2004,48176,45799,2377,4.9,146944,138453,8491,5.8
Terrebonne,4/1/2004,48315,46076,2239,4.6,146850,138680,8170,5.6
Terrebonne,5/1/2004,48051,45716,2335,4.9,147065,138852,8212,5.6
Terrebonne,6/1/2004,49092,46315,2777,5.7,147460,139174,8286,5.6
Terrebonne,7/1/2004,49828,47258,2570,5.2,147692,139556,8136,5.5
Terrebonne,8/1/2004,49137,46864,2273,4.6,147564,139573,7990,5.4
Terrebonne,9/1/2004,48696,46294,2402,4.9,147415,139487,7927,5.4
Terrebonne,10/1/2004,48566,46277,2289,4.7,147793,139732,8061,5.5
Terrebonne,11/1/2004,48521,46251,2270,4.7,148162,140231,7932,5.4
Terrebonne,12/1/2004,48662,46422,2240,4.6,148059,140125,7934,5.4
Terrebonne,1/1/2005,48593,46080,2513,5.2,148029,140245,7784,5.3
Terrebonne,2/1/2005,48376,45961,2415,5,148364,140385,7980,5.4
Terrebonne,3/1/2005,48640,46362,2278,4.7,148391,140654,7737,5.2
Terrebonne,4/1/2005,49526,47353,2173,4.4,148926,141254,7672,5.2
Terrebonne,5/1/2005,49323,47013,2310,4.7,149261,141609,7651,5.1
Terrebonne,6/1/2005,50721,48093,2628,5.2,149238,141714,7524,5
Terrebonne,7/1/2005,50240,47907,2333,4.6,149432,142026,7406,5
Terrebonne,8/1/2005,49761,47609,2152,4.3,149779,142434,7345,4.9
Terrebonne,9/1/2005,56445,49603,6842,12.1,149954,142401,7553,5
Terrebonne,10/1/2005,56861,50628,6233,11,150001,142548,7453,5
Terrebonne,11/1/2005,56368,50167,6201,11,150065,142499,7566,5
Terrebonne,12/1/2005,52643,50064,2579,4.9,150030,142752,7279,4.9
Terrebonne,1/1/2006,51470,49383,2087,4.1,150214,143150,7064,4.7
Terrebonne,2/1/2006,51164,49476,1688,3.3,150641,143457,7184,4.8
Terrebonne,3/1/2006,51530,49746,1784,3.5,150813,143741,7072,4.7
Terrebonne,4/1/2006,52327,50655,1672,3.2,150881,143761,7120,4.7
Terrebonne,5/1/2006,52718,51002,1716,3.3,151069,144089,6980,4.6
Terrebonne,6/1/2006,53798,51819,1979,3.7,151354,144353,7001,4.6
Terrebonne,7/1/2006,54496,52895,1601,2.9,151377,144202,7175,4.7
Terrebonne,8/1/2006,53976,52369,1607,3,151716,144625,7091,4.7
Terrebonne,9/1/2006,54311,52683,1628,3,151662,144815,6847,4.5
Terrebonne,10/1/2006,54554,52980,1574,2.9,152041,145314,6727,4.4
Terrebonne,11/1/2006,54678,53089,1589,2.9,152406,145534,6872,4.5
Terrebonne,12/1/2006,54827,53443,1384,2.5,152732,145970,6762,4.4
Terrebonne,1/1/2007,54085,52390,1695,3.1,153144,146028,7116,4.6
Terrebonne,2/1/2007,53997,52487,1510,2.8,152983,146057,6927,4.5
Terrebonne,3/1/2007,54603,53007,1596,2.9,153051,146320,6731,4.4
Terrebonne,4/1/2007,54620,53093,1527,2.8,152435,145586,6850,4.5
Terrebonne,5/1/2007,55206,53466,1740,3.2,152670,145903,6766,4.4
Terrebonne,6/1/2007,55904,53983,1921,3.4,153041,146063,6979,4.6
Terrebonne,7/1/2007,55318,53626,1692,3.1,153054,145905,7149,4.7
Terrebonne,8/1/2007,54533,53000,1533,2.8,152749,145682,7067,4.6
Terrebonne,9/1/2007,54884,53300,1584,2.9,153414,146244,7170,4.7
Terrebonne,10/1/2007,55341,53975,1366,2.5,153183,145946,7237,4.7
Terrebonne,11/1/2007,55811,54365,1446,2.6,153835,146595,7240,4.7
Terrebonne,12/1/2007,55432,53961,1471,2.7,153918,146273,7645,5
Terrebonne,1/1/2008,54841,53090,1751,3.2,154063,146378,7685,5
Terrebonne,2/1/2008,54959,53524,1435,2.6,153653,146156,7497,4.9
Terrebonne,3/1/2008,55638,53990,1648,3,153908,146086,7822,5.1
Terrebonne,4/1/2008,55745,54330,1415,2.5,153769,146132,7637,5
Terrebonne,5/1/2008,56289,54639,1650,2.9,154303,145908,8395,5.4
Terrebonne,6/1/2008,57050,55046,2004,3.5,154313,145737,8575,5.6
Terrebonne,7/1/2008,56811,55086,1725,3,154469,145532,8937,5.8
Terrebonne,8/1/2008,56319,54429,1890,3.4,154641,145203,9438,6.1
Terrebonne,9/1/2008,57213,53192,4021,7,154570,145076,9494,6.1
Terrebonne,10/1/2008,57181,54896,2285,4,154876,144802,10074,6.5
Terrebonne,11/1/2008,57181,55106,2075,3.6,154639,144100,10538,6.8
Terrebonne,12/1/2008,56756,54657,2099,3.7,154655,143369,11286,7.3
Terrebonne,1/1/2009,54929,52629,2300,4.2,154210,142152,12058,7.8
Terrebonne,2/1/2009,55082,52861,2221,4,154538,141640,12898,8.3
Terrebonne,3/1/2009,55203,52909,2294,4.2,154133,140707,13426,8.7
Terrebonne,4/1/2009,54694,52407,2287,4.2,154509,140656,13853,9
Terrebonne,5/1/2009,54788,52233,2555,4.7,154747,140248,14499,9.4
Terrebonne,6/1/2009,55324,52263,3061,5.5,154716,140009,14707,9.5
Terrebonne,7/1/2009,55635,52927,2708,4.9,154502,139901,14601,9.5
Terrebonne,8/1/2009,54911,52127,2784,5.1,154307,139492,14814,9.6
Terrebonne,9/1/2009,54430,51777,2653,4.9,153827,138818,15009,9.8
Terrebonne,10/1/2009,54326,51536,2790,5.1,153784,138432,15352,10
Terrebonne,11/1/2009,54026,51357,2669,4.9,153878,138659,15219,9.9
Terrebonne,12/1/2009,53664,50956,2708,5,153111,138013,15098,9.9
Terrebonne,1/1/2010,49504,46284,3220,6.5,153484,138438,15046,9.8
Terrebonne,2/1/2010,49805,46945,2860,5.7,153694,138581,15113,9.8
Terrebonne,3/1/2010,50289,47408,2881,5.7,153954,138751,15202,9.9
Terrebonne,4/1/2010,51194,48271,2923,5.7,154622,139297,15325,9.9
Terrebonne,5/1/2010,51235,48183,3052,6,154091,139241,14849,9.6
Terrebonne,6/1/2010,51795,48453,3342,6.5,153616,139141,14474,9.4
Terrebonne,7/1/2010,52483,49376,3107,5.9,153691,139179,14512,9.4
Terrebonne,8/1/2010,51994,48737,3257,6.3,154086,139438,14648,9.5
Terrebonne,9/1/2010,51811,48692,3119,6,153975,139396,14579,9.5
Terrebonne,10/1/2010,51418,48270,3148,6.1,153635,139119,14516,9.4
Terrebonne,11/1/2010,50818,47722,3096,6.1,154125,139044,15081,9.8
Terrebonne,12/1/2010,50298,47390,2908,5.8,153650,139301,14348,9.3
Terrebonne,1/1/2011,48934,45564,3370,6.9,153263,139250,14013,9.1
Terrebonne,2/1/2011,48841,45819,3022,6.2,153214,139394,13820,9
Terrebonne,3/1/2011,49216,46232,2984,6.1,153376,139639,13737,9
Terrebonne,4/1/2011,49954,47118,2836,5.7,153543,139586,13957,9.1
Terrebonne,5/1/2011,50073,47119,2954,5.9,153479,139624,13855,9
Terrebonne,6/1/2011,50513,47335,3178,6.3,153346,139384,13962,9.1
Terrebonne,7/1/2011,51349,48308,3041,5.9,153288,139524,13763,9
Terrebonne,8/1/2011,50836,47960,2876,5.7,153760,139942,13818,9
Terrebonne,9/1/2011,50729,47866,2863,5.6,154131,140183,13948,9
Terrebonne,10/1/2011,50732,47895,2837,5.6,153961,140368,13594,8.8
Terrebonne,11/1/2011,50801,48152,2649,5.2,154128,140826,13302,8.6
Terrebonne,12/1/2011,50561,48030,2531,5,153995,140902,13093,8.5
Terrebonne,1/1/2012,49534,46700,2834,5.7,154381,141584,12797,8.3
Terrebonne,2/1/2012,49797,47156,2641,5.3,154671,141858,12813,8.3
Terrebonne,3/1/2012,50186,47590,2596,5.2,154749,142036,12713,8.2
Terrebonne,4/1/2012,50792,48358,2434,4.8,154545,141899,12646,8.2
Terrebonne,5/1/2012,51300,48590,2710,5.3,154866,142206,12660,8.2
Terrebonne,6/1/2012,51998,48919,3079,5.9,155083,142391,12692,8.2
Terrebonne,7/1/2012,52559,49704,2855,5.4,154948,142292,12656,8.2
Terrebonne,8/1/2012,51558,48979,2579,5,154763,142291,12471,8.1
Terrebonne,9/1/2012,51788,49410,2378,4.6,155160,143044,12115,7.8
Terrebonne,10/1/2012,52354,49966,2388,4.6,155554,143431,12124,7.8
Terrebonne,11/1/2012,52207,50038,2169,4.2,155338,143333,12005,7.7
Terrebonne,12/1/2012,52221,49865,2356,4.5,155628,143330,12298,7.9
Terrebonne,1/1/2013,52004,49047,2957,5.7,155763,143292,12471,8
Terrebonne,2/1/2013,51765,49242,2523,4.9,155312,143362,11950,7.7
Terrebonne,3/1/2013,51955,49473,2482,4.8,155005,143316,11689,7.5
Terrebonne,4/1/2013,52808,50318,2490,4.7,155394,143635,11760,7.6
Terrebonne,5/1/2013,53114,50383,2731,5.1,155536,143882,11654,7.5
Terrebonne,6/1/2013,53743,50660,3083,5.7,155749,143999,11751,7.5
Terrebonne,7/1/2013,54605,51782,2823,5.2,155599,144264,11335,7.3
Terrebonne,8/1/2013,53821,51171,2650,4.9,155605,144326,11279,7.2
Terrebonne,9/1/2013,53621,51214,2407,4.5,155687,144418,11270,7.2
Terrebonne,10/1/2013,53290,50940,2350,4.4,154673,143537,11136,7.2
Terrebonne,11/1/2013,53279,51069,2210,4.1,155265,144479,10787,6.9
Terrebonne,12/1/2013,53071,51124,1947,3.7,155182,144778,10404,6.7
Terrebonne,1/1/2014,53238,50980,2258,4.2,155352,145150,10202,6.6
Terrebonne,2/1/2014,53127,51064,2063,3.9,155483,145134,10349,6.7
Terrebonne,3/1/2014,53396,51138,2258,4.2,156028,145648,10380,6.7
Terrebonne,4/1/2014,53567,51458,2109,3.9,155369,145667,9702,6.2
Terrebonne,5/1/2014,53696,51223,2473,4.6,155684,145825,9859,6.3
Terrebonne,6/1/2014,54704,51927,2777,5.1,155707,146247,9460,6.1
Terrebonne,7/1/2014,55763,52772,2991,5.4,156007,146399,9608,6.2
Terrebonne,8/1/2014,55286,52304,2982,5.4,156130,146530,9599,6.1
Terrebonne,9/1/2014,54939,52146,2793,5.1,156040,146778,9262,5.9
Terrebonne,10/1/2014,55345,52527,2818,5.1,156417,147427,8990,5.7
Terrebonne,11/1/2014,55081,52204,2877,5.2,156494,147404,9090,5.8
Terrebonne,12/1/2014,54699,52116,2583,4.7,156332,147615,8717,5.6
Terrebonne,1/1/2015,53998,51020,2978,5.5,157030,148145,8885,5.7
Terrebonne,2/1/2015,53556,50682,2874,5.4,156644,148045,8599,5.5
Terrebonne,3/1/2015,53715,50614,3101,5.8,156643,148128,8515,5.4
Terrebonne,4/1/2015,53322,50169,3153,5.9,157060,148511,8550,5.4
Terrebonne,5/1/2015,53340,50045,3295,6.2,157651,148817,8834,5.6
Terrebonne,6/1/2015,53570,50173,3397,6.3,157062,148816,8247,5.3
Terrebonne,7/1/2015,53804,50507,3297,6.1,156997,148830,8167,5.2
Terrebonne,8/1/2015,52646,49584,3062,5.8,157172,149181,7992,5.1
Terrebonne,9/1/2015,51967,48870,3097,6,156733,148826,7907,5
Terrebonne,10/1/2015,51332,48153,3179,6.2,157167,149246,7922,5
Terrebonne,11/1/2015,51101,48042,3059,6,157463,149463,8000,5.1
Terrebonne,12/1/2015,50645,47694,2951,5.8,158035,150128,7907,5
Terrebonne,1/1/2016,50198,46824,3374,6.7,158280,150653,7627,4.8
Terrebonne,2/1/2016,49906,46607,3299,6.6,158640,150939,7702,4.9
Terrebonne,3/1/2016,49844,46424,3420,6.9,159179,151218,7961,5
Terrebonne,4/1/2016,49579,46278,3301,6.7,159141,151074,8067,5.1
Terrebonne,5/1/2016,49480,46099,3381,6.8,158784,151132,7652,4.8
Terrebonne,6/1/2016,49847,46001,3846,7.7,158967,151223,7744,4.9
Terrebonne,7/1/2016,49781,46089,3692,7.4,159194,151554,7641,4.8
Terrebonne,8/1/2016,48561,45026,3535,7.3,159562,151779,7784,4.9
Terrebonne,9/1/2016,48149,44603,3546,7.4,159714,151761,7953,5
Terrebonne,10/1/2016,47635,44350,3285,6.9,159605,151793,7811,4.9
Terrebonne,11/1/2016,47286,44258,3028,6.4,159506,151954,7553,4.7
Terrebonne,12/1/2016,46965,43944,3021,6.4,159678,152157,7521,4.7
Terrebonne,1/1/2017,46298,43015,3283,7.1,159620,152152,7468,4.7
Terrebonne,2/1/2017,46532,43451,3081,6.6,159859,152480,7379,4.6
Terrebonne,3/1/2017,46755,43837,2918,6.2,160137,153065,7073,4.4
Terrebonne,4/1/2017,46635,43870,2765,5.9,160345,153255,7089,4.4
Terrebonne,5/1/2017,46693,43994,2699,5.8,160068,153069,7000,4.4
Terrebonne,6/1/2017,47195,44336,2859,6.1,160192,153318,6873,4.3
Terrebonne,7/1/2017,47450,44719,2731,5.8,160462,153569,6892,4.3
Terrebonne,8/1/2017,46746,44113,2633,5.6,160586,153503,7082,4.4
Terrebonne,9/1/2017,46740,44233,2507,5.4,161140,154286,6854,4.3
Terrebonne,10/1/2017,46350,44176,2174,4.7,160309,153609,6700,4.2
Terrebonne,11/1/2017,46517,44378,2139,4.6,160579,153805,6774,4.2
Terrebonne,12/1/2017,46382,44318,2064,4.5,160535,153904,6632,4.1
Terrebonne,1/1/2018,45729,43404,2325,5.1,160914,154425,6489,4
Terrebonne,2/1/2018,46159,43947,2212,4.8,161778,155197,6581,4.1
Terrebonne,3/1/2018,46464,44246,2218,4.8,161686,155214,6472,4
Terrebonne,4/1/2018,46646,44440,2206,4.7,161771,155312,6459,4
Terrebonne,5/1/2018,46790,44479,2311,4.9,161848,155652,6196,3.8
Terrebonne,6/1/2018,47273,44432,2841,6,162210,155762,6447,4
Terrebonne,7/1/2018,47446,44837,2609,5.5,162341,156146,6195,3.8
Terrebonne,8/1/2018,46276,43897,2379,5.1,161660,155504,6156,3.8
Terrebonne,9/1/2018,46064,43800,2264,4.9,162087,156015,6073,3.7
Terrebonne,10/1/2018,46306,44149,2157,4.7,162602,156391,6211,3.8
Terrebonne,11/1/2018,46217,44202,2015,4.4,162836,156721,6115,3.8
Terrebonne,12/1/2018,45738,43773,1965,4.3,163206,156817,6389,3.9
Terrebonne,1/1/2019,45392,43049,2343,5.2,162963,156487,6475,4
Terrebonne,2/1/2019,45489,43511,1978,4.3,162999,156863,6136,3.8
Terrebonne,3/1/2019,45894,44068,1826,4,162904,156701,6202,3.8
Terrebonne,4/1/2019,45710,44023,1687,3.7,162586,156625,5961,3.7
Terrebonne,5/1/2019,46074,44127,1947,4.2,162751,156821,5930,3.6
Terrebonne,6/1/2019,46422,44060,2362,5.1,163168,157232,5935,3.6
Terrebonne,7/1/2019,47022,44735,2287,4.9,163590,157529,6061,3.7
Terrebonne,8/1/2019,46755,44604,2151,4.6,163774,157829,5945,3.6
Terrebonne,9/1/2019,46820,44728,2092,4.5,164092,158339,5753,3.5
Terrebonne,10/1/2019,46616,44511,2105,4.5,164416,158545,5871,3.6
Terrebonne,11/1/2019,46293,44243,2050,4.4,164496,158629,5868,3.6
Terrebonne,12/1/2019,45836,43926,1910,4.2,164699,158845,5853,3.6
Terrebonne,1/1/2020,45273,43146,2127,4.7,164377,158508,5869,3.6
Terrebonne,2/1/2020,45170,43490,1680,3.7,164467,158714,5753,3.5
Terrebonne,3/1/2020,46019,43010,3009,6.5,162559,155353,7206,4.4
Terrebonne,4/1/2020,44209,38848,5361,12.1,156269,133185,23084,14.8
Terrebonne,5/1/2020,44731,39649,5082,11.4,158101,137173,20929,13.2
Terrebonne,6/1/2020,45346,40491,4855,10.7,159994,142342,17652,11
Terrebonne,7/1/2020,45763,41088,4675,10.2,160132,143779,16352,10.2
Terrebonne,8/1/2020,45499,41643,3856,8.5,160706,147245,13461,8.4
Terrebonne,9/1/2020,45845,41900,3945,8.6,160174,147620,12554,7.8
Terrebonne,10/1/2020,45989,42480,3509,7.6,161003,149931,11072,6.9
Terrebonne,11/1/2020,45514,42398,3116,6.8,160629,149934,10694,6.7
Terrebonne,12/1/2020,45085,41919,3166,7,160745,149975,10770,6.7
Terrebonne,1/1/2021,44905,41666,3239,7.2,160088,149852,10236,6.4
Terrebonne,2/1/2021,45301,42295,3006,6.6,160184,150189,9995,6.2
Terrebonne,3/1/2021,45473,42658,2815,6.2,160400,150644,9756,6.1
Terrebonne,4/1/2021,45402,42675,2727,6,160843,151081,9762,6.1
Terrebonne,5/1/2021,45167,42460,2707,6,160800,151535,9266,5.8
Terrebonne,6/1/2021,45745,42656,3089,6.8,161197,151734,9462,5.9
Terrebonne,7/1/2021,45905,43220,2685,5.8,161504,152773,8731,5.4
Terrebonne,8/1/2021,44930,42564,2366,5.3,161527,153250,8276,5.1
Terrebonne,9/1/2021,43308,40176,3132,7.2,161495,153843,7652,4.7
Terrebonne,10/1/2021,43471,41079,2392,5.5,161754,154475,7279,4.5
Terrebonne,11/1/2021,43316,41290,2026,4.7,162281,155530,6751,4.2
Terrebonne,12/1/2021,43220,41461,1759,4.1,162497,156099,6398,3.9
Terrebonne,1/1/2022,43102,40998,2104,4.9,163627,157115,6512,4
Terrebonne,2/1/2022,43599,41726,1873,4.3,163899,157598,6301,3.8
Terrebonne,3/1/2022,43983,42218,1765,4,164220,158206,6014,3.7
Terrebonne,4/1/2022,44388,42808,1580,3.6,163893,157891,6002,3.7
Terrebonne,5/1/2022,44469,42819,1650,3.7,164362,158378,5983,3.6
Terrebonne,6/1/2022,45003,42945,2058,4.6,164046,158094,5951,3.6
Terrebonne,7/1/2022,45132,43260,1872,4.1,164026,158258,5768,3.5
Terrebonne,8/1/2022,44614,42861,1753,3.9,164654,158735,5919,3.6
Terrebonne,9/1/2022,44588,42966,1622,3.6,164602,158810,5792,3.5
Terrebonne,10/1/2022,44548,43062,1486,3.3,164648,158684,5964,3.6
Terrebonne,11/1/2022,44370,42982,1388,3.1,164450,158507,5943,3.6
Terrebonne,12/1/2022,44255,42865,1390,3.1,165025,159259,5766,3.5
Terrebonne,1/1/2023,44147,42556,1591,3.6,165964,160217,5747,3.5
Terrebonne,2/1/2023,44354,42847,1507,3.4,166358,160395,5962,3.6
Terrebonne,3/1/2023,44846,43452,1394,3.1,166651,160812,5839,3.5
Terrebonne,4/1/2023,45023,43742,1281,2.8,166725,160974,5751,3.4
Terrebonne,5/1/2023,45111,43583,1528,3.4,166886,160796,6089,3.6
Terrebonne,6/1/2023,45748,43992,1756,3.8,166937,160979,5958,3.6
Terrebonne,7/1/2023,45665,44227,1438,3.1,167103,161183,5920,3.5
Terrebonne,8/1/2023,45563,44036,1527,3.4,167759,161475,6284,3.7
Terrebonne,9/1/2023,45439,43748,1691,3.7,167767,161442,6326,3.8
Terrebonne,10/1/2023,45669,44007,1662,3.6,167690,161211,6479,3.9
Terrebonne,11/1/2023,45626,44083,1543,3.4,168140,161886,6254,3.7
Terrebonne,12/1/2023,45340,43735,1605,3.5,167439,161124,6315,3.8
Terrebonne,1/1/2024,45081,43292,1789,4,167339,161190,6149,3.7
Terrebonne,2/1/2024,45313,43522,1791,4,167475,161013,6462,3.9
Terrebonne,3/1/2024,45573,43858,1715,3.8,167922,161425,6497,3.9
Terrebonne,4/1/2024,45590,44072,1518,3.3,167988,161495,6492,3.9
Terrebonne,5/1/2024,45580,43945,1635,3.6,167799,161164,6635,4
Terrebonne,6/1/2024,46307,44205,2102,4.5,168005,161155,6849,4.1
Terrebonne,7/1/2024,46627,44606,2021,4.3,168315,161219,7097,4.2
Terrebonne,8/1/2024,46222,44183,2039,4.4,168496,161425,7071,4.2
Terrebonne,9/1/2024,46023,44030,1993,4.3,168703,161802,6901,4.1
Terrebonne,10/1/2024,46405,44409,1996,4.3,168428,161456,6972,4.1
Terrebonne,11/1/2024,45979,44071,1908,4.1,168304,161183,7121,4.2
Terrebonne,12/1/2024,45909,44154,1755,3.8,168547,161661,6886,4.1
Terrebonne,1/1/2025,44398,42691,1707,3.8,170744,163895,6849,4
Terrebonne,2/1/2025,44709,43037,1672,3.7,170359,163307,7052,4.1
Union,1/1/1990,8152,7674,478,5.9,125833,119081,6752,5.4
Union,2/1/1990,8092,7616,476,5.9,125710,119059,6651,5.3
Union,3/1/1990,8382,7920,462,5.5,125801,119203,6598,5.2
Union,4/1/1990,8445,7957,488,5.8,125649,118852,6797,5.4
Union,5/1/1990,8477,8011,466,5.5,125893,119151,6742,5.4
Union,6/1/1990,8590,8024,566,6.6,125573,118983,6590,5.2
Union,7/1/1990,8503,8004,499,5.9,125732,118810,6922,5.5
Union,8/1/1990,8457,7901,556,6.6,125990,118802,7188,5.7
Union,9/1/1990,8739,8174,565,6.5,125892,118524,7368,5.9
Union,10/1/1990,8717,8171,546,6.3,125995,118536,7459,5.9
Union,11/1/1990,8578,8018,560,6.5,126070,118306,7764,6.2
Union,12/1/1990,8567,7986,581,6.8,126142,118241,7901,6.3
Union,1/1/1991,8527,7723,804,9.4,125955,117940,8015,6.4
Union,2/1/1991,8522,7674,848,10,126020,117755,8265,6.6
Union,3/1/1991,8622,7855,767,8.9,126238,117652,8586,6.8
Union,4/1/1991,8609,7854,755,8.8,126548,118109,8439,6.7
Union,5/1/1991,8622,7827,795,9.2,126176,117440,8736,6.9
Union,6/1/1991,8831,8076,755,8.5,126331,117639,8692,6.9
Union,7/1/1991,8860,8308,552,6.2,126154,117568,8586,6.8
Union,8/1/1991,8823,8247,576,6.5,126150,117484,8666,6.9
Union,9/1/1991,8820,8280,540,6.1,126650,117928,8722,6.9
Union,10/1/1991,8692,8163,529,6.1,126642,117800,8842,7
Union,11/1/1991,8654,8189,465,5.4,126701,117770,8931,7
Union,12/1/1991,8503,7940,563,6.6,126664,117466,9198,7.3
Union,1/1/1992,8604,7904,700,8.1,127261,117978,9283,7.3
Union,2/1/1992,8686,7996,690,7.9,127207,117753,9454,7.4
Union,3/1/1992,8848,8133,715,8.1,127604,118144,9460,7.4
Union,4/1/1992,9088,8406,682,7.5,127841,118426,9415,7.4
Union,5/1/1992,9658,8996,662,6.9,128119,118375,9744,7.6
Union,6/1/1992,9891,9135,756,7.6,128459,118419,10040,7.8
Union,7/1/1992,10345,9687,658,6.4,128563,118713,9850,7.7
Union,8/1/1992,10167,9539,628,6.2,128613,118826,9787,7.6
Union,9/1/1992,10269,9672,597,5.8,128501,118720,9781,7.6
Union,10/1/1992,10164,9596,568,5.6,128026,118628,9398,7.3
Union,11/1/1992,10109,9606,503,5,128441,118876,9565,7.4
Union,12/1/1992,9824,9280,544,5.5,128554,118997,9557,7.4
Union,1/1/1993,10278,9625,653,6.4,128400,119075,9325,7.3
Union,2/1/1993,10329,9757,572,5.5,128458,119275,9183,7.1
Union,3/1/1993,10620,10012,608,5.7,128598,119542,9056,7
Union,4/1/1993,10713,10125,588,5.5,128584,119474,9110,7.1
Union,5/1/1993,10638,10084,554,5.2,129264,120115,9149,7.1
Union,6/1/1993,10948,10282,666,6.1,129411,120290,9121,7
Union,7/1/1993,10878,10294,584,5.4,129397,120467,8930,6.9
Union,8/1/1993,10723,10178,545,5.1,129619,120856,8763,6.8
Union,9/1/1993,10369,9855,514,5,129268,120554,8714,6.7
Union,10/1/1993,10691,10141,550,5.1,129573,120823,8750,6.8
Union,11/1/1993,10688,10117,571,5.3,129711,121169,8542,6.6
Union,12/1/1993,10624,10086,538,5.1,129941,121464,8477,6.5
Union,1/1/1994,10852,10171,681,6.3,130596,121966,8630,6.6
Union,2/1/1994,10903,10278,625,5.7,130669,122086,8583,6.6
Union,3/1/1994,11085,10427,658,5.9,130400,121930,8470,6.5
Union,4/1/1994,11006,10376,630,5.7,130621,122290,8331,6.4
Union,5/1/1994,10997,10371,626,5.7,130779,122864,7915,6.1
Union,6/1/1994,10967,10307,660,6,130561,122634,7927,6.1
Union,7/1/1994,10951,10366,585,5.3,130652,122706,7946,6.1
Union,8/1/1994,10995,10367,628,5.7,131275,123342,7933,6
Union,9/1/1994,10869,10284,585,5.4,131421,123687,7734,5.9
Union,10/1/1994,11150,10550,600,5.4,131744,124112,7632,5.8
Union,11/1/1994,11023,10482,541,4.9,131891,124516,7375,5.6
Union,12/1/1994,10925,10389,536,4.9,131951,124721,7230,5.5
Union,1/1/1995,10807,10204,603,5.6,132038,124663,7375,5.6
Union,2/1/1995,10891,10349,542,5,132115,124928,7187,5.4
Union,3/1/1995,11065,10512,553,5,132108,124955,7153,5.4
Union,4/1/1995,10970,10418,552,5,132590,124945,7645,5.8
Union,5/1/1995,10912,10373,539,4.9,131851,124421,7430,5.6
Union,6/1/1995,11301,10730,571,5.1,131949,124522,7427,5.6
Union,7/1/1995,11393,10840,553,4.9,132343,124816,7527,5.7
Union,8/1/1995,11289,10758,531,4.7,132336,124852,7484,5.7
Union,9/1/1995,11056,10545,511,4.6,132611,125133,7478,5.6
Union,10/1/1995,11080,10564,516,4.7,132716,125388,7328,5.5
Union,11/1/1995,10955,10401,554,5.1,132614,125188,7426,5.6
Union,12/1/1995,10930,10329,601,5.5,132511,125088,7423,5.6
Union,1/1/1996,10857,10126,731,6.7,132616,125125,7491,5.6
Union,2/1/1996,10992,10265,727,6.6,132952,125639,7313,5.5
Union,3/1/1996,11121,10402,719,6.5,133180,125862,7318,5.5
Union,4/1/1996,11186,10442,744,6.7,133409,125994,7415,5.6
Union,5/1/1996,10923,10274,649,5.9,133667,126244,7423,5.6
Union,6/1/1996,11149,10401,748,6.7,133697,126602,7095,5.3
Union,7/1/1996,11211,10516,695,6.2,134284,126947,7337,5.5
Union,8/1/1996,11064,10419,645,5.8,134054,127172,6882,5.1
Union,9/1/1996,11033,10437,596,5.4,134515,127536,6979,5.2
Union,10/1/1996,11644,11036,608,5.2,134921,127890,7031,5.2
Union,11/1/1996,11972,11326,646,5.4,135007,127771,7236,5.4
Union,12/1/1996,11938,11289,649,5.4,135113,127860,7253,5.4
Union,1/1/1997,11699,10924,775,6.6,135456,128298,7158,5.3
Union,2/1/1997,11590,10904,686,5.9,135400,128298,7102,5.2
Union,3/1/1997,11484,10745,739,6.4,135891,128891,7000,5.2
Union,4/1/1997,11450,10785,665,5.8,136016,129143,6873,5.1
Union,5/1/1997,11576,10989,587,5.1,136119,129464,6655,4.9
Union,6/1/1997,11923,11199,724,6.1,136211,129412,6799,5
Union,7/1/1997,12077,11434,643,5.3,136477,129822,6655,4.9
Union,8/1/1997,11877,11299,578,4.9,136618,130010,6608,4.8
Union,9/1/1997,11766,11197,569,4.8,136675,130019,6656,4.9
Union,10/1/1997,11883,11343,540,4.5,136633,130179,6454,4.7
Union,11/1/1997,11919,11409,510,4.3,136961,130653,6308,4.6
Union,12/1/1997,12051,11512,539,4.5,137155,130679,6476,4.7
Union,1/1/1998,12061,11300,761,6.3,137095,130726,6368,4.6
Union,2/1/1998,11977,11325,652,5.4,137112,130807,6306,4.6
Union,3/1/1998,12109,11391,718,5.9,137236,130814,6422,4.7
Union,4/1/1998,11769,11152,617,5.2,137150,131209,5941,4.3
Union,5/1/1998,11678,11040,638,5.5,137372,131325,6047,4.4
Union,6/1/1998,11731,11036,695,5.9,137455,131244,6212,4.5
Union,7/1/1998,11881,11230,651,5.5,137588,131329,6259,4.5
Union,8/1/1998,11718,11116,602,5.1,137570,131390,6179,4.5
Union,9/1/1998,11376,10812,564,5,138286,131986,6300,4.6
Union,10/1/1998,11910,11429,481,4,138279,131999,6280,4.5
Union,11/1/1998,11784,11316,468,4,138381,132280,6100,4.4
Union,12/1/1998,11834,11371,463,3.9,138634,132602,6032,4.4
Union,1/1/1999,12044,11495,549,4.6,139003,133027,5976,4.3
Union,2/1/1999,12040,11539,501,4.2,138967,132856,6111,4.4
Union,3/1/1999,12120,11660,460,3.8,138730,132947,5783,4.2
Union,4/1/1999,12334,11857,477,3.9,138959,132955,6004,4.3
Union,5/1/1999,12229,11797,432,3.5,139107,133311,5796,4.2
Union,6/1/1999,12538,11981,557,4.4,139329,133378,5951,4.3
Union,7/1/1999,12888,12393,495,3.8,139439,133414,6025,4.3
Union,8/1/1999,12882,12400,482,3.7,139430,133591,5838,4.2
Union,9/1/1999,12698,12203,495,3.9,139622,133707,5915,4.2
Union,10/1/1999,12601,12137,464,3.7,139771,133993,5778,4.1
Union,11/1/1999,12410,11954,456,3.7,140025,134309,5716,4.1
Union,12/1/1999,12380,11927,453,3.7,140177,134523,5653,4
Union,1/1/2000,10046,9429,617,6.1,142267,136559,5708,4
Union,2/1/2000,10055,9501,554,5.5,142456,136598,5858,4.1
Union,3/1/2000,10124,9538,586,5.8,142434,136701,5733,4
Union,4/1/2000,10275,9753,522,5.1,142751,137270,5481,3.8
Union,5/1/2000,10207,9657,550,5.4,142388,136630,5758,4
Union,6/1/2000,10246,9600,646,6.3,142591,136940,5651,4
Union,7/1/2000,10181,9624,557,5.5,142278,136531,5747,4
Union,8/1/2000,10138,9585,553,5.5,142514,136662,5853,4.1
Union,9/1/2000,10062,9535,527,5.2,142518,136893,5625,3.9
Union,10/1/2000,10144,9600,544,5.4,142622,137088,5534,3.9
Union,11/1/2000,10144,9596,548,5.4,142962,137322,5639,3.9
Union,12/1/2000,10130,9612,518,5.1,143248,137614,5634,3.9
Union,1/1/2001,10252,9611,641,6.3,143800,137778,6023,4.2
Union,2/1/2001,10220,9661,559,5.5,143701,137612,6089,4.2
Union,3/1/2001,10311,9697,614,6,143924,137783,6141,4.3
Union,4/1/2001,10484,9871,613,5.8,143569,137299,6271,4.4
Union,5/1/2001,10415,9806,609,5.8,143318,137092,6226,4.3
Union,6/1/2001,10472,9790,682,6.5,143357,136873,6484,4.5
Union,7/1/2001,10470,9862,608,5.8,143654,137071,6583,4.6
Union,8/1/2001,10456,9843,613,5.9,143284,136241,7042,4.9
Union,9/1/2001,10544,9918,626,5.9,143989,136846,7142,5
Union,10/1/2001,10456,9878,578,5.5,144086,136392,7694,5.3
Union,11/1/2001,10476,9881,595,5.7,144240,136238,8003,5.5
Union,12/1/2001,10456,9859,597,5.7,144305,136047,8258,5.7
Union,1/1/2002,10238,9566,672,6.6,143883,135701,8182,5.7
Union,2/1/2002,10336,9752,584,5.7,144653,136438,8215,5.7
Union,3/1/2002,10435,9809,626,6,144481,136177,8304,5.7
Union,4/1/2002,10496,9880,616,5.9,144725,136126,8599,5.9
Union,5/1/2002,10463,9851,612,5.8,144938,136539,8399,5.8
Union,6/1/2002,10675,9973,702,6.6,144808,136415,8393,5.8
Union,7/1/2002,10563,9925,638,6,144803,136413,8390,5.8
Union,8/1/2002,10506,9877,629,6,145009,136705,8304,5.7
Union,9/1/2002,10523,9898,625,5.9,145552,137302,8251,5.7
Union,10/1/2002,10597,9937,660,6.2,145314,137008,8307,5.7
Union,11/1/2002,10522,9835,687,6.5,145041,136521,8520,5.9
Union,12/1/2002,10477,9789,688,6.6,145066,136426,8640,6
Union,1/1/2003,10621,9833,788,7.4,145937,137417,8520,5.8
Union,2/1/2003,10679,9918,761,7.1,146100,137482,8618,5.9
Union,3/1/2003,10752,9945,807,7.5,146022,137434,8588,5.9
Union,4/1/2003,10659,9855,804,7.5,146474,137633,8842,6
Union,5/1/2003,10549,9741,808,7.7,146500,137544,8957,6.1
Union,6/1/2003,10739,9776,963,9,147056,137790,9266,6.3
Union,7/1/2003,10652,9815,837,7.9,146485,137474,9011,6.2
Union,8/1/2003,10483,9741,742,7.1,146445,137549,8896,6.1
Union,9/1/2003,10482,9772,710,6.8,146530,137609,8921,6.1
Union,10/1/2003,10512,9839,673,6.4,146716,137984,8732,6
Union,11/1/2003,10499,9870,629,6,147000,138424,8576,5.8
Union,12/1/2003,10470,9852,618,5.9,146729,138411,8317,5.7
Union,1/1/2004,10427,9687,740,7.1,146842,138472,8370,5.7
Union,2/1/2004,10392,9716,676,6.5,146709,138542,8167,5.6
Union,3/1/2004,10410,9721,689,6.6,146944,138453,8491,5.8
Union,4/1/2004,10356,9732,624,6,146850,138680,8170,5.6
Union,5/1/2004,10281,9675,606,5.9,147065,138852,8212,5.6
Union,6/1/2004,10480,9759,721,6.9,147460,139174,8286,5.6
Union,7/1/2004,10512,9850,662,6.3,147692,139556,8136,5.5
Union,8/1/2004,10344,9780,564,5.5,147564,139573,7990,5.4
Union,9/1/2004,10352,9724,628,6.1,147415,139487,7927,5.4
Union,10/1/2004,10367,9748,619,6,147793,139732,8061,5.5
Union,11/1/2004,10340,9703,637,6.2,148162,140231,7932,5.4
Union,12/1/2004,10324,9692,632,6.1,148059,140125,7934,5.4
Union,1/1/2005,10251,9522,729,7.1,148029,140245,7784,5.3
Union,2/1/2005,10266,9593,673,6.6,148364,140385,7980,5.4
Union,3/1/2005,10280,9668,612,6,148391,140654,7737,5.2
Union,4/1/2005,10329,9688,641,6.2,148926,141254,7672,5.2
Union,5/1/2005,10278,9636,642,6.2,149261,141609,7651,5.1
Union,6/1/2005,10266,9607,659,6.4,149238,141714,7524,5
Union,7/1/2005,10335,9731,604,5.8,149432,142026,7406,5
Union,8/1/2005,10222,9646,576,5.6,149779,142434,7345,4.9
Union,9/1/2005,11055,10332,723,6.5,149954,142401,7553,5
Union,10/1/2005,11173,10491,682,6.1,150001,142548,7453,5
Union,11/1/2005,11096,10412,684,6.2,150065,142499,7566,5
Union,12/1/2005,10795,10332,463,4.3,150030,142752,7279,4.9
Union,1/1/2006,10454,10030,424,4.1,150214,143150,7064,4.7
Union,2/1/2006,10423,10042,381,3.7,150641,143457,7184,4.8
Union,3/1/2006,10423,10026,397,3.8,150813,143741,7072,4.7
Union,4/1/2006,10464,10056,408,3.9,150881,143761,7120,4.7
Union,5/1/2006,10449,10030,419,4,151069,144089,6980,4.6
Union,6/1/2006,10542,10061,481,4.6,151354,144353,7001,4.6
Union,7/1/2006,10543,10127,416,3.9,151377,144202,7175,4.7
Union,8/1/2006,10426,9966,460,4.4,151716,144625,7091,4.7
Union,9/1/2006,10380,9906,474,4.6,151662,144815,6847,4.5
Union,10/1/2006,10478,10032,446,4.3,152041,145314,6727,4.4
Union,11/1/2006,10549,10084,465,4.4,152406,145534,6872,4.5
Union,12/1/2006,10514,10102,412,3.9,152732,145970,6762,4.4
Union,1/1/2007,10150,9638,512,5,153144,146028,7116,4.6
Union,2/1/2007,10199,9703,496,4.9,152983,146057,6927,4.5
Union,3/1/2007,10228,9733,495,4.8,153051,146320,6731,4.4
Union,4/1/2007,10239,9727,512,5,152435,145586,6850,4.5
Union,5/1/2007,10208,9680,528,5.2,152670,145903,6766,4.4
Union,6/1/2007,10302,9704,598,5.8,153041,146063,6979,4.6
Union,7/1/2007,10313,9751,562,5.4,153054,145905,7149,4.7
Union,8/1/2007,10204,9700,504,4.9,152749,145682,7067,4.6
Union,9/1/2007,10244,9777,467,4.6,153414,146244,7170,4.7
Union,10/1/2007,10156,9740,416,4.1,153183,145946,7237,4.7
Union,11/1/2007,10290,9858,432,4.2,153835,146595,7240,4.7
Union,12/1/2007,10228,9750,478,4.7,153918,146273,7645,5
Union,1/1/2008,10043,9518,525,5.2,154063,146378,7685,5
Union,2/1/2008,10031,9575,456,4.5,153653,146156,7497,4.9
Union,3/1/2008,10133,9646,487,4.8,153908,146086,7822,5.1
Union,4/1/2008,10155,9712,443,4.4,153769,146132,7637,5
Union,5/1/2008,10154,9662,492,4.8,154303,145908,8395,5.4
Union,6/1/2008,10219,9628,591,5.8,154313,145737,8575,5.6
Union,7/1/2008,10194,9663,531,5.2,154469,145532,8937,5.8
Union,8/1/2008,10089,9549,540,5.4,154641,145203,9438,6.1
Union,9/1/2008,10149,9661,488,4.8,154570,145076,9494,6.1
Union,10/1/2008,10203,9633,570,5.6,154876,144802,10074,6.5
Union,11/1/2008,10158,9585,573,5.6,154639,144100,10538,6.8
Union,12/1/2008,10164,9499,665,6.5,154655,143369,11286,7.3
Union,1/1/2009,10082,9288,794,7.9,154210,142152,12058,7.8
Union,2/1/2009,10213,9417,796,7.8,154538,141640,12898,8.3
Union,3/1/2009,10239,9416,823,8,154133,140707,13426,8.7
Union,4/1/2009,10257,9422,835,8.1,154509,140656,13853,9
Union,5/1/2009,10685,9278,1407,13.2,154747,140248,14499,9.4
Union,6/1/2009,10790,9230,1560,14.5,154716,140009,14707,9.5
Union,7/1/2009,10751,9260,1491,13.9,154502,139901,14601,9.5
Union,8/1/2009,10410,9213,1197,11.5,154307,139492,14814,9.6
Union,9/1/2009,10307,9150,1157,11.2,153827,138818,15009,9.8
Union,10/1/2009,10313,9242,1071,10.4,153784,138432,15352,10
Union,11/1/2009,10323,9329,994,9.6,153878,138659,15219,9.9
Union,12/1/2009,10094,9226,868,8.6,153111,138013,15098,9.9
Union,1/1/2010,9534,8519,1015,10.6,153484,138438,15046,9.8
Union,2/1/2010,9626,8671,955,9.9,153694,138581,15113,9.8
Union,3/1/2010,9726,8780,946,9.7,153954,138751,15202,9.9
Union,4/1/2010,9787,8906,881,9,154622,139297,15325,9.9
Union,5/1/2010,9757,8834,923,9.5,154091,139241,14849,9.6
Union,6/1/2010,9825,8793,1032,10.5,153616,139141,14474,9.4
Union,7/1/2010,9931,8939,992,10,153691,139179,14512,9.4
Union,8/1/2010,9708,8759,949,9.8,154086,139438,14648,9.5
Union,9/1/2010,9683,8750,933,9.6,153975,139396,14579,9.5
Union,10/1/2010,9599,8706,893,9.3,153635,139119,14516,9.4
Union,11/1/2010,9558,8634,924,9.7,154125,139044,15081,9.8
Union,12/1/2010,9393,8505,888,9.5,153650,139301,14348,9.3
Union,1/1/2011,9348,8377,971,10.4,153263,139250,14013,9.1
Union,2/1/2011,9340,8434,906,9.7,153214,139394,13820,9
Union,3/1/2011,9333,8481,852,9.1,153376,139639,13737,9
Union,4/1/2011,9380,8560,820,8.7,153543,139586,13957,9.1
Union,5/1/2011,9404,8579,825,8.8,153479,139624,13855,9
Union,6/1/2011,9474,8569,905,9.6,153346,139384,13962,9.1
Union,7/1/2011,9551,8681,870,9.1,153288,139524,13763,9
Union,8/1/2011,9435,8601,834,8.8,153760,139942,13818,9
Union,9/1/2011,9364,8548,816,8.7,154131,140183,13948,9
Union,10/1/2011,9389,8610,779,8.3,153961,140368,13594,8.8
Union,11/1/2011,9388,8633,755,8,154128,140826,13302,8.6
Union,12/1/2011,9276,8549,727,7.8,153995,140902,13093,8.5
Union,1/1/2012,9079,8245,834,9.2,154381,141584,12797,8.3
Union,2/1/2012,9116,8374,742,8.1,154671,141858,12813,8.3
Union,3/1/2012,9132,8401,731,8,154749,142036,12713,8.2
Union,4/1/2012,9175,8482,693,7.6,154545,141899,12646,8.2
Union,5/1/2012,9317,8585,732,7.9,154866,142206,12660,8.2
Union,6/1/2012,9384,8559,825,8.8,155083,142391,12692,8.2
Union,7/1/2012,9497,8708,789,8.3,154948,142292,12656,8.2
Union,8/1/2012,9262,8507,755,8.2,154763,142291,12471,8.1
Union,9/1/2012,9220,8528,692,7.5,155160,143044,12115,7.8
Union,10/1/2012,9388,8709,679,7.2,155554,143431,12124,7.8
Union,11/1/2012,9317,8698,619,6.6,155338,143333,12005,7.7
Union,12/1/2012,9345,8679,666,7.1,155628,143330,12298,7.9
Union,1/1/2013,9127,8332,795,8.7,155763,143292,12471,8
Union,2/1/2013,9099,8386,713,7.8,155312,143362,11950,7.7
Union,3/1/2013,9066,8357,709,7.8,155005,143316,11689,7.5
Union,4/1/2013,9119,8447,672,7.4,155394,143635,11760,7.6
Union,5/1/2013,9206,8491,715,7.8,155536,143882,11654,7.5
Union,6/1/2013,9262,8486,776,8.4,155749,143999,11751,7.5
Union,7/1/2013,9379,8656,723,7.7,155599,144264,11335,7.3
Union,8/1/2013,9209,8528,681,7.4,155605,144326,11279,7.2
Union,9/1/2013,9158,8493,665,7.3,155687,144418,11270,7.2
Union,10/1/2013,9124,8491,633,6.9,154673,143537,11136,7.2
Union,11/1/2013,9124,8543,581,6.4,155265,144479,10787,6.9
Union,12/1/2013,9078,8547,531,5.8,155182,144778,10404,6.7
Union,1/1/2014,9104,8497,607,6.7,155352,145150,10202,6.6
Union,2/1/2014,9140,8567,573,6.3,155483,145134,10349,6.7
Union,3/1/2014,9170,8579,591,6.4,156028,145648,10380,6.7
Union,4/1/2014,9204,8625,579,6.3,155369,145667,9702,6.2
Union,5/1/2014,9206,8561,645,7,155684,145825,9859,6.3
Union,6/1/2014,9360,8623,737,7.9,155707,146247,9460,6.1
Union,7/1/2014,9562,8783,779,8.1,156007,146399,9608,6.2
Union,8/1/2014,9415,8652,763,8.1,156130,146530,9599,6.1
Union,9/1/2014,9424,8679,745,7.9,156040,146778,9262,5.9
Union,10/1/2014,9429,8677,752,8,156417,147427,8990,5.7
Union,11/1/2014,9417,8660,757,8,156494,147404,9090,5.8
Union,12/1/2014,9419,8719,700,7.4,156332,147615,8717,5.6
Union,1/1/2015,9316,8542,774,8.3,157030,148145,8885,5.7
Union,2/1/2015,9322,8603,719,7.7,156644,148045,8599,5.5
Union,3/1/2015,9346,8641,705,7.5,156643,148128,8515,5.4
Union,4/1/2015,9317,8670,647,6.9,157060,148511,8550,5.4
Union,5/1/2015,9366,8695,671,7.2,157651,148817,8834,5.6
Union,6/1/2015,9441,8754,687,7.3,157062,148816,8247,5.3
Union,7/1/2015,9448,8774,674,7.1,156997,148830,8167,5.2
Union,8/1/2015,9274,8642,632,6.8,157172,149181,7992,5.1
Union,9/1/2015,9208,8571,637,6.9,156733,148826,7907,5
Union,10/1/2015,9188,8577,611,6.6,157167,149246,7922,5
Union,11/1/2015,9251,8645,606,6.6,157463,149463,8000,5.1
Union,12/1/2015,9212,8661,551,6,158035,150128,7907,5
Union,1/1/2016,9202,8573,629,6.8,158280,150653,7627,4.8
Union,2/1/2016,9269,8658,611,6.6,158640,150939,7702,4.9
Union,3/1/2016,9318,8710,608,6.5,159179,151218,7961,5
Union,4/1/2016,9289,8712,577,6.2,159141,151074,8067,5.1
Union,5/1/2016,9306,8711,595,6.4,158784,151132,7652,4.8
Union,6/1/2016,9451,8771,680,7.2,158967,151223,7744,4.9
Union,7/1/2016,9412,8757,655,7,159194,151554,7641,4.8
Union,8/1/2016,9216,8605,611,6.6,159562,151779,7784,4.9
Union,9/1/2016,9194,8573,621,6.8,159714,151761,7953,5
Union,10/1/2016,9068,8501,567,6.3,159605,151793,7811,4.9
Union,11/1/2016,9119,8570,549,6,159506,151954,7553,4.7
Union,12/1/2016,9037,8503,534,5.9,159678,152157,7521,4.7
Union,1/1/2017,9102,8499,603,6.6,159620,152152,7468,4.7
Union,2/1/2017,9139,8567,572,6.3,159859,152480,7379,4.6
Union,3/1/2017,9201,8667,534,5.8,160137,153065,7073,4.4
Union,4/1/2017,9224,8708,516,5.6,160345,153255,7089,4.4
Union,5/1/2017,9261,8749,512,5.5,160068,153069,7000,4.4
Union,6/1/2017,9402,8856,546,5.8,160192,153318,6873,4.3
Union,7/1/2017,9358,8820,538,5.7,160462,153569,6892,4.3
Union,8/1/2017,9163,8645,518,5.7,160586,153503,7082,4.4
Union,9/1/2017,9130,8636,494,5.4,161140,154286,6854,4.3
Union,10/1/2017,9058,8621,437,4.8,160309,153609,6700,4.2
Union,11/1/2017,9120,8689,431,4.7,160579,153805,6774,4.2
Union,12/1/2017,9111,8689,422,4.6,160535,153904,6632,4.1
Union,1/1/2018,9119,8615,504,5.5,160914,154425,6489,4
Union,2/1/2018,9138,8657,481,5.3,161778,155197,6581,4.1
Union,3/1/2018,9225,8756,469,5.1,161686,155214,6472,4
Union,4/1/2018,9235,8762,473,5.1,161771,155312,6459,4
Union,5/1/2018,9284,8803,481,5.2,161848,155652,6196,3.8
Union,6/1/2018,9370,8760,610,6.5,162210,155762,6447,4
Union,7/1/2018,9372,8792,580,6.2,162341,156146,6195,3.8
Union,8/1/2018,9124,8591,533,5.8,161660,155504,6156,3.8
Union,9/1/2018,9099,8595,504,5.5,162087,156015,6073,3.7
Union,10/1/2018,9120,8626,494,5.4,162602,156391,6211,3.8
Union,11/1/2018,9103,8625,478,5.3,162836,156721,6115,3.8
Union,12/1/2018,9115,8592,523,5.7,163206,156817,6389,3.9
Union,1/1/2019,9061,8477,584,6.4,162963,156487,6475,4
Union,2/1/2019,9083,8581,502,5.5,162999,156863,6136,3.8
Union,3/1/2019,9131,8651,480,5.3,162904,156701,6202,3.8
Union,4/1/2019,9031,8593,438,4.8,162586,156625,5961,3.7
Union,5/1/2019,9103,8630,473,5.2,162751,156821,5930,3.6
Union,6/1/2019,9133,8562,571,6.3,163168,157232,5935,3.6
Union,7/1/2019,9146,8595,551,6,163590,157529,6061,3.7
Union,8/1/2019,9049,8538,511,5.6,163774,157829,5945,3.6
Union,9/1/2019,9119,8622,497,5.5,164092,158339,5753,3.5
Union,10/1/2019,9097,8588,509,5.6,164416,158545,5871,3.6
Union,11/1/2019,9047,8536,511,5.6,164496,158629,5868,3.6
Union,12/1/2019,8972,8482,490,5.5,164699,158845,5853,3.6
Union,1/1/2020,8964,8420,544,6.1,164377,158508,5869,3.6
Union,2/1/2020,8967,8507,460,5.1,164467,158714,5753,3.5
Union,3/1/2020,9225,8443,782,8.5,162559,155353,7206,4.4
Union,4/1/2020,8217,7524,693,8.4,156269,133185,23084,14.8
Union,5/1/2020,8551,7786,765,8.9,158101,137173,20929,13.2
Union,6/1/2020,8920,8077,843,9.5,159994,142342,17652,11
Union,7/1/2020,9014,8202,812,9,160132,143779,16352,10.2
Union,8/1/2020,9030,8335,695,7.7,160706,147245,13461,8.4
Union,9/1/2020,9124,8402,722,7.9,160174,147620,12554,7.8
Union,10/1/2020,9101,8473,628,6.9,161003,149931,11072,6.9
Union,11/1/2020,9006,8436,570,6.3,160629,149934,10694,6.7
Union,12/1/2020,9024,8434,590,6.5,160745,149975,10770,6.7
Union,1/1/2021,8891,8305,586,6.6,160088,149852,10236,6.4
Union,2/1/2021,8909,8354,555,6.2,160184,150189,9995,6.2
Union,3/1/2021,8970,8433,537,6,160400,150644,9756,6.1
Union,4/1/2021,8960,8488,472,5.3,160843,151081,9762,6.1
Union,5/1/2021,8969,8487,482,5.4,160800,151535,9266,5.8
Union,6/1/2021,9093,8539,554,6.1,161197,151734,9462,5.9
Union,7/1/2021,9060,8588,472,5.2,161504,152773,8731,5.4
Union,8/1/2021,8890,8479,411,4.6,161527,153250,8276,5.1
Union,9/1/2021,9108,8720,388,4.3,161495,153843,7652,4.7
Union,10/1/2021,8985,8635,350,3.9,161754,154475,7279,4.5
Union,11/1/2021,8989,8670,319,3.5,162281,155530,6751,4.2
Union,12/1/2021,9038,8740,298,3.3,162497,156099,6398,3.9
Union,1/1/2022,9031,8661,370,4.1,163627,157115,6512,4
Union,2/1/2022,9051,8706,345,3.8,163899,157598,6301,3.8
Union,3/1/2022,9084,8756,328,3.6,164220,158206,6014,3.7
Union,4/1/2022,9081,8789,292,3.2,163893,157891,6002,3.7
Union,5/1/2022,9098,8786,312,3.4,164362,158378,5983,3.6
Union,6/1/2022,9243,8829,414,4.5,164046,158094,5951,3.6
Union,7/1/2022,9237,8846,391,4.2,164026,158258,5768,3.5
Union,8/1/2022,9048,8681,367,4.1,164654,158735,5919,3.6
Union,9/1/2022,9081,8729,352,3.9,164602,158810,5792,3.5
Union,10/1/2022,9056,8725,331,3.7,164648,158684,5964,3.6
Union,11/1/2022,9032,8710,322,3.6,164450,158507,5943,3.6
Union,12/1/2022,9052,8727,325,3.6,165025,159259,5766,3.5
Union,1/1/2023,9037,8658,379,4.2,165964,160217,5747,3.5
Union,2/1/2023,9026,8672,354,3.9,166358,160395,5962,3.6
Union,3/1/2023,9131,8784,347,3.8,166651,160812,5839,3.5
Union,4/1/2023,9119,8799,320,3.5,166725,160974,5751,3.4
Union,5/1/2023,9143,8759,384,4.2,166886,160796,6089,3.6
Union,6/1/2023,9240,8804,436,4.7,166937,160979,5958,3.6
Union,7/1/2023,9282,8918,364,3.9,167103,161183,5920,3.5
Union,8/1/2023,9097,8706,391,4.3,167759,161475,6284,3.7
Union,9/1/2023,9116,8712,404,4.4,167767,161442,6326,3.8
Union,10/1/2023,9123,8700,423,4.6,167690,161211,6479,3.9
Union,11/1/2023,9119,8716,403,4.4,168140,161886,6254,3.7
Union,12/1/2023,9070,8667,403,4.4,167439,161124,6315,3.8
Union,1/1/2024,9027,8568,459,5.1,167339,161190,6149,3.7
Union,2/1/2024,8940,8502,438,4.9,167475,161013,6462,3.9
Union,3/1/2024,8981,8548,433,4.8,167922,161425,6497,3.9
Union,4/1/2024,9031,8637,394,4.4,167988,161495,6492,3.9
Union,5/1/2024,8994,8576,418,4.6,167799,161164,6635,4
Union,6/1/2024,9159,8661,498,5.4,168005,161155,6849,4.1
Union,7/1/2024,9263,8750,513,5.5,168315,161219,7097,4.2
Union,8/1/2024,9065,8572,493,5.4,168496,161425,7071,4.2
Union,9/1/2024,9039,8567,472,5.2,168703,161802,6901,4.1
Union,10/1/2024,9081,8597,484,5.3,168428,161456,6972,4.1
Union,11/1/2024,9001,8547,454,5,168304,161183,7121,4.2
Union,12/1/2024,8964,8547,417,4.7,168547,161661,6886,4.1
Union,1/1/2025,7884,7464,420,5.3,170744,163895,6849,4
Union,2/1/2025,7709,7312,397,5.1,170359,163307,7052,4.1
Vermilion,1/1/1990,19421,18077,1344,6.9,125833,119081,6752,5.4
Vermilion,2/1/1990,19322,18165,1157,6,125710,119059,6651,5.3
Vermilion,3/1/1990,19469,18337,1132,5.8,125801,119203,6598,5.2
Vermilion,4/1/1990,19784,18750,1034,5.2,125649,118852,6797,5.4
Vermilion,5/1/1990,19698,18796,902,4.6,125893,119151,6742,5.4
Vermilion,6/1/1990,20223,19094,1129,5.6,125573,118983,6590,5.2
Vermilion,7/1/1990,20532,19398,1134,5.5,125732,118810,6922,5.5
Vermilion,8/1/1990,20551,19413,1138,5.5,125990,118802,7188,5.7
Vermilion,9/1/1990,20131,19105,1026,5.1,125892,118524,7368,5.9
Vermilion,10/1/1990,20250,19295,955,4.7,125995,118536,7459,5.9
Vermilion,11/1/1990,20396,19212,1184,5.8,126070,118306,7764,6.2
Vermilion,12/1/1990,20225,19015,1210,6,126142,118241,7901,6.3
Vermilion,1/1/1991,19687,18128,1559,7.9,125955,117940,8015,6.4
Vermilion,2/1/1991,19801,18239,1562,7.9,126020,117755,8265,6.6
Vermilion,3/1/1991,20083,18520,1563,7.8,126238,117652,8586,6.8
Vermilion,4/1/1991,19715,18315,1400,7.1,126548,118109,8439,6.7
Vermilion,5/1/1991,19624,18330,1294,6.6,126176,117440,8736,6.9
Vermilion,6/1/1991,20228,18570,1658,8.2,126331,117639,8692,6.9
Vermilion,7/1/1991,20450,18910,1540,7.5,126154,117568,8586,6.8
Vermilion,8/1/1991,20053,18559,1494,7.5,126150,117484,8666,6.9
Vermilion,9/1/1991,19771,18339,1432,7.2,126650,117928,8722,6.9
Vermilion,10/1/1991,19769,18351,1418,7.2,126642,117800,8842,7
Vermilion,11/1/1991,19754,18031,1723,8.7,126701,117770,8931,7
Vermilion,12/1/1991,19351,17615,1736,9,126664,117466,9198,7.3
Vermilion,1/1/1992,20629,18363,2266,11,127261,117978,9283,7.3
Vermilion,2/1/1992,20687,18622,2065,10,127207,117753,9454,7.4
Vermilion,3/1/1992,20932,18774,2158,10.3,127604,118144,9460,7.4
Vermilion,4/1/1992,21021,18947,2074,9.9,127841,118426,9415,7.4
Vermilion,5/1/1992,21152,19071,2081,9.8,128119,118375,9744,7.6
Vermilion,6/1/1992,21762,19215,2547,11.7,128459,118419,10040,7.8
Vermilion,7/1/1992,22346,20121,2225,10,128563,118713,9850,7.7
Vermilion,8/1/1992,21820,19579,2241,10.3,128613,118826,9787,7.6
Vermilion,9/1/1992,21389,19369,2020,9.4,128501,118720,9781,7.6
Vermilion,10/1/1992,21504,19743,1761,8.2,128026,118628,9398,7.3
Vermilion,11/1/1992,21403,19647,1756,8.2,128441,118876,9565,7.4
Vermilion,12/1/1992,20745,19111,1634,7.9,128554,118997,9557,7.4
Vermilion,1/1/1993,21238,19174,2064,9.7,128400,119075,9325,7.3
Vermilion,2/1/1993,21013,19217,1796,8.5,128458,119275,9183,7.1
Vermilion,3/1/1993,21124,19368,1756,8.3,128598,119542,9056,7
Vermilion,4/1/1993,21676,20096,1580,7.3,128584,119474,9110,7.1
Vermilion,5/1/1993,21215,19718,1497,7.1,129264,120115,9149,7.1
Vermilion,6/1/1993,21839,20086,1753,8,129411,120290,9121,7
Vermilion,7/1/1993,21493,20047,1446,6.7,129397,120467,8930,6.9
Vermilion,8/1/1993,21519,20151,1368,6.4,129619,120856,8763,6.8
Vermilion,9/1/1993,21164,19854,1310,6.2,129268,120554,8714,6.7
Vermilion,10/1/1993,21086,19846,1240,5.9,129573,120823,8750,6.8
Vermilion,11/1/1993,21041,19724,1317,6.3,129711,121169,8542,6.6
Vermilion,12/1/1993,21044,19704,1340,6.4,129941,121464,8477,6.5
Vermilion,1/1/1994,21583,19846,1737,8,130596,121966,8630,6.6
Vermilion,2/1/1994,21514,19895,1619,7.5,130669,122086,8583,6.6
Vermilion,3/1/1994,21860,20222,1638,7.5,130400,121930,8470,6.5
Vermilion,4/1/1994,22244,20735,1509,6.8,130621,122290,8331,6.4
Vermilion,5/1/1994,22143,20856,1287,5.8,130779,122864,7915,6.1
Vermilion,6/1/1994,22662,21012,1650,7.3,130561,122634,7927,6.1
Vermilion,7/1/1994,22578,21097,1481,6.6,130652,122706,7946,6.1
Vermilion,8/1/1994,22261,20848,1413,6.3,131275,123342,7933,6
Vermilion,9/1/1994,22301,20979,1322,5.9,131421,123687,7734,5.9
Vermilion,10/1/1994,22450,21214,1236,5.5,131744,124112,7632,5.8
Vermilion,11/1/1994,22436,21128,1308,5.8,131891,124516,7375,5.6
Vermilion,12/1/1994,22281,21023,1258,5.6,131951,124721,7230,5.5
Vermilion,1/1/1995,22232,20729,1503,6.8,132038,124663,7375,5.6
Vermilion,2/1/1995,22090,20690,1400,6.3,132115,124928,7187,5.4
Vermilion,3/1/1995,22289,20862,1427,6.4,132108,124955,7153,5.4
Vermilion,4/1/1995,22170,20800,1370,6.2,132590,124945,7645,5.8
Vermilion,5/1/1995,22125,20962,1163,5.3,131851,124421,7430,5.6
Vermilion,6/1/1995,22530,21141,1389,6.2,131949,124522,7427,5.6
Vermilion,7/1/1995,22836,21398,1438,6.3,132343,124816,7527,5.7
Vermilion,8/1/1995,22758,21509,1249,5.5,132336,124852,7484,5.7
Vermilion,9/1/1995,22407,21247,1160,5.2,132611,125133,7478,5.6
Vermilion,10/1/1995,22604,21492,1112,4.9,132716,125388,7328,5.5
Vermilion,11/1/1995,22188,21042,1146,5.2,132614,125188,7426,5.6
Vermilion,12/1/1995,21874,20740,1134,5.2,132511,125088,7423,5.6
Vermilion,1/1/1996,22117,20626,1491,6.7,132616,125125,7491,5.6
Vermilion,2/1/1996,22072,20756,1316,6,132952,125639,7313,5.5
Vermilion,3/1/1996,22246,21028,1218,5.5,133180,125862,7318,5.5
Vermilion,4/1/1996,22350,21106,1244,5.6,133409,125994,7415,5.6
Vermilion,5/1/1996,22578,21400,1178,5.2,133667,126244,7423,5.6
Vermilion,6/1/1996,23224,21970,1254,5.4,133697,126602,7095,5.3
Vermilion,7/1/1996,23719,22542,1177,5,134284,126947,7337,5.5
Vermilion,8/1/1996,23071,22027,1044,4.5,134054,127172,6882,5.1
Vermilion,9/1/1996,22684,21690,994,4.4,134515,127536,6979,5.2
Vermilion,10/1/1996,22916,21938,978,4.3,134921,127890,7031,5.2
Vermilion,11/1/1996,22738,21667,1071,4.7,135007,127771,7236,5.4
Vermilion,12/1/1996,22420,21401,1019,4.5,135113,127860,7253,5.4
Vermilion,1/1/1997,22509,21248,1261,5.6,135456,128298,7158,5.3
Vermilion,2/1/1997,22365,21245,1120,5,135400,128298,7102,5.2
Vermilion,3/1/1997,22545,21366,1179,5.2,135891,128891,7000,5.2
Vermilion,4/1/1997,22752,21674,1078,4.7,136016,129143,6873,5.1
Vermilion,5/1/1997,22725,21792,933,4.1,136119,129464,6655,4.9
Vermilion,6/1/1997,23414,22243,1171,5,136211,129412,6799,5
Vermilion,7/1/1997,23915,22845,1070,4.5,136477,129822,6655,4.9
Vermilion,8/1/1997,23335,22409,926,4,136618,130010,6608,4.8
Vermilion,9/1/1997,22668,21714,954,4.2,136675,130019,6656,4.9
Vermilion,10/1/1997,23094,21745,1349,5.8,136633,130179,6454,4.7
Vermilion,11/1/1997,22845,21452,1393,6.1,136961,130653,6308,4.6
Vermilion,12/1/1997,22641,21357,1284,5.7,137155,130679,6476,4.7
Vermilion,1/1/1998,22276,20651,1625,7.3,137095,130726,6368,4.6
Vermilion,2/1/1998,22231,20718,1513,6.8,137112,130807,6306,4.6
Vermilion,3/1/1998,22519,20808,1711,7.6,137236,130814,6422,4.7
Vermilion,4/1/1998,22909,21281,1628,7.1,137150,131209,5941,4.3
Vermilion,5/1/1998,23098,21646,1452,6.3,137372,131325,6047,4.4
Vermilion,6/1/1998,23432,21852,1580,6.7,137455,131244,6212,4.5
Vermilion,7/1/1998,23423,21994,1429,6.1,137588,131329,6259,4.5
Vermilion,8/1/1998,23347,21756,1591,6.8,137570,131390,6179,4.5
Vermilion,9/1/1998,22759,21169,1590,7,138286,131986,6300,4.6
Vermilion,10/1/1998,22861,21444,1417,6.2,138279,131999,6280,4.5
Vermilion,11/1/1998,22918,21459,1459,6.4,138381,132280,6100,4.4
Vermilion,12/1/1998,22659,21311,1348,5.9,138634,132602,6032,4.4
Vermilion,1/1/1999,21864,20228,1636,7.5,139003,133027,5976,4.3
Vermilion,2/1/1999,21774,20190,1584,7.3,138967,132856,6111,4.4
Vermilion,3/1/1999,21915,20271,1644,7.5,138730,132947,5783,4.2
Vermilion,4/1/1999,21665,20072,1593,7.4,138959,132955,6004,4.3
Vermilion,5/1/1999,21271,19903,1368,6.4,139107,133311,5796,4.2
Vermilion,6/1/1999,21999,20402,1597,7.3,139329,133378,5951,4.3
Vermilion,7/1/1999,22163,20698,1465,6.6,139439,133414,6025,4.3
Vermilion,8/1/1999,21755,20467,1288,5.9,139430,133591,5838,4.2
Vermilion,9/1/1999,21308,19932,1376,6.5,139622,133707,5915,4.2
Vermilion,10/1/1999,21573,20332,1241,5.8,139771,133993,5778,4.1
Vermilion,11/1/1999,21632,20325,1307,6,140025,134309,5716,4.1
Vermilion,12/1/1999,21272,20034,1238,5.8,140177,134523,5653,4
Vermilion,1/1/2000,23005,21676,1329,5.8,142267,136559,5708,4
Vermilion,2/1/2000,22912,21723,1189,5.2,142456,136598,5858,4.1
Vermilion,3/1/2000,23049,21805,1244,5.4,142434,136701,5733,4
Vermilion,4/1/2000,23142,22074,1068,4.6,142751,137270,5481,3.8
Vermilion,5/1/2000,23185,22054,1131,4.9,142388,136630,5758,4
Vermilion,6/1/2000,23526,22192,1334,5.7,142591,136940,5651,4
Vermilion,7/1/2000,23631,22388,1243,5.3,142278,136531,5747,4
Vermilion,8/1/2000,23332,22116,1216,5.2,142514,136662,5853,4.1
Vermilion,9/1/2000,23183,22012,1171,5.1,142518,136893,5625,3.9
Vermilion,10/1/2000,23420,22289,1131,4.8,142622,137088,5534,3.9
Vermilion,11/1/2000,23059,21884,1175,5.1,142962,137322,5639,3.9
Vermilion,12/1/2000,23112,21982,1130,4.9,143248,137614,5634,3.9
Vermilion,1/1/2001,23027,21637,1390,6,143800,137778,6023,4.2
Vermilion,2/1/2001,23247,22010,1237,5.3,143701,137612,6089,4.2
Vermilion,3/1/2001,23616,22308,1308,5.5,143924,137783,6141,4.3
Vermilion,4/1/2001,23495,22312,1183,5,143569,137299,6271,4.4
Vermilion,5/1/2001,23490,22361,1129,4.8,143318,137092,6226,4.3
Vermilion,6/1/2001,23932,22522,1410,5.9,143357,136873,6484,4.5
Vermilion,7/1/2001,23974,22691,1283,5.4,143654,137071,6583,4.6
Vermilion,8/1/2001,23712,22442,1270,5.4,143284,136241,7042,4.9
Vermilion,9/1/2001,23777,22484,1293,5.4,143989,136846,7142,5
Vermilion,10/1/2001,23872,22601,1271,5.3,144086,136392,7694,5.3
Vermilion,11/1/2001,23569,22212,1357,5.8,144240,136238,8003,5.5
Vermilion,12/1/2001,23409,22022,1387,5.9,144305,136047,8258,5.7
Vermilion,1/1/2002,22542,20966,1576,7,143883,135701,8182,5.7
Vermilion,2/1/2002,22354,20962,1392,6.2,144653,136438,8215,5.7
Vermilion,3/1/2002,22409,20926,1483,6.6,144481,136177,8304,5.7
Vermilion,4/1/2002,22708,21266,1442,6.4,144725,136126,8599,5.9
Vermilion,5/1/2002,22865,21388,1477,6.5,144938,136539,8399,5.8
Vermilion,6/1/2002,23253,21505,1748,7.5,144808,136415,8393,5.8
Vermilion,7/1/2002,23310,21728,1582,6.8,144803,136413,8390,5.8
Vermilion,8/1/2002,23242,21764,1478,6.4,145009,136705,8304,5.7
Vermilion,9/1/2002,23127,21650,1477,6.4,145552,137302,8251,5.7
Vermilion,10/1/2002,23422,21919,1503,6.4,145314,137008,8307,5.7
Vermilion,11/1/2002,23145,21669,1476,6.4,145041,136521,8520,5.9
Vermilion,12/1/2002,23043,21577,1466,6.4,145066,136426,8640,6
Vermilion,1/1/2003,22962,21302,1660,7.2,145937,137417,8520,5.8
Vermilion,2/1/2003,22786,21227,1559,6.8,146100,137482,8618,5.9
Vermilion,3/1/2003,22955,21317,1638,7.1,146022,137434,8588,5.9
Vermilion,4/1/2003,23040,21502,1538,6.7,146474,137633,8842,6
Vermilion,5/1/2003,23190,21645,1545,6.7,146500,137544,8957,6.1
Vermilion,6/1/2003,23847,21991,1856,7.8,147056,137790,9266,6.3
Vermilion,7/1/2003,23471,21789,1682,7.2,146485,137474,9011,6.2
Vermilion,8/1/2003,23279,21816,1463,6.3,146445,137549,8896,6.1
Vermilion,9/1/2003,23159,21788,1371,5.9,146530,137609,8921,6.1
Vermilion,10/1/2003,23380,22114,1266,5.4,146716,137984,8732,6
Vermilion,11/1/2003,22992,21701,1291,5.6,147000,138424,8576,5.8
Vermilion,12/1/2003,22763,21495,1268,5.6,146729,138411,8317,5.7
Vermilion,1/1/2004,22498,20953,1545,6.9,146842,138472,8370,5.7
Vermilion,2/1/2004,22328,20977,1351,6.1,146709,138542,8167,5.6
Vermilion,3/1/2004,22403,20962,1441,6.4,146944,138453,8491,5.8
Vermilion,4/1/2004,22622,21346,1276,5.6,146850,138680,8170,5.6
Vermilion,5/1/2004,22729,21452,1277,5.6,147065,138852,8212,5.6
Vermilion,6/1/2004,23269,21739,1530,6.6,147460,139174,8286,5.6
Vermilion,7/1/2004,23208,21828,1380,5.9,147692,139556,8136,5.5
Vermilion,8/1/2004,23026,21903,1123,4.9,147564,139573,7990,5.4
Vermilion,9/1/2004,22914,21736,1178,5.1,147415,139487,7927,5.4
Vermilion,10/1/2004,23262,22117,1145,4.9,147793,139732,8061,5.5
Vermilion,11/1/2004,22951,21746,1205,5.3,148162,140231,7932,5.4
Vermilion,12/1/2004,22738,21548,1190,5.2,148059,140125,7934,5.4
Vermilion,1/1/2005,22530,21143,1387,6.2,148029,140245,7784,5.3
Vermilion,2/1/2005,22287,21008,1279,5.7,148364,140385,7980,5.4
Vermilion,3/1/2005,22334,21120,1214,5.4,148391,140654,7737,5.2
Vermilion,4/1/2005,22740,21580,1160,5.1,148926,141254,7672,5.2
Vermilion,5/1/2005,22855,21690,1165,5.1,149261,141609,7651,5.1
Vermilion,6/1/2005,23383,22000,1383,5.9,149238,141714,7524,5
Vermilion,7/1/2005,23199,21937,1262,5.4,149432,142026,7406,5
Vermilion,8/1/2005,22818,21722,1096,4.8,149779,142434,7345,4.9
Vermilion,9/1/2005,24928,23167,1761,7.1,149954,142401,7553,5
Vermilion,10/1/2005,25945,23937,2008,7.7,150001,142548,7453,5
Vermilion,11/1/2005,25452,23412,2040,8,150065,142499,7566,5
Vermilion,12/1/2005,24317,23207,1110,4.6,150030,142752,7279,4.9
Vermilion,1/1/2006,23740,22757,983,4.1,150214,143150,7064,4.7
Vermilion,2/1/2006,23577,22779,798,3.4,150641,143457,7184,4.8
Vermilion,3/1/2006,23792,22945,847,3.6,150813,143741,7072,4.7
Vermilion,4/1/2006,24047,23237,810,3.4,150881,143761,7120,4.7
Vermilion,5/1/2006,24213,23367,846,3.5,151069,144089,6980,4.6
Vermilion,6/1/2006,24781,23714,1067,4.3,151354,144353,7001,4.6
Vermilion,7/1/2006,24701,23804,897,3.6,151377,144202,7175,4.7
Vermilion,8/1/2006,24333,23444,889,3.7,151716,144625,7091,4.7
Vermilion,9/1/2006,24478,23627,851,3.5,151662,144815,6847,4.5
Vermilion,10/1/2006,24705,23894,811,3.3,152041,145314,6727,4.4
Vermilion,11/1/2006,24584,23700,884,3.6,152406,145534,6872,4.5
Vermilion,12/1/2006,24174,23352,822,3.4,152732,145970,6762,4.4
Vermilion,1/1/2007,23865,22852,1013,4.2,153144,146028,7116,4.6
Vermilion,2/1/2007,23781,22910,871,3.7,152983,146057,6927,4.5
Vermilion,3/1/2007,24170,23279,891,3.7,153051,146320,6731,4.4
Vermilion,4/1/2007,24053,23203,850,3.5,152435,145586,6850,4.5
Vermilion,5/1/2007,24083,23150,933,3.9,152670,145903,6766,4.4
Vermilion,6/1/2007,24526,23424,1102,4.5,153041,146063,6979,4.6
Vermilion,7/1/2007,24570,23573,997,4.1,153054,145905,7149,4.7
Vermilion,8/1/2007,24238,23401,837,3.5,152749,145682,7067,4.6
Vermilion,9/1/2007,24468,23615,853,3.5,153414,146244,7170,4.7
Vermilion,10/1/2007,24336,23615,721,3,153183,145946,7237,4.7
Vermilion,11/1/2007,24356,23540,816,3.4,153835,146595,7240,4.7
Vermilion,12/1/2007,24140,23278,862,3.6,153918,146273,7645,5
Vermilion,1/1/2008,23952,22943,1009,4.2,154063,146378,7685,5
Vermilion,2/1/2008,23951,23104,847,3.5,153653,146156,7497,4.9
Vermilion,3/1/2008,24250,23324,926,3.8,153908,146086,7822,5.1
Vermilion,4/1/2008,24360,23546,814,3.3,153769,146132,7637,5
Vermilion,5/1/2008,24466,23529,937,3.8,154303,145908,8395,5.4
Vermilion,6/1/2008,24958,23788,1170,4.7,154313,145737,8575,5.6
Vermilion,7/1/2008,24774,23733,1041,4.2,154469,145532,8937,5.8
Vermilion,8/1/2008,24642,23593,1049,4.3,154641,145203,9438,6.1
Vermilion,9/1/2008,24514,23455,1059,4.3,154570,145076,9494,6.1
Vermilion,10/1/2008,25070,23940,1130,4.5,154876,144802,10074,6.5
Vermilion,11/1/2008,25055,23937,1118,4.5,154639,144100,10538,6.8
Vermilion,12/1/2008,24603,23442,1161,4.7,154655,143369,11286,7.3
Vermilion,1/1/2009,24425,23065,1360,5.6,154210,142152,12058,7.8
Vermilion,2/1/2009,24652,23272,1380,5.6,154538,141640,12898,8.3
Vermilion,3/1/2009,24659,23222,1437,5.8,154133,140707,13426,8.7
Vermilion,4/1/2009,25018,23520,1498,6,154509,140656,13853,9
Vermilion,5/1/2009,25148,23570,1578,6.3,154747,140248,14499,9.4
Vermilion,6/1/2009,25566,23681,1885,7.4,154716,140009,14707,9.5
Vermilion,7/1/2009,25159,23384,1775,7.1,154502,139901,14601,9.5
Vermilion,8/1/2009,24724,23001,1723,7,154307,139492,14814,9.6
Vermilion,9/1/2009,24352,22704,1648,6.8,153827,138818,15009,9.8
Vermilion,10/1/2009,24870,23244,1626,6.5,153784,138432,15352,10
Vermilion,11/1/2009,24805,23196,1609,6.5,153878,138659,15219,9.9
Vermilion,12/1/2009,24550,22876,1674,6.8,153111,138013,15098,9.9
Vermilion,1/1/2010,25229,23286,1943,7.7,153484,138438,15046,9.8
Vermilion,2/1/2010,25391,23667,1724,6.8,153694,138581,15113,9.8
Vermilion,3/1/2010,25604,23858,1746,6.8,153954,138751,15202,9.9
Vermilion,4/1/2010,25813,24138,1675,6.5,154622,139297,15325,9.9
Vermilion,5/1/2010,25786,24099,1687,6.5,154091,139241,14849,9.6
Vermilion,6/1/2010,26074,24168,1906,7.3,153616,139141,14474,9.4
Vermilion,7/1/2010,26083,24292,1791,6.9,153691,139179,14512,9.4
Vermilion,8/1/2010,25931,24129,1802,6.9,154086,139438,14648,9.5
Vermilion,9/1/2010,25775,24056,1719,6.7,153975,139396,14579,9.5
Vermilion,10/1/2010,25696,24022,1674,6.5,153635,139119,14516,9.4
Vermilion,11/1/2010,25680,23981,1699,6.6,154125,139044,15081,9.8
Vermilion,12/1/2010,25304,23712,1592,6.3,153650,139301,14348,9.3
Vermilion,1/1/2011,25107,23234,1873,7.5,153263,139250,14013,9.1
Vermilion,2/1/2011,25218,23551,1667,6.6,153214,139394,13820,9
Vermilion,3/1/2011,25331,23705,1626,6.4,153376,139639,13737,9
Vermilion,4/1/2011,25373,23858,1515,6,153543,139586,13957,9.1
Vermilion,5/1/2011,25391,23829,1562,6.2,153479,139624,13855,9
Vermilion,6/1/2011,25622,23928,1694,6.6,153346,139384,13962,9.1
Vermilion,7/1/2011,25819,24199,1620,6.3,153288,139524,13763,9
Vermilion,8/1/2011,25631,24098,1533,6,153760,139942,13818,9
Vermilion,9/1/2011,25586,24104,1482,5.8,154131,140183,13948,9
Vermilion,10/1/2011,25712,24216,1496,5.8,153961,140368,13594,8.8
Vermilion,11/1/2011,25783,24333,1450,5.6,154128,140826,13302,8.6
Vermilion,12/1/2011,25543,24107,1436,5.6,153995,140902,13093,8.5
Vermilion,1/1/2012,25447,23819,1628,6.4,154381,141584,12797,8.3
Vermilion,2/1/2012,25708,24213,1495,5.8,154671,141858,12813,8.3
Vermilion,3/1/2012,25905,24450,1455,5.6,154749,142036,12713,8.2
Vermilion,4/1/2012,26053,24700,1353,5.2,154545,141899,12646,8.2
Vermilion,5/1/2012,26181,24747,1434,5.5,154866,142206,12660,8.2
Vermilion,6/1/2012,26580,24929,1651,6.2,155083,142391,12692,8.2
Vermilion,7/1/2012,26315,24779,1536,5.8,154948,142292,12656,8.2
Vermilion,8/1/2012,25881,24511,1370,5.3,154763,142291,12471,8.1
Vermilion,9/1/2012,25812,24585,1227,4.8,155160,143044,12115,7.8
Vermilion,10/1/2012,25986,24726,1260,4.8,155554,143431,12124,7.8
Vermilion,11/1/2012,25936,24730,1206,4.6,155338,143333,12005,7.7
Vermilion,12/1/2012,25913,24570,1343,5.2,155628,143330,12298,7.9
Vermilion,1/1/2013,25786,24112,1674,6.5,155763,143292,12471,8
Vermilion,2/1/2013,25861,24432,1429,5.5,155312,143362,11950,7.7
Vermilion,3/1/2013,25934,24524,1410,5.4,155005,143316,11689,7.5
Vermilion,4/1/2013,26118,24730,1388,5.3,155394,143635,11760,7.6
Vermilion,5/1/2013,26217,24745,1472,5.6,155536,143882,11654,7.5
Vermilion,6/1/2013,26602,24983,1619,6.1,155749,143999,11751,7.5
Vermilion,7/1/2013,26629,25103,1526,5.7,155599,144264,11335,7.3
Vermilion,8/1/2013,26237,24860,1377,5.2,155605,144326,11279,7.2
Vermilion,9/1/2013,26179,24894,1285,4.9,155687,144418,11270,7.2
Vermilion,10/1/2013,25982,24726,1256,4.8,154673,143537,11136,7.2
Vermilion,11/1/2013,26106,24870,1236,4.7,155265,144479,10787,6.9
Vermilion,12/1/2013,25973,24869,1104,4.3,155182,144778,10404,6.7
Vermilion,1/1/2014,25786,24495,1291,5,155352,145150,10202,6.6
Vermilion,2/1/2014,25897,24694,1203,4.6,155483,145134,10349,6.7
Vermilion,3/1/2014,26094,24815,1279,4.9,156028,145648,10380,6.7
Vermilion,4/1/2014,26202,25009,1193,4.6,155369,145667,9702,6.2
Vermilion,5/1/2014,26249,24914,1335,5.1,155684,145825,9859,6.3
Vermilion,6/1/2014,26516,24991,1525,5.8,155707,146247,9460,6.1
Vermilion,7/1/2014,26821,25173,1648,6.1,156007,146399,9608,6.2
Vermilion,8/1/2014,26625,25017,1608,6,156130,146530,9599,6.1
Vermilion,9/1/2014,26577,25040,1537,5.8,156040,146778,9262,5.9
Vermilion,10/1/2014,26701,25155,1546,5.8,156417,147427,8990,5.7
Vermilion,11/1/2014,26654,25029,1625,6.1,156494,147404,9090,5.8
Vermilion,12/1/2014,26544,25019,1525,5.7,156332,147615,8717,5.6
Vermilion,1/1/2015,26201,24449,1752,6.7,157030,148145,8885,5.7
Vermilion,2/1/2015,26016,24312,1704,6.5,156644,148045,8599,5.5
Vermilion,3/1/2015,26071,24354,1717,6.6,156643,148128,8515,5.4
Vermilion,4/1/2015,25958,24221,1737,6.7,157060,148511,8550,5.4
Vermilion,5/1/2015,26063,24235,1828,7,157651,148817,8834,5.6
Vermilion,6/1/2015,26122,24160,1962,7.5,157062,148816,8247,5.3
Vermilion,7/1/2015,25875,23988,1887,7.3,156997,148830,8167,5.2
Vermilion,8/1/2015,25508,23775,1733,6.8,157172,149181,7992,5.1
Vermilion,9/1/2015,25202,23474,1728,6.9,156733,148826,7907,5
Vermilion,10/1/2015,25291,23515,1776,7,157167,149246,7922,5
Vermilion,11/1/2015,25152,23431,1721,6.8,157463,149463,8000,5.1
Vermilion,12/1/2015,25033,23378,1655,6.6,158035,150128,7907,5
Vermilion,1/1/2016,24951,23013,1938,7.8,158280,150653,7627,4.8
Vermilion,2/1/2016,24916,23052,1864,7.5,158640,150939,7702,4.9
Vermilion,3/1/2016,25105,23148,1957,7.8,159179,151218,7961,5
Vermilion,4/1/2016,24902,23045,1857,7.5,159141,151074,8067,5.1
Vermilion,5/1/2016,24933,23063,1870,7.5,158784,151132,7652,4.8
Vermilion,6/1/2016,25112,23003,2109,8.4,158967,151223,7744,4.9
Vermilion,7/1/2016,24993,22983,2010,8,159194,151554,7641,4.8
Vermilion,8/1/2016,24477,22594,1883,7.7,159562,151779,7784,4.9
Vermilion,9/1/2016,24361,22436,1925,7.9,159714,151761,7953,5
Vermilion,10/1/2016,24227,22478,1749,7.2,159605,151793,7811,4.9
Vermilion,11/1/2016,24202,22568,1634,6.8,159506,151954,7553,4.7
Vermilion,12/1/2016,24135,22486,1649,6.8,159678,152157,7521,4.7
Vermilion,1/1/2017,23977,22174,1803,7.5,159620,152152,7468,4.7
Vermilion,2/1/2017,24131,22455,1676,6.9,159859,152480,7379,4.6
Vermilion,3/1/2017,24314,22711,1603,6.6,160137,153065,7073,4.4
Vermilion,4/1/2017,24384,22883,1501,6.2,160345,153255,7089,4.4
Vermilion,5/1/2017,24355,22899,1456,6,160068,153069,7000,4.4
Vermilion,6/1/2017,24663,23066,1597,6.5,160192,153318,6873,4.3
Vermilion,7/1/2017,24692,23160,1532,6.2,160462,153569,6892,4.3
Vermilion,8/1/2017,24235,22800,1435,5.9,160586,153503,7082,4.4
Vermilion,9/1/2017,24077,22766,1311,5.4,161140,154286,6854,4.3
Vermilion,10/1/2017,23899,22717,1182,4.9,160309,153609,6700,4.2
Vermilion,11/1/2017,23864,22710,1154,4.8,160579,153805,6774,4.2
Vermilion,12/1/2017,23747,22610,1137,4.8,160535,153904,6632,4.1
Vermilion,1/1/2018,23744,22442,1302,5.5,160914,154425,6489,4
Vermilion,2/1/2018,23956,22686,1270,5.3,161778,155197,6581,4.1
Vermilion,3/1/2018,24175,22886,1289,5.3,161686,155214,6472,4
Vermilion,4/1/2018,24281,23051,1230,5.1,161771,155312,6459,4
Vermilion,5/1/2018,24302,23065,1237,5.1,161848,155652,6196,3.8
Vermilion,6/1/2018,24636,23065,1571,6.4,162210,155762,6447,4
Vermilion,7/1/2018,24781,23335,1446,5.8,162341,156146,6195,3.8
Vermilion,8/1/2018,24161,22856,1305,5.4,161660,155504,6156,3.8
Vermilion,9/1/2018,23983,22775,1208,5,162087,156015,6073,3.7
Vermilion,10/1/2018,24125,22972,1153,4.8,162602,156391,6211,3.8
Vermilion,11/1/2018,24027,22922,1105,4.6,162836,156721,6115,3.8
Vermilion,12/1/2018,23913,22791,1122,4.7,163206,156817,6389,3.9
Vermilion,1/1/2019,23626,22307,1319,5.6,162963,156487,6475,4
Vermilion,2/1/2019,23704,22581,1123,4.7,162999,156863,6136,3.8
Vermilion,3/1/2019,23873,22812,1061,4.4,162904,156701,6202,3.8
Vermilion,4/1/2019,23892,22920,972,4.1,162586,156625,5961,3.7
Vermilion,5/1/2019,23963,22861,1102,4.6,162751,156821,5930,3.6
Vermilion,6/1/2019,24384,23049,1335,5.5,163168,157232,5935,3.6
Vermilion,7/1/2019,24457,23143,1314,5.4,163590,157529,6061,3.7
Vermilion,8/1/2019,24199,22980,1219,5,163774,157829,5945,3.6
Vermilion,9/1/2019,24196,23027,1169,4.8,164092,158339,5753,3.5
Vermilion,10/1/2019,24187,23019,1168,4.8,164416,158545,5871,3.6
Vermilion,11/1/2019,24006,22894,1112,4.6,164496,158629,5868,3.6
Vermilion,12/1/2019,23799,22687,1112,4.7,164699,158845,5853,3.6
Vermilion,1/1/2020,23587,22378,1209,5.1,164377,158508,5869,3.6
Vermilion,2/1/2020,23497,22519,978,4.2,164467,158714,5753,3.5
Vermilion,3/1/2020,24017,22281,1736,7.2,162559,155353,7206,4.4
Vermilion,4/1/2020,22403,19907,2496,11.1,156269,133185,23084,14.8
Vermilion,5/1/2020,22782,20445,2337,10.3,158101,137173,20929,13.2
Vermilion,6/1/2020,23462,21135,2327,9.9,159994,142342,17652,11
Vermilion,7/1/2020,23658,21401,2257,9.5,160132,143779,16352,10.2
Vermilion,8/1/2020,23485,21594,1891,8.1,160706,147245,13461,8.4
Vermilion,9/1/2020,23531,21618,1913,8.1,160174,147620,12554,7.8
Vermilion,10/1/2020,23673,21968,1705,7.2,161003,149931,11072,6.9
Vermilion,11/1/2020,23509,21975,1534,6.5,160629,149934,10694,6.7
Vermilion,12/1/2020,23544,21933,1611,6.8,160745,149975,10770,6.7
Vermilion,1/1/2021,23254,21619,1635,7,160088,149852,10236,6.4
Vermilion,2/1/2021,23401,21870,1531,6.5,160184,150189,9995,6.2
Vermilion,3/1/2021,23708,22237,1471,6.2,160400,150644,9756,6.1
Vermilion,4/1/2021,23730,22377,1353,5.7,160843,151081,9762,6.1
Vermilion,5/1/2021,23714,22386,1328,5.6,160800,151535,9266,5.8
Vermilion,6/1/2021,24094,22550,1544,6.4,161197,151734,9462,5.9
Vermilion,7/1/2021,24099,22784,1315,5.5,161504,152773,8731,5.4
Vermilion,8/1/2021,23686,22533,1153,4.9,161527,153250,8276,5.1
Vermilion,9/1/2021,23875,22857,1018,4.3,161495,153843,7652,4.7
Vermilion,10/1/2021,23685,22782,903,3.8,161754,154475,7279,4.5
Vermilion,11/1/2021,23609,22792,817,3.5,162281,155530,6751,4.2
Vermilion,12/1/2021,23524,22770,754,3.2,162497,156099,6398,3.9
Vermilion,1/1/2022,23472,22538,934,4,163627,157115,6512,4
Vermilion,2/1/2022,23561,22707,854,3.6,163899,157598,6301,3.8
Vermilion,3/1/2022,23924,23096,828,3.5,164220,158206,6014,3.7
Vermilion,4/1/2022,23912,23148,764,3.2,163893,157891,6002,3.7
Vermilion,5/1/2022,23986,23179,807,3.4,164362,158378,5983,3.6
Vermilion,6/1/2022,24205,23135,1070,4.4,164046,158094,5951,3.6
Vermilion,7/1/2022,24201,23248,953,3.9,164026,158258,5768,3.5
Vermilion,8/1/2022,23812,22941,871,3.7,164654,158735,5919,3.6
Vermilion,9/1/2022,23821,22992,829,3.5,164602,158810,5792,3.5
Vermilion,10/1/2022,23879,23109,770,3.2,164648,158684,5964,3.6
Vermilion,11/1/2022,23793,23088,705,3,164450,158507,5943,3.6
Vermilion,12/1/2022,23764,23013,751,3.2,165025,159259,5766,3.5
Vermilion,1/1/2023,23669,22805,864,3.7,165964,160217,5747,3.5
Vermilion,2/1/2023,23773,22917,856,3.6,166358,160395,5962,3.6
Vermilion,3/1/2023,23922,23110,812,3.4,166651,160812,5839,3.5
Vermilion,4/1/2023,23998,23256,742,3.1,166725,160974,5751,3.4
Vermilion,5/1/2023,23992,23133,859,3.6,166886,160796,6089,3.6
Vermilion,6/1/2023,24235,23223,1012,4.2,166937,160979,5958,3.6
Vermilion,7/1/2023,24147,23298,849,3.5,167103,161183,5920,3.5
Vermilion,8/1/2023,23978,23083,895,3.7,167759,161475,6284,3.7
Vermilion,9/1/2023,24076,23126,950,3.9,167767,161442,6326,3.8
Vermilion,10/1/2023,24058,23121,937,3.9,167690,161211,6479,3.9
Vermilion,11/1/2023,24063,23193,870,3.6,168140,161886,6254,3.7
Vermilion,12/1/2023,23923,22995,928,3.9,167439,161124,6315,3.8
Vermilion,1/1/2024,23930,22885,1045,4.4,167339,161190,6149,3.7
Vermilion,2/1/2024,23915,22891,1024,4.3,167475,161013,6462,3.9
Vermilion,3/1/2024,24137,23137,1000,4.1,167922,161425,6497,3.9
Vermilion,4/1/2024,24140,23271,869,3.6,167988,161495,6492,3.9
Vermilion,5/1/2024,24027,23133,894,3.7,167799,161164,6635,4
Vermilion,6/1/2024,24387,23209,1178,4.8,168005,161155,6849,4.1
Vermilion,7/1/2024,24573,23413,1160,4.7,168315,161219,7097,4.2
Vermilion,8/1/2024,24291,23128,1163,4.8,168496,161425,7071,4.2
Vermilion,9/1/2024,24153,23022,1131,4.7,168703,161802,6901,4.1
Vermilion,10/1/2024,24113,23002,1111,4.6,168428,161456,6972,4.1
Vermilion,11/1/2024,24110,23019,1091,4.5,168304,161183,7121,4.2
Vermilion,12/1/2024,23993,22976,1017,4.2,168547,161661,6886,4.1
Vermilion,1/1/2025,24580,23581,999,4.1,170744,163895,6849,4
Vermilion,2/1/2025,24693,23690,1003,4.1,170359,163307,7052,4.1
Vernon,1/1/1990,16420,15371,1049,6.4,125833,119081,6752,5.4
Vernon,2/1/1990,16297,15313,984,6,125710,119059,6651,5.3
Vernon,3/1/1990,16566,15576,990,6,125801,119203,6598,5.2
Vernon,4/1/1990,16439,15476,963,5.9,125649,118852,6797,5.4
Vernon,5/1/1990,16528,15525,1003,6.1,125893,119151,6742,5.4
Vernon,6/1/1990,16661,15483,1178,7.1,125573,118983,6590,5.2
Vernon,7/1/1990,16848,15673,1175,7,125732,118810,6922,5.5
Vernon,8/1/1990,16867,15627,1240,7.4,125990,118802,7188,5.7
Vernon,9/1/1990,16645,15340,1305,7.8,125892,118524,7368,5.9
Vernon,10/1/1990,15710,14358,1352,8.6,125995,118536,7459,5.9
Vernon,11/1/1990,15744,14506,1238,7.9,126070,118306,7764,6.2
Vernon,12/1/1990,15737,14576,1161,7.4,126142,118241,7901,6.3
Vernon,1/1/1991,15840,14614,1226,7.7,125955,117940,8015,6.4
Vernon,2/1/1991,15659,14516,1143,7.3,126020,117755,8265,6.6
Vernon,3/1/1991,15571,14451,1120,7.2,126238,117652,8586,6.8
Vernon,4/1/1991,16374,15307,1067,6.5,126548,118109,8439,6.7
Vernon,5/1/1991,16210,15164,1046,6.5,126176,117440,8736,6.9
Vernon,6/1/1991,16381,15182,1199,7.3,126331,117639,8692,6.9
Vernon,7/1/1991,16111,15141,970,6,126154,117568,8586,6.8
Vernon,8/1/1991,16090,15065,1025,6.4,126150,117484,8666,6.9
Vernon,9/1/1991,15963,14866,1097,6.9,126650,117928,8722,6.9
Vernon,10/1/1991,15932,14861,1071,6.7,126642,117800,8842,7
Vernon,11/1/1991,15882,14964,918,5.8,126701,117770,8931,7
Vernon,12/1/1991,15921,14884,1037,6.5,126664,117466,9198,7.3
Vernon,1/1/1992,15674,14517,1157,7.4,127261,117978,9283,7.3
Vernon,2/1/1992,15597,14445,1152,7.4,127207,117753,9454,7.4
Vernon,3/1/1992,15738,14482,1256,8,127604,118144,9460,7.4
Vernon,4/1/1992,16774,15603,1171,7,127841,118426,9415,7.4
Vernon,5/1/1992,16714,15517,1197,7.2,128119,118375,9744,7.6
Vernon,6/1/1992,17377,15894,1483,8.5,128459,118419,10040,7.8
Vernon,7/1/1992,17743,16415,1328,7.5,128563,118713,9850,7.7
Vernon,8/1/1992,17468,16194,1274,7.3,128613,118826,9787,7.6
Vernon,9/1/1992,17255,15971,1284,7.4,128501,118720,9781,7.6
Vernon,10/1/1992,16802,15630,1172,7,128026,118628,9398,7.3
Vernon,11/1/1992,16598,15493,1105,6.7,128441,118876,9565,7.4
Vernon,12/1/1992,16253,15136,1117,6.9,128554,118997,9557,7.4
Vernon,1/1/1993,15840,14701,1139,7.2,128400,119075,9325,7.3
Vernon,2/1/1993,15735,14677,1058,6.7,128458,119275,9183,7.1
Vernon,3/1/1993,15853,14826,1027,6.5,128598,119542,9056,7
Vernon,4/1/1993,16500,15438,1062,6.4,128584,119474,9110,7.1
Vernon,5/1/1993,16621,15650,971,5.8,129264,120115,9149,7.1
Vernon,6/1/1993,17370,16124,1246,7.2,129411,120290,9121,7
Vernon,7/1/1993,17827,16599,1228,6.9,129397,120467,8930,6.9
Vernon,8/1/1993,17870,16544,1326,7.4,129619,120856,8763,6.8
Vernon,9/1/1993,17677,16290,1387,7.8,129268,120554,8714,6.7
Vernon,10/1/1993,17804,16379,1425,8,129573,120823,8750,6.8
Vernon,11/1/1993,17802,16410,1392,7.8,129711,121169,8542,6.6
Vernon,12/1/1993,17463,16211,1252,7.2,129941,121464,8477,6.5
Vernon,1/1/1994,17012,15244,1768,10.4,130596,121966,8630,6.6
Vernon,2/1/1994,16897,15274,1623,9.6,130669,122086,8583,6.6
Vernon,3/1/1994,17048,15235,1813,10.6,130400,121930,8470,6.5
Vernon,4/1/1994,16975,15336,1639,9.7,130621,122290,8331,6.4
Vernon,5/1/1994,17257,15753,1504,8.7,130779,122864,7915,6.1
Vernon,6/1/1994,17434,15773,1661,9.5,130561,122634,7927,6.1
Vernon,7/1/1994,17440,16055,1385,7.9,130652,122706,7946,6.1
Vernon,8/1/1994,17445,15975,1470,8.4,131275,123342,7933,6
Vernon,9/1/1994,17093,15743,1350,7.9,131421,123687,7734,5.9
Vernon,10/1/1994,16991,15708,1283,7.6,131744,124112,7632,5.8
Vernon,11/1/1994,16917,15734,1183,7,131891,124516,7375,5.6
Vernon,12/1/1994,16681,15544,1137,6.8,131951,124721,7230,5.5
Vernon,1/1/1995,16664,15291,1373,8.2,132038,124663,7375,5.6
Vernon,2/1/1995,16591,15481,1110,6.7,132115,124928,7187,5.4
Vernon,3/1/1995,16793,15683,1110,6.6,132108,124955,7153,5.4
Vernon,4/1/1995,17120,16020,1100,6.4,132590,124945,7645,5.8
Vernon,5/1/1995,17135,16044,1091,6.4,131851,124421,7430,5.6
Vernon,6/1/1995,17253,16129,1124,6.5,131949,124522,7427,5.6
Vernon,7/1/1995,17275,16212,1063,6.2,132343,124816,7527,5.7
Vernon,8/1/1995,17209,16133,1076,6.3,132336,124852,7484,5.7
Vernon,9/1/1995,16925,15884,1041,6.2,132611,125133,7478,5.6
Vernon,10/1/1995,16948,15812,1136,6.7,132716,125388,7328,5.5
Vernon,11/1/1995,16917,15909,1008,6,132614,125188,7426,5.6
Vernon,12/1/1995,16825,15626,1199,7.1,132511,125088,7423,5.6
Vernon,1/1/1996,17084,15786,1298,7.6,132616,125125,7491,5.6
Vernon,2/1/1996,17130,16059,1071,6.3,132952,125639,7313,5.5
Vernon,3/1/1996,17128,16182,946,5.5,133180,125862,7318,5.5
Vernon,4/1/1996,17328,16346,982,5.7,133409,125994,7415,5.6
Vernon,5/1/1996,17333,16292,1041,6,133667,126244,7423,5.6
Vernon,6/1/1996,17902,16822,1080,6,133697,126602,7095,5.3
Vernon,7/1/1996,16907,15695,1212,7.2,134284,126947,7337,5.5
Vernon,8/1/1996,16754,15576,1178,7,134054,127172,6882,5.1
Vernon,9/1/1996,16497,15323,1174,7.1,134515,127536,6979,5.2
Vernon,10/1/1996,17170,15958,1212,7.1,134921,127890,7031,5.2
Vernon,11/1/1996,17182,16106,1076,6.3,135007,127771,7236,5.4
Vernon,12/1/1996,17084,15871,1213,7.1,135113,127860,7253,5.4
Vernon,1/1/1997,17006,15768,1238,7.3,135456,128298,7158,5.3
Vernon,2/1/1997,16834,15828,1006,6,135400,128298,7102,5.2
Vernon,3/1/1997,16978,15899,1079,6.4,135891,128891,7000,5.2
Vernon,4/1/1997,17062,16046,1016,6,136016,129143,6873,5.1
Vernon,5/1/1997,16835,15802,1033,6.1,136119,129464,6655,4.9
Vernon,6/1/1997,17374,16161,1213,7,136211,129412,6799,5
Vernon,7/1/1997,15851,14774,1077,6.8,136477,129822,6655,4.9
Vernon,8/1/1997,15910,14876,1034,6.5,136618,130010,6608,4.8
Vernon,9/1/1997,16727,15650,1077,6.4,136675,130019,6656,4.9
Vernon,10/1/1997,17186,16198,988,5.7,136633,130179,6454,4.7
Vernon,11/1/1997,17107,16177,930,5.4,136961,130653,6308,4.6
Vernon,12/1/1997,16985,16061,924,5.4,137155,130679,6476,4.7
Vernon,1/1/1998,17234,16168,1066,6.2,137095,130726,6368,4.6
Vernon,2/1/1998,17159,16241,918,5.3,137112,130807,6306,4.6
Vernon,3/1/1998,17369,16378,991,5.7,137236,130814,6422,4.7
Vernon,4/1/1998,17412,16425,987,5.7,137150,131209,5941,4.3
Vernon,5/1/1998,17320,16350,970,5.6,137372,131325,6047,4.4
Vernon,6/1/1998,17700,16659,1041,5.9,137455,131244,6212,4.5
Vernon,7/1/1998,16611,15588,1023,6.2,137588,131329,6259,4.5
Vernon,8/1/1998,16343,15317,1026,6.3,137570,131390,6179,4.5
Vernon,9/1/1998,17300,16032,1268,7.3,138286,131986,6300,4.6
Vernon,10/1/1998,17475,16416,1059,6.1,138279,131999,6280,4.5
Vernon,11/1/1998,17187,16267,920,5.4,138381,132280,6100,4.4
Vernon,12/1/1998,17350,16307,1043,6,138634,132602,6032,4.4
Vernon,1/1/1999,17037,15957,1080,6.3,139003,133027,5976,4.3
Vernon,2/1/1999,16929,15979,950,5.6,138967,132856,6111,4.4
Vernon,3/1/1999,16978,16067,911,5.4,138730,132947,5783,4.2
Vernon,4/1/1999,16707,15701,1006,6,138959,132955,6004,4.3
Vernon,5/1/1999,17011,16190,821,4.8,139107,133311,5796,4.2
Vernon,6/1/1999,17493,16532,961,5.5,139329,133378,5951,4.3
Vernon,7/1/1999,16860,15756,1104,6.5,139439,133414,6025,4.3
Vernon,8/1/1999,16773,15803,970,5.8,139430,133591,5838,4.2
Vernon,9/1/1999,16681,15703,978,5.9,139622,133707,5915,4.2
Vernon,10/1/1999,17162,16238,924,5.4,139771,133993,5778,4.1
Vernon,11/1/1999,16998,16268,730,4.3,140025,134309,5716,4.1
Vernon,12/1/1999,16996,16131,865,5.1,140177,134523,5653,4
Vernon,1/1/2000,18137,17062,1075,5.9,142267,136559,5708,4
Vernon,2/1/2000,18100,17164,936,5.2,142456,136598,5858,4.1
Vernon,3/1/2000,18363,17310,1053,5.7,142434,136701,5733,4
Vernon,4/1/2000,17993,17071,922,5.1,142751,137270,5481,3.8
Vernon,5/1/2000,18221,17173,1048,5.8,142388,136630,5758,4
Vernon,6/1/2000,18434,17157,1277,6.9,142591,136940,5651,4
Vernon,7/1/2000,18373,17196,1177,6.4,142278,136531,5747,4
Vernon,8/1/2000,18245,17089,1156,6.3,142514,136662,5853,4.1
Vernon,9/1/2000,18039,16919,1120,6.2,142518,136893,5625,3.9
Vernon,10/1/2000,18301,17185,1116,6.1,142622,137088,5534,3.9
Vernon,11/1/2000,18292,17229,1063,5.8,142962,137322,5639,3.9
Vernon,12/1/2000,18160,17074,1086,6,143248,137614,5634,3.9
Vernon,1/1/2001,17997,16690,1307,7.3,143800,137778,6023,4.2
Vernon,2/1/2001,17936,16829,1107,6.2,143701,137612,6089,4.2
Vernon,3/1/2001,18371,17208,1163,6.3,143924,137783,6141,4.3
Vernon,4/1/2001,18424,17330,1094,5.9,143569,137299,6271,4.4
Vernon,5/1/2001,18278,17195,1083,5.9,143318,137092,6226,4.3
Vernon,6/1/2001,18959,17721,1238,6.5,143357,136873,6484,4.5
Vernon,7/1/2001,18649,17423,1226,6.6,143654,137071,6583,4.6
Vernon,8/1/2001,18704,17570,1134,6.1,143284,136241,7042,4.9
Vernon,9/1/2001,18706,17516,1190,6.4,143989,136846,7142,5
Vernon,10/1/2001,18703,17486,1217,6.5,144086,136392,7694,5.3
Vernon,11/1/2001,18675,17380,1295,6.9,144240,136238,8003,5.5
Vernon,12/1/2001,18631,17412,1219,6.5,144305,136047,8258,5.7
Vernon,1/1/2002,18426,17170,1256,6.8,143883,135701,8182,5.7
Vernon,2/1/2002,18411,17281,1130,6.1,144653,136438,8215,5.7
Vernon,3/1/2002,18510,17344,1166,6.3,144481,136177,8304,5.7
Vernon,4/1/2002,18500,17306,1194,6.5,144725,136126,8599,5.9
Vernon,5/1/2002,18362,17145,1217,6.6,144938,136539,8399,5.8
Vernon,6/1/2002,18771,17417,1354,7.2,144808,136415,8393,5.8
Vernon,7/1/2002,18914,17611,1303,6.9,144803,136413,8390,5.8
Vernon,8/1/2002,18724,17509,1215,6.5,145009,136705,8304,5.7
Vernon,9/1/2002,18638,17460,1178,6.3,145552,137302,8251,5.7
Vernon,10/1/2002,18284,17186,1098,6,145314,137008,8307,5.7
Vernon,11/1/2002,18243,17076,1167,6.4,145041,136521,8520,5.9
Vernon,12/1/2002,18216,17045,1171,6.4,145066,136426,8640,6
Vernon,1/1/2003,18356,17045,1311,7.1,145937,137417,8520,5.8
Vernon,2/1/2003,18291,17083,1208,6.6,146100,137482,8618,5.9
Vernon,3/1/2003,18455,17210,1245,6.7,146022,137434,8588,5.9
Vernon,4/1/2003,18829,17692,1137,6,146474,137633,8842,6
Vernon,5/1/2003,18752,17562,1190,6.3,146500,137544,8957,6.1
Vernon,6/1/2003,19211,17764,1447,7.5,147056,137790,9266,6.3
Vernon,7/1/2003,19039,17692,1347,7.1,146485,137474,9011,6.2
Vernon,8/1/2003,18820,17628,1192,6.3,146445,137549,8896,6.1
Vernon,9/1/2003,18518,17309,1209,6.5,146530,137609,8921,6.1
Vernon,10/1/2003,18839,17736,1103,5.9,146716,137984,8732,6
Vernon,11/1/2003,18745,17731,1014,5.4,147000,138424,8576,5.8
Vernon,12/1/2003,18596,17598,998,5.4,146729,138411,8317,5.7
Vernon,1/1/2004,19191,18091,1100,5.7,146842,138472,8370,5.7
Vernon,2/1/2004,19211,18264,947,4.9,146709,138542,8167,5.6
Vernon,3/1/2004,19294,18304,990,5.1,146944,138453,8491,5.8
Vernon,4/1/2004,19324,18321,1003,5.2,146850,138680,8170,5.6
Vernon,5/1/2004,19246,18145,1101,5.7,147065,138852,8212,5.6
Vernon,6/1/2004,19800,18510,1290,6.5,147460,139174,8286,5.6
Vernon,7/1/2004,19645,18464,1181,6,147692,139556,8136,5.5
Vernon,8/1/2004,19619,18713,906,4.6,147564,139573,7990,5.4
Vernon,9/1/2004,19477,18572,905,4.6,147415,139487,7927,5.4
Vernon,10/1/2004,20484,19607,877,4.3,147793,139732,8061,5.5
Vernon,11/1/2004,20614,19699,915,4.4,148162,140231,7932,5.4
Vernon,12/1/2004,20519,19597,922,4.5,148059,140125,7934,5.4
Vernon,1/1/2005,20059,19043,1016,5.1,148029,140245,7784,5.3
Vernon,2/1/2005,20112,19181,931,4.6,148364,140385,7980,5.4
Vernon,3/1/2005,20177,19256,921,4.6,148391,140654,7737,5.2
Vernon,4/1/2005,20505,19645,860,4.2,148926,141254,7672,5.2
Vernon,5/1/2005,20568,19617,951,4.6,149261,141609,7651,5.1
Vernon,6/1/2005,20921,19803,1118,5.3,149238,141714,7524,5
Vernon,7/1/2005,21021,19660,1361,6.5,149432,142026,7406,5
Vernon,8/1/2005,20508,19494,1014,4.9,149779,142434,7345,4.9
Vernon,9/1/2005,22922,21164,1758,7.7,149954,142401,7553,5
Vernon,10/1/2005,23665,21715,1950,8.2,150001,142548,7453,5
Vernon,11/1/2005,22649,20867,1782,7.9,150065,142499,7566,5
Vernon,12/1/2005,21683,20527,1156,5.3,150030,142752,7279,4.9
Vernon,1/1/2006,21638,20643,995,4.6,150214,143150,7064,4.7
Vernon,2/1/2006,21461,20852,609,2.8,150641,143457,7184,4.8
Vernon,3/1/2006,21521,20864,657,3.1,150813,143741,7072,4.7
Vernon,4/1/2006,22501,21869,632,2.8,150881,143761,7120,4.7
Vernon,5/1/2006,22611,21897,714,3.2,151069,144089,6980,4.6
Vernon,6/1/2006,22818,21952,866,3.8,151354,144353,7001,4.6
Vernon,7/1/2006,21897,20867,1030,4.7,151377,144202,7175,4.7
Vernon,8/1/2006,21413,20644,769,3.6,151716,144625,7091,4.7
Vernon,9/1/2006,21965,21025,940,4.3,151662,144815,6847,4.5
Vernon,10/1/2006,21476,20683,793,3.7,152041,145314,6727,4.4
Vernon,11/1/2006,21423,20629,794,3.7,152406,145534,6872,4.5
Vernon,12/1/2006,20870,19911,959,4.6,152732,145970,6762,4.4
Vernon,1/1/2007,21157,20120,1037,4.9,153144,146028,7116,4.6
Vernon,2/1/2007,21197,20215,982,4.6,152983,146057,6927,4.5
Vernon,3/1/2007,21281,20476,805,3.8,153051,146320,6731,4.4
Vernon,4/1/2007,21223,20426,797,3.8,152435,145586,6850,4.5
Vernon,5/1/2007,21226,20370,856,4,152670,145903,6766,4.4
Vernon,6/1/2007,21326,20353,973,4.6,153041,146063,6979,4.6
Vernon,7/1/2007,21532,20557,975,4.5,153054,145905,7149,4.7
Vernon,8/1/2007,21297,20454,843,4,152749,145682,7067,4.6
Vernon,9/1/2007,21271,20118,1153,5.4,153414,146244,7170,4.7
Vernon,10/1/2007,21031,20308,723,3.4,153183,145946,7237,4.7
Vernon,11/1/2007,21249,20211,1038,4.9,153835,146595,7240,4.7
Vernon,12/1/2007,21159,20018,1141,5.4,153918,146273,7645,5
Vernon,1/1/2008,20199,19234,965,4.8,154063,146378,7685,5
Vernon,2/1/2008,20275,19475,800,3.9,153653,146156,7497,4.9
Vernon,3/1/2008,20629,19760,869,4.2,153908,146086,7822,5.1
Vernon,4/1/2008,20570,19712,858,4.2,153769,146132,7637,5
Vernon,5/1/2008,21394,20554,840,3.9,154303,145908,8395,5.4
Vernon,6/1/2008,21174,20129,1045,4.9,154313,145737,8575,5.6
Vernon,7/1/2008,20613,19326,1287,6.2,154469,145532,8937,5.8
Vernon,8/1/2008,20842,19866,976,4.7,154641,145203,9438,6.1
Vernon,9/1/2008,21222,20262,960,4.5,154570,145076,9494,6.1
Vernon,10/1/2008,20958,19976,982,4.7,154876,144802,10074,6.5
Vernon,11/1/2008,20946,19996,950,4.5,154639,144100,10538,6.8
Vernon,12/1/2008,20946,19955,991,4.7,154655,143369,11286,7.3
Vernon,1/1/2009,20347,19138,1209,5.9,154210,142152,12058,7.8
Vernon,2/1/2009,20495,19294,1201,5.9,154538,141640,12898,8.3
Vernon,3/1/2009,20554,18904,1650,8,154133,140707,13426,8.7
Vernon,4/1/2009,21043,19769,1274,6.1,154509,140656,13853,9
Vernon,5/1/2009,21158,19859,1299,6.1,154747,140248,14499,9.4
Vernon,6/1/2009,21427,19898,1529,7.1,154716,140009,14707,9.5
Vernon,7/1/2009,21523,20100,1423,6.6,154502,139901,14601,9.5
Vernon,8/1/2009,21073,19661,1412,6.7,154307,139492,14814,9.6
Vernon,9/1/2009,20546,19197,1349,6.6,153827,138818,15009,9.8
Vernon,10/1/2009,20198,18813,1385,6.9,153784,138432,15352,10
Vernon,11/1/2009,20538,19332,1206,5.9,153878,138659,15219,9.9
Vernon,12/1/2009,19901,18476,1425,7.2,153111,138013,15098,9.9
Vernon,1/1/2010,18393,16948,1445,7.9,153484,138438,15046,9.8
Vernon,2/1/2010,18170,16931,1239,6.8,153694,138581,15113,9.8
Vernon,3/1/2010,18680,17415,1265,6.8,153954,138751,15202,9.9
Vernon,4/1/2010,18530,17203,1327,7.2,154622,139297,15325,9.9
Vernon,5/1/2010,18686,17324,1362,7.3,154091,139241,14849,9.6
Vernon,6/1/2010,18872,17342,1530,8.1,153616,139141,14474,9.4
Vernon,7/1/2010,19159,17697,1462,7.6,153691,139179,14512,9.4
Vernon,8/1/2010,18816,17034,1782,9.5,154086,139438,14648,9.5
Vernon,9/1/2010,19132,17435,1697,8.9,153975,139396,14579,9.5
Vernon,10/1/2010,18528,16941,1587,8.6,153635,139119,14516,9.4
Vernon,11/1/2010,18328,16842,1486,8.1,154125,139044,15081,9.8
Vernon,12/1/2010,17625,15930,1695,9.6,153650,139301,14348,9.3
Vernon,1/1/2011,19218,17577,1641,8.5,153263,139250,14013,9.1
Vernon,2/1/2011,19300,17870,1430,7.4,153214,139394,13820,9
Vernon,3/1/2011,18824,17367,1457,7.7,153376,139639,13737,9
Vernon,4/1/2011,18860,17204,1656,8.8,153543,139586,13957,9.1
Vernon,5/1/2011,19288,17768,1520,7.9,153479,139624,13855,9
Vernon,6/1/2011,19855,18023,1832,9.2,153346,139384,13962,9.1
Vernon,7/1/2011,19719,17848,1871,9.5,153288,139524,13763,9
Vernon,8/1/2011,19336,17843,1493,7.7,153760,139942,13818,9
Vernon,9/1/2011,19532,17617,1915,9.8,154131,140183,13948,9
Vernon,10/1/2011,19394,17527,1867,9.6,153961,140368,13594,8.8
Vernon,11/1/2011,19279,17899,1380,7.2,154128,140826,13302,8.6
Vernon,12/1/2011,19236,17646,1590,8.3,153995,140902,13093,8.5
Vernon,1/1/2012,19256,17646,1610,8.4,154381,141584,12797,8.3
Vernon,2/1/2012,19078,17637,1441,7.6,154671,141858,12813,8.3
Vernon,3/1/2012,19529,18115,1414,7.2,154749,142036,12713,8.2
Vernon,4/1/2012,19043,17526,1517,8,154545,141899,12646,8.2
Vernon,5/1/2012,19207,17758,1449,7.5,154866,142206,12660,8.2
Vernon,6/1/2012,19716,18033,1683,8.5,155083,142391,12692,8.2
Vernon,7/1/2012,19429,17839,1590,8.2,154948,142292,12656,8.2
Vernon,8/1/2012,18769,17303,1466,7.8,154763,142291,12471,8.1
Vernon,9/1/2012,18420,16941,1479,8,155160,143044,12115,7.8
Vernon,10/1/2012,18417,16969,1448,7.9,155554,143431,12124,7.8
Vernon,11/1/2012,18846,17610,1236,6.6,155338,143333,12005,7.7
Vernon,12/1/2012,18035,16508,1527,8.5,155628,143330,12298,7.9
Vernon,1/1/2013,18620,16959,1661,8.9,155763,143292,12471,8
Vernon,2/1/2013,18415,16971,1444,7.8,155312,143362,11950,7.7
Vernon,3/1/2013,18265,16846,1419,7.8,155005,143316,11689,7.5
Vernon,4/1/2013,17608,15996,1612,9.2,155394,143635,11760,7.6
Vernon,5/1/2013,18332,16902,1430,7.8,155536,143882,11654,7.5
Vernon,6/1/2013,18714,17111,1603,8.6,155749,143999,11751,7.5
Vernon,7/1/2013,18021,16229,1792,9.9,155599,144264,11335,7.3
Vernon,8/1/2013,17464,15978,1486,8.5,155605,144326,11279,7.2
Vernon,9/1/2013,17349,15707,1642,9.5,155687,144418,11270,7.2
Vernon,10/1/2013,17214,15661,1553,9,154673,143537,11136,7.2
Vernon,11/1/2013,17535,16336,1199,6.8,155265,144479,10787,6.9
Vernon,12/1/2013,16845,15601,1244,7.4,155182,144778,10404,6.7
Vernon,1/1/2014,17193,15963,1230,7.2,155352,145150,10202,6.6
Vernon,2/1/2014,16698,15350,1348,8.1,155483,145134,10349,6.7
Vernon,3/1/2014,17123,15916,1207,7,156028,145648,10380,6.7
Vernon,4/1/2014,17164,16028,1136,6.6,155369,145667,9702,6.2
Vernon,5/1/2014,17031,15583,1448,8.5,155684,145825,9859,6.3
Vernon,6/1/2014,17701,16227,1474,8.3,155707,146247,9460,6.1
Vernon,7/1/2014,18158,16458,1700,9.4,156007,146399,9608,6.2
Vernon,8/1/2014,17666,16132,1534,8.7,156130,146530,9599,6.1
Vernon,9/1/2014,17368,15785,1583,9.1,156040,146778,9262,5.9
Vernon,10/1/2014,17241,15582,1659,9.6,156417,147427,8990,5.7
Vernon,11/1/2014,17233,15647,1586,9.2,156494,147404,9090,5.8
Vernon,12/1/2014,17396,15925,1471,8.5,156332,147615,8717,5.6
Vernon,1/1/2015,17273,15768,1505,8.7,157030,148145,8885,5.7
Vernon,2/1/2015,17550,16168,1382,7.9,156644,148045,8599,5.5
Vernon,3/1/2015,17528,16147,1381,7.9,156643,148128,8515,5.4
Vernon,4/1/2015,17501,16185,1316,7.5,157060,148511,8550,5.4
Vernon,5/1/2015,17644,16271,1373,7.8,157651,148817,8834,5.6
Vernon,6/1/2015,18105,16672,1433,7.9,157062,148816,8247,5.3
Vernon,7/1/2015,17876,16370,1506,8.4,156997,148830,8167,5.2
Vernon,8/1/2015,17273,15993,1280,7.4,157172,149181,7992,5.1
Vernon,9/1/2015,17165,15891,1274,7.4,156733,148826,7907,5
Vernon,10/1/2015,17008,15780,1228,7.2,157167,149246,7922,5
Vernon,11/1/2015,16920,15769,1151,6.8,157463,149463,8000,5.1
Vernon,12/1/2015,16253,15068,1185,7.3,158035,150128,7907,5
Vernon,1/1/2016,17206,15930,1276,7.4,158280,150653,7627,4.8
Vernon,2/1/2016,17312,16162,1150,6.6,158640,150939,7702,4.9
Vernon,3/1/2016,17245,16105,1140,6.6,159179,151218,7961,5
Vernon,4/1/2016,17096,16044,1052,6.2,159141,151074,8067,5.1
Vernon,5/1/2016,17071,15978,1093,6.4,158784,151132,7652,4.8
Vernon,6/1/2016,17524,16069,1455,8.3,158967,151223,7744,4.9
Vernon,7/1/2016,17426,15982,1444,8.3,159194,151554,7641,4.8
Vernon,8/1/2016,16240,14943,1297,8,159562,151779,7784,4.9
Vernon,9/1/2016,16443,15204,1239,7.5,159714,151761,7953,5
Vernon,10/1/2016,16798,15688,1110,6.6,159605,151793,7811,4.9
Vernon,11/1/2016,16501,15340,1161,7,159506,151954,7553,4.7
Vernon,12/1/2016,16213,14991,1222,7.5,159678,152157,7521,4.7
Vernon,1/1/2017,16649,15290,1359,8.2,159620,152152,7468,4.7
Vernon,2/1/2017,16477,15459,1018,6.2,159859,152480,7379,4.6
Vernon,3/1/2017,16572,15550,1022,6.2,160137,153065,7073,4.4
Vernon,4/1/2017,16311,15218,1093,6.7,160345,153255,7089,4.4
Vernon,5/1/2017,16419,15329,1090,6.6,160068,153069,7000,4.4
Vernon,6/1/2017,16700,15585,1115,6.7,160192,153318,6873,4.3
Vernon,7/1/2017,16643,15414,1229,7.4,160462,153569,6892,4.3
Vernon,8/1/2017,15891,14834,1057,6.7,160586,153503,7082,4.4
Vernon,9/1/2017,16396,15247,1149,7,161140,154286,6854,4.3
Vernon,10/1/2017,16037,15189,848,5.3,160309,153609,6700,4.2
Vernon,11/1/2017,16001,15123,878,5.5,160579,153805,6774,4.2
Vernon,12/1/2017,16120,15212,908,5.6,160535,153904,6632,4.1
Vernon,1/1/2018,16286,15218,1068,6.6,160914,154425,6489,4
Vernon,2/1/2018,16028,15132,896,5.6,161778,155197,6581,4.1
Vernon,3/1/2018,15931,15032,899,5.6,161686,155214,6472,4
Vernon,4/1/2018,16060,15148,912,5.7,161771,155312,6459,4
Vernon,5/1/2018,15936,14942,994,6.2,161848,155652,6196,3.8
Vernon,6/1/2018,16479,15085,1394,8.5,162210,155762,6447,4
Vernon,7/1/2018,16076,14975,1101,6.8,162341,156146,6195,3.8
Vernon,8/1/2018,15633,14633,1000,6.4,161660,155504,6156,3.8
Vernon,9/1/2018,15696,14751,945,6,162087,156015,6073,3.7
Vernon,10/1/2018,15687,14656,1031,6.6,162602,156391,6211,3.8
Vernon,11/1/2018,15555,14658,897,5.8,162836,156721,6115,3.8
Vernon,12/1/2018,15584,14471,1113,7.1,163206,156817,6389,3.9
Vernon,1/1/2019,15941,14866,1075,6.7,162963,156487,6475,4
Vernon,2/1/2019,15459,14624,835,5.4,162999,156863,6136,3.8
Vernon,3/1/2019,15527,14730,797,5.1,162904,156701,6202,3.8
Vernon,4/1/2019,15438,14705,733,4.7,162586,156625,5961,3.7
Vernon,5/1/2019,15605,14781,824,5.3,162751,156821,5930,3.6
Vernon,6/1/2019,16043,15049,994,6.2,163168,157232,5935,3.6
Vernon,7/1/2019,16141,15026,1115,6.9,163590,157529,6061,3.7
Vernon,8/1/2019,16077,14999,1078,6.7,163774,157829,5945,3.6
Vernon,9/1/2019,16089,15197,892,5.5,164092,158339,5753,3.5
Vernon,10/1/2019,15834,14918,916,5.8,164416,158545,5871,3.6
Vernon,11/1/2019,15849,14979,870,5.5,164496,158629,5868,3.6
Vernon,12/1/2019,15392,14557,835,5.4,164699,158845,5853,3.6
Vernon,1/1/2020,15843,14884,959,6.1,164377,158508,5869,3.6
Vernon,2/1/2020,15754,14860,894,5.7,164467,158714,5753,3.5
Vernon,3/1/2020,15917,14287,1630,10.2,162559,155353,7206,4.4
Vernon,4/1/2020,14751,13338,1413,9.6,156269,133185,23084,14.8
Vernon,5/1/2020,15329,13866,1463,9.5,158101,137173,20929,13.2
Vernon,6/1/2020,15889,14488,1401,8.8,159994,142342,17652,11
Vernon,7/1/2020,15861,14429,1432,9,160132,143779,16352,10.2
Vernon,8/1/2020,15921,14780,1141,7.2,160706,147245,13461,8.4
Vernon,9/1/2020,15775,14552,1223,7.8,160174,147620,12554,7.8
Vernon,10/1/2020,15888,14929,959,6,161003,149931,11072,6.9
Vernon,11/1/2020,15902,15065,837,5.3,160629,149934,10694,6.7
Vernon,12/1/2020,15394,14442,952,6.2,160745,149975,10770,6.7
Vernon,1/1/2021,15491,14451,1040,6.7,160088,149852,10236,6.4
Vernon,2/1/2021,15821,14964,857,5.4,160184,150189,9995,6.2
Vernon,3/1/2021,15908,15106,802,5,160400,150644,9756,6.1
Vernon,4/1/2021,15935,15201,734,4.6,160843,151081,9762,6.1
Vernon,5/1/2021,15554,14710,844,5.4,160800,151535,9266,5.8
Vernon,6/1/2021,16133,15244,889,5.5,161197,151734,9462,5.9
Vernon,7/1/2021,16116,15303,813,5,161504,152773,8731,5.4
Vernon,8/1/2021,15949,15227,722,4.5,161527,153250,8276,5.1
Vernon,9/1/2021,16322,15659,663,4.1,161495,153843,7652,4.7
Vernon,10/1/2021,15671,15040,631,4,161754,154475,7279,4.5
Vernon,11/1/2021,15698,15143,555,3.5,162281,155530,6751,4.2
Vernon,12/1/2021,15434,14870,564,3.7,162497,156099,6398,3.9
Vernon,1/1/2022,15846,15201,645,4.1,163627,157115,6512,4
Vernon,2/1/2022,16025,15406,619,3.9,163899,157598,6301,3.8
Vernon,3/1/2022,15700,15144,556,3.5,164220,158206,6014,3.7
Vernon,4/1/2022,16043,15530,513,3.2,163893,157891,6002,3.7
Vernon,5/1/2022,15991,15408,583,3.6,164362,158378,5983,3.6
Vernon,6/1/2022,16428,15502,926,5.6,164046,158094,5951,3.6
Vernon,7/1/2022,16609,15899,710,4.3,164026,158258,5768,3.5
Vernon,8/1/2022,16202,15580,622,3.8,164654,158735,5919,3.6
Vernon,9/1/2022,16245,15634,611,3.8,164602,158810,5792,3.5
Vernon,10/1/2022,15924,15198,726,4.6,164648,158684,5964,3.6
Vernon,11/1/2022,16025,15458,567,3.5,164450,158507,5943,3.6
Vernon,12/1/2022,16122,15362,760,4.7,165025,159259,5766,3.5
Vernon,1/1/2023,16383,15513,870,5.3,165964,160217,5747,3.5
Vernon,2/1/2023,16326,15614,712,4.4,166358,160395,5962,3.6
Vernon,3/1/2023,16076,15458,618,3.8,166651,160812,5839,3.5
Vernon,4/1/2023,16497,15768,729,4.4,166725,160974,5751,3.4
Vernon,5/1/2023,16057,15416,641,4,166886,160796,6089,3.6
Vernon,6/1/2023,16732,15980,752,4.5,166937,160979,5958,3.6
Vernon,7/1/2023,16475,15714,761,4.6,167103,161183,5920,3.5
Vernon,8/1/2023,16075,15368,707,4.4,167759,161475,6284,3.7
Vernon,9/1/2023,16231,15449,782,4.8,167767,161442,6326,3.8
Vernon,10/1/2023,16036,15309,727,4.5,167690,161211,6479,3.9
Vernon,11/1/2023,16383,15480,903,5.5,168140,161886,6254,3.7
Vernon,12/1/2023,15908,15070,838,5.3,167439,161124,6315,3.8
Vernon,1/1/2024,16331,15342,989,6.1,167339,161190,6149,3.7
Vernon,2/1/2024,16337,15420,917,5.6,167475,161013,6462,3.9
Vernon,3/1/2024,15842,15083,759,4.8,167922,161425,6497,3.9
Vernon,4/1/2024,15785,15129,656,4.2,167988,161495,6492,3.9
Vernon,5/1/2024,15696,14999,697,4.4,167799,161164,6635,4
Vernon,6/1/2024,16251,15359,892,5.5,168005,161155,6849,4.1
Vernon,7/1/2024,16265,15306,959,5.9,168315,161219,7097,4.2
Vernon,8/1/2024,15910,15033,877,5.5,168496,161425,7071,4.2
Vernon,9/1/2024,16005,15158,847,5.3,168703,161802,6901,4.1
Vernon,10/1/2024,15931,14956,975,6.1,168428,161456,6972,4.1
Vernon,11/1/2024,15799,14930,869,5.5,168304,161183,7121,4.2
Vernon,12/1/2024,15634,14659,975,6.2,168547,161661,6886,4.1
Vernon,1/1/2025,16953,15887,1066,6.3,170744,163895,6849,4
Vernon,2/1/2025,16921,15951,970,5.7,170359,163307,7052,4.1
Washington,1/1/1990,15796,14659,1137,7.2,125833,119081,6752,5.4
Washington,2/1/1990,15744,14709,1035,6.6,125710,119059,6651,5.3
Washington,3/1/1990,16020,14986,1034,6.5,125801,119203,6598,5.2
Washington,4/1/1990,15901,14891,1010,6.4,125649,118852,6797,5.4
Washington,5/1/1990,15994,14934,1060,6.6,125893,119151,6742,5.4
Washington,6/1/1990,16081,14794,1287,8,125573,118983,6590,5.2
Washington,7/1/1990,16209,14832,1377,8.5,125732,118810,6922,5.5
Washington,8/1/1990,15807,14324,1483,9.4,125990,118802,7188,5.7
Washington,9/1/1990,15893,14236,1657,10.4,125892,118524,7368,5.9
Washington,10/1/1990,15622,13936,1686,10.8,125995,118536,7459,5.9
Washington,11/1/1990,15231,13703,1528,10,126070,118306,7764,6.2
Washington,12/1/1990,15142,13606,1536,10.1,126142,118241,7901,6.3
Washington,1/1/1991,15543,13875,1668,10.7,125955,117940,8015,6.4
Washington,2/1/1991,15574,13973,1601,10.3,126020,117755,8265,6.6
Washington,3/1/1991,15721,14027,1694,10.8,126238,117652,8586,6.8
Washington,4/1/1991,15832,14216,1616,10.2,126548,118109,8439,6.7
Washington,5/1/1991,15981,14356,1625,10.2,126176,117440,8736,6.9
Washington,6/1/1991,16370,14188,2182,13.3,126331,117639,8692,6.9
Washington,7/1/1991,16458,14550,1908,11.6,126154,117568,8586,6.8
Washington,8/1/1991,16190,14326,1864,11.5,126150,117484,8666,6.9
Washington,9/1/1991,15964,14281,1683,10.5,126650,117928,8722,6.9
Washington,10/1/1991,16000,14319,1681,10.5,126642,117800,8842,7
Washington,11/1/1991,15780,14489,1291,8.2,126701,117770,8931,7
Washington,12/1/1991,15813,14429,1384,8.8,126664,117466,9198,7.3
Washington,1/1/1992,15942,14193,1749,11,127261,117978,9283,7.3
Washington,2/1/1992,15724,14189,1535,9.8,127207,117753,9454,7.4
Washington,3/1/1992,15878,14426,1452,9.1,127604,118144,9460,7.4
Washington,4/1/1992,16231,14687,1544,9.5,127841,118426,9415,7.4
Washington,5/1/1992,16476,14838,1638,9.9,128119,118375,9744,7.6
Washington,6/1/1992,17020,14761,2259,13.3,128459,118419,10040,7.8
Washington,7/1/1992,17265,15348,1917,11.1,128563,118713,9850,7.7
Washington,8/1/1992,17077,15209,1868,10.9,128613,118826,9787,7.6
Washington,9/1/1992,16675,14909,1766,10.6,128501,118720,9781,7.6
Washington,10/1/1992,16435,14895,1540,9.4,128026,118628,9398,7.3
Washington,11/1/1992,16288,14887,1401,8.6,128441,118876,9565,7.4
Washington,12/1/1992,15815,14492,1323,8.4,128554,118997,9557,7.4
Washington,1/1/1993,15872,14379,1493,9.4,128400,119075,9325,7.3
Washington,2/1/1993,15819,14448,1371,8.7,128458,119275,9183,7.1
Washington,3/1/1993,15982,14660,1322,8.3,128598,119542,9056,7
Washington,4/1/1993,16123,14846,1277,7.9,128584,119474,9110,7.1
Washington,5/1/1993,16320,15077,1243,7.6,129264,120115,9149,7.1
Washington,6/1/1993,16665,15018,1647,9.9,129411,120290,9121,7
Washington,7/1/1993,16381,14921,1460,8.9,129397,120467,8930,6.9
Washington,8/1/1993,16390,14971,1419,8.7,129619,120856,8763,6.8
Washington,9/1/1993,16162,14753,1409,8.7,129268,120554,8714,6.7
Washington,10/1/1993,16449,15037,1412,8.6,129573,120823,8750,6.8
Washington,11/1/1993,16297,15015,1282,7.9,129711,121169,8542,6.6
Washington,12/1/1993,16326,15206,1120,6.9,129941,121464,8477,6.5
Washington,1/1/1994,16634,15205,1429,8.6,130596,121966,8630,6.6
Washington,2/1/1994,16645,15221,1424,8.6,130669,122086,8583,6.6
Washington,3/1/1994,16793,15344,1449,8.6,130400,121930,8470,6.5
Washington,4/1/1994,16756,15311,1445,8.6,130621,122290,8331,6.4
Washington,5/1/1994,16930,15418,1512,8.9,130779,122864,7915,6.1
Washington,6/1/1994,17263,15570,1693,9.8,130561,122634,7927,6.1
Washington,7/1/1994,17809,16181,1628,9.1,130652,122706,7946,6.1
Washington,8/1/1994,17510,15887,1623,9.3,131275,123342,7933,6
Washington,9/1/1994,17314,15780,1534,8.9,131421,123687,7734,5.9
Washington,10/1/1994,17393,15881,1512,8.7,131744,124112,7632,5.8
Washington,11/1/1994,17324,16033,1291,7.5,131891,124516,7375,5.6
Washington,12/1/1994,17263,16144,1119,6.5,131951,124721,7230,5.5
Washington,1/1/1995,17026,15461,1565,9.2,132038,124663,7375,5.6
Washington,2/1/1995,16961,15581,1380,8.1,132115,124928,7187,5.4
Washington,3/1/1995,17204,15823,1381,8,132108,124955,7153,5.4
Washington,4/1/1995,17036,15642,1394,8.2,132590,124945,7645,5.8
Washington,5/1/1995,17014,15643,1371,8.1,131851,124421,7430,5.6
Washington,6/1/1995,17347,15838,1509,8.7,131949,124522,7427,5.6
Washington,7/1/1995,17245,15776,1469,8.5,132343,124816,7527,5.7
Washington,8/1/1995,17185,15769,1416,8.2,132336,124852,7484,5.7
Washington,9/1/1995,17007,15597,1410,8.3,132611,125133,7478,5.6
Washington,10/1/1995,16758,15498,1260,7.5,132716,125388,7328,5.5
Washington,11/1/1995,16609,15441,1168,7,132614,125188,7426,5.6
Washington,12/1/1995,16644,15526,1118,6.7,132511,125088,7423,5.6
Washington,1/1/1996,16127,14859,1268,7.9,132616,125125,7491,5.6
Washington,2/1/1996,16231,14901,1330,8.2,132952,125639,7313,5.5
Washington,3/1/1996,16482,15126,1356,8.2,133180,125862,7318,5.5
Washington,4/1/1996,16753,15444,1309,7.8,133409,125994,7415,5.6
Washington,5/1/1996,16629,15372,1257,7.6,133667,126244,7423,5.6
Washington,6/1/1996,17006,15604,1402,8.2,133697,126602,7095,5.3
Washington,7/1/1996,17307,15896,1411,8.2,134284,126947,7337,5.5
Washington,8/1/1996,17129,15842,1287,7.5,134054,127172,6882,5.1
Washington,9/1/1996,16984,15720,1264,7.4,134515,127536,6979,5.2
Washington,10/1/1996,16921,15666,1255,7.4,134921,127890,7031,5.2
Washington,11/1/1996,16738,15601,1137,6.8,135007,127771,7236,5.4
Washington,12/1/1996,16689,15632,1057,6.3,135113,127860,7253,5.4
Washington,1/1/1997,16392,15178,1214,7.4,135456,128298,7158,5.3
Washington,2/1/1997,16313,15180,1133,6.9,135400,128298,7102,5.2
Washington,3/1/1997,16461,15207,1254,7.6,135891,128891,7000,5.2
Washington,4/1/1997,16478,15326,1152,7,136016,129143,6873,5.1
Washington,5/1/1997,16488,15294,1194,7.2,136119,129464,6655,4.9
Washington,6/1/1997,17058,15273,1785,10.5,136211,129412,6799,5
Washington,7/1/1997,17097,15639,1458,8.5,136477,129822,6655,4.9
Washington,8/1/1997,16783,15551,1232,7.3,136618,130010,6608,4.8
Washington,9/1/1997,16708,15430,1278,7.6,136675,130019,6656,4.9
Washington,10/1/1997,16355,15309,1046,6.4,136633,130179,6454,4.7
Washington,11/1/1997,16365,15379,986,6,136961,130653,6308,4.6
Washington,12/1/1997,16623,15685,938,5.6,137155,130679,6476,4.7
Washington,1/1/1998,16207,15006,1201,7.4,137095,130726,6368,4.6
Washington,2/1/1998,16027,14959,1068,6.7,137112,130807,6306,4.6
Washington,3/1/1998,16152,14903,1249,7.7,137236,130814,6422,4.7
Washington,4/1/1998,16174,14997,1177,7.3,137150,131209,5941,4.3
Washington,5/1/1998,16227,15007,1220,7.5,137372,131325,6047,4.4
Washington,6/1/1998,16658,15205,1453,8.7,137455,131244,6212,4.5
Washington,7/1/1998,16777,15322,1455,8.7,137588,131329,6259,4.5
Washington,8/1/1998,16595,15199,1396,8.4,137570,131390,6179,4.5
Washington,9/1/1998,16264,14983,1281,7.9,138286,131986,6300,4.6
Washington,10/1/1998,16217,15104,1113,6.9,138279,131999,6280,4.5
Washington,11/1/1998,16007,15025,982,6.1,138381,132280,6100,4.4
Washington,12/1/1998,15928,15037,891,5.6,138634,132602,6032,4.4
Washington,1/1/1999,16250,15302,948,5.8,139003,133027,5976,4.3
Washington,2/1/1999,15893,15028,865,5.4,138967,132856,6111,4.4
Washington,3/1/1999,16103,15196,907,5.6,138730,132947,5783,4.2
Washington,4/1/1999,16189,15356,833,5.1,138959,132955,6004,4.3
Washington,5/1/1999,16057,15229,828,5.2,139107,133311,5796,4.2
Washington,6/1/1999,16496,15395,1101,6.7,139329,133378,5951,4.3
Washington,7/1/1999,16454,15469,985,6,139439,133414,6025,4.3
Washington,8/1/1999,16333,15390,943,5.8,139430,133591,5838,4.2
Washington,9/1/1999,16109,15134,975,6.1,139622,133707,5915,4.2
Washington,10/1/1999,15982,15077,905,5.7,139771,133993,5778,4.1
Washington,11/1/1999,15908,15110,798,5,140025,134309,5716,4.1
Washington,12/1/1999,15676,14931,745,4.8,140177,134523,5653,4
Washington,1/1/2000,16879,15937,942,5.6,142267,136559,5708,4
Washington,2/1/2000,16494,15533,961,5.8,142456,136598,5858,4.1
Washington,3/1/2000,16597,15612,985,5.9,142434,136701,5733,4
Washington,4/1/2000,16494,15630,864,5.2,142751,137270,5481,3.8
Washington,5/1/2000,16482,15504,978,5.9,142388,136630,5758,4
Washington,6/1/2000,16752,15569,1183,7.1,142591,136940,5651,4
Washington,7/1/2000,16826,15696,1130,6.7,142278,136531,5747,4
Washington,8/1/2000,16656,15552,1104,6.6,142514,136662,5853,4.1
Washington,9/1/2000,16517,15469,1048,6.3,142518,136893,5625,3.9
Washington,10/1/2000,16861,15858,1003,5.9,142622,137088,5534,3.9
Washington,11/1/2000,17018,16047,971,5.7,142962,137322,5639,3.9
Washington,12/1/2000,17003,16079,924,5.4,143248,137614,5634,3.9
Washington,1/1/2001,17312,16189,1123,6.5,143800,137778,6023,4.2
Washington,2/1/2001,17074,16071,1003,5.9,143701,137612,6089,4.2
Washington,3/1/2001,17203,16128,1075,6.2,143924,137783,6141,4.3
Washington,4/1/2001,17062,16015,1047,6.1,143569,137299,6271,4.4
Washington,5/1/2001,16947,15808,1139,6.7,143318,137092,6226,4.3
Washington,6/1/2001,17163,15737,1426,8.3,143357,136873,6484,4.5
Washington,7/1/2001,17171,15895,1276,7.4,143654,137071,6583,4.6
Washington,8/1/2001,16979,15713,1266,7.5,143284,136241,7042,4.9
Washington,9/1/2001,16953,15648,1305,7.7,143989,136846,7142,5
Washington,10/1/2001,17154,15890,1264,7.4,144086,136392,7694,5.3
Washington,11/1/2001,16940,15703,1237,7.3,144240,136238,8003,5.5
Washington,12/1/2001,16826,15583,1243,7.4,144305,136047,8258,5.7
Washington,1/1/2002,16721,15438,1283,7.7,143883,135701,8182,5.7
Washington,2/1/2002,16602,15448,1154,7,144653,136438,8215,5.7
Washington,3/1/2002,16708,15556,1152,6.9,144481,136177,8304,5.7
Washington,4/1/2002,16692,15581,1111,6.7,144725,136126,8599,5.9
Washington,5/1/2002,16669,15533,1136,6.8,144938,136539,8399,5.8
Washington,6/1/2002,17048,15656,1392,8.2,144808,136415,8393,5.8
Washington,7/1/2002,16941,15675,1266,7.5,144803,136413,8390,5.8
Washington,8/1/2002,17018,15780,1238,7.3,145009,136705,8304,5.7
Washington,9/1/2002,16851,15625,1226,7.3,145552,137302,8251,5.7
Washington,10/1/2002,16893,15709,1184,7,145314,137008,8307,5.7
Washington,11/1/2002,16784,15561,1223,7.3,145041,136521,8520,5.9
Washington,12/1/2002,16865,15645,1220,7.2,145066,136426,8640,6
Washington,1/1/2003,16860,15467,1393,8.3,145937,137417,8520,5.8
Washington,2/1/2003,16654,15393,1261,7.6,146100,137482,8618,5.9
Washington,3/1/2003,16702,15404,1298,7.8,146022,137434,8588,5.9
Washington,4/1/2003,16564,15322,1242,7.5,146474,137633,8842,6
Washington,5/1/2003,16536,15282,1254,7.6,146500,137544,8957,6.1
Washington,6/1/2003,16999,15378,1621,9.5,147056,137790,9266,6.3
Washington,7/1/2003,16648,15194,1454,8.7,146485,137474,9011,6.2
Washington,8/1/2003,16609,15304,1305,7.9,146445,137549,8896,6.1
Washington,9/1/2003,16458,15236,1222,7.4,146530,137609,8921,6.1
Washington,10/1/2003,16515,15395,1120,6.8,146716,137984,8732,6
Washington,11/1/2003,16527,15426,1101,6.7,147000,138424,8576,5.8
Washington,12/1/2003,16569,15520,1049,6.3,146729,138411,8317,5.7
Washington,1/1/2004,16341,15025,1316,8.1,146842,138472,8370,5.7
Washington,2/1/2004,16110,14951,1159,7.2,146709,138542,8167,5.6
Washington,3/1/2004,16132,14943,1189,7.4,146944,138453,8491,5.8
Washington,4/1/2004,16179,15061,1118,6.9,146850,138680,8170,5.6
Washington,5/1/2004,16156,15018,1138,7,147065,138852,8212,5.6
Washington,6/1/2004,16442,15056,1386,8.4,147460,139174,8286,5.6
Washington,7/1/2004,16370,15117,1253,7.7,147692,139556,8136,5.5
Washington,8/1/2004,16231,15095,1136,7,147564,139573,7990,5.4
Washington,9/1/2004,16133,14989,1144,7.1,147415,139487,7927,5.4
Washington,10/1/2004,16383,15246,1137,6.9,147793,139732,8061,5.5
Washington,11/1/2004,16322,15198,1124,6.9,148162,140231,7932,5.4
Washington,12/1/2004,16253,15192,1061,6.5,148059,140125,7934,5.4
Washington,1/1/2005,15876,14679,1197,7.5,148029,140245,7784,5.3
Washington,2/1/2005,15658,14572,1086,6.9,148364,140385,7980,5.4
Washington,3/1/2005,15705,14643,1062,6.8,148391,140654,7737,5.2
Washington,4/1/2005,15779,14795,984,6.2,148926,141254,7672,5.2
Washington,5/1/2005,15870,14812,1058,6.7,149261,141609,7651,5.1
Washington,6/1/2005,16222,14907,1315,8.1,149238,141714,7524,5
Washington,7/1/2005,16312,15125,1187,7.3,149432,142026,7406,5
Washington,8/1/2005,16103,15024,1079,6.7,149779,142434,7345,4.9
Washington,9/1/2005,18326,14756,3570,19.5,149954,142401,7553,5
Washington,10/1/2005,17778,14607,3171,17.8,150001,142548,7453,5
Washington,11/1/2005,17779,14621,3158,17.8,150065,142499,7566,5
Washington,12/1/2005,15972,14692,1280,8,150030,142752,7279,4.9
Washington,1/1/2006,15565,14541,1024,6.6,150214,143150,7064,4.7
Washington,2/1/2006,15444,14652,792,5.1,150641,143457,7184,4.8
Washington,3/1/2006,15555,14776,779,5,150813,143741,7072,4.7
Washington,4/1/2006,15565,14780,785,5,150881,143761,7120,4.7
Washington,5/1/2006,15547,14721,826,5.3,151069,144089,6980,4.6
Washington,6/1/2006,15970,14949,1021,6.4,151354,144353,7001,4.6
Washington,7/1/2006,15885,15009,876,5.5,151377,144202,7175,4.7
Washington,8/1/2006,15701,14833,868,5.5,151716,144625,7091,4.7
Washington,9/1/2006,15745,14867,878,5.6,151662,144815,6847,4.5
Washington,10/1/2006,15760,14930,830,5.3,152041,145314,6727,4.4
Washington,11/1/2006,15852,15018,834,5.3,152406,145534,6872,4.5
Washington,12/1/2006,15715,14957,758,4.8,152732,145970,6762,4.4
Washington,1/1/2007,15906,14994,912,5.7,153144,146028,7116,4.6
Washington,2/1/2007,15860,15003,857,5.4,152983,146057,6927,4.5
Washington,3/1/2007,16052,15213,839,5.2,153051,146320,6731,4.4
Washington,4/1/2007,15812,14968,844,5.3,152435,145586,6850,4.5
Washington,5/1/2007,15790,14882,908,5.8,152670,145903,6766,4.4
Washington,6/1/2007,16100,14997,1103,6.9,153041,146063,6979,4.6
Washington,7/1/2007,15720,14685,1035,6.6,153054,145905,7149,4.7
Washington,8/1/2007,15655,14778,877,5.6,152749,145682,7067,4.6
Washington,9/1/2007,16013,15132,881,5.5,153414,146244,7170,4.7
Washington,10/1/2007,16002,15192,810,5.1,153183,145946,7237,4.7
Washington,11/1/2007,16224,15417,807,5,153835,146595,7240,4.7
Washington,12/1/2007,16040,15198,842,5.2,153918,146273,7645,5
Washington,1/1/2008,16097,15160,937,5.8,154063,146378,7685,5
Washington,2/1/2008,15943,15157,786,4.9,153653,146156,7497,4.9
Washington,3/1/2008,16113,15286,827,5.1,153908,146086,7822,5.1
Washington,4/1/2008,16060,15312,748,4.7,153769,146132,7637,5
Washington,5/1/2008,16076,15199,877,5.5,154303,145908,8395,5.4
Washington,6/1/2008,16189,15044,1145,7.1,154313,145737,8575,5.6
Washington,7/1/2008,15859,14720,1139,7.2,154469,145532,8937,5.8
Washington,8/1/2008,15884,14797,1087,6.8,154641,145203,9438,6.1
Washington,9/1/2008,15992,14984,1008,6.3,154570,145076,9494,6.1
Washington,10/1/2008,15992,14917,1075,6.7,154876,144802,10074,6.5
Washington,11/1/2008,16024,14973,1051,6.6,154639,144100,10538,6.8
Washington,12/1/2008,15735,14596,1139,7.2,154655,143369,11286,7.3
Washington,1/1/2009,15680,14430,1250,8,154210,142152,12058,7.8
Washington,2/1/2009,15831,14639,1192,7.5,154538,141640,12898,8.3
Washington,3/1/2009,15844,14602,1242,7.8,154133,140707,13426,8.7
Washington,4/1/2009,15931,14690,1241,7.8,154509,140656,13853,9
Washington,5/1/2009,16021,14685,1336,8.3,154747,140248,14499,9.4
Washington,6/1/2009,16136,14545,1591,9.9,154716,140009,14707,9.5
Washington,7/1/2009,15892,14397,1495,9.4,154502,139901,14601,9.5
Washington,8/1/2009,15745,14303,1442,9.2,154307,139492,14814,9.6
Washington,9/1/2009,15685,14286,1399,8.9,153827,138818,15009,9.8
Washington,10/1/2009,15719,14285,1434,9.1,153784,138432,15352,10
Washington,11/1/2009,15820,14456,1364,8.6,153878,138659,15219,9.9
Washington,12/1/2009,15631,14259,1372,8.8,153111,138013,15098,9.9
Washington,1/1/2010,17120,15547,1573,9.2,153484,138438,15046,9.8
Washington,2/1/2010,17159,15744,1415,8.2,153694,138581,15113,9.8
Washington,3/1/2010,17373,15933,1440,8.3,153954,138751,15202,9.9
Washington,4/1/2010,17105,15688,1417,8.3,154622,139297,15325,9.9
Washington,5/1/2010,17061,15573,1488,8.7,154091,139241,14849,9.6
Washington,6/1/2010,17222,15489,1733,10.1,153616,139141,14474,9.4
Washington,7/1/2010,17216,15553,1663,9.7,153691,139179,14512,9.4
Washington,8/1/2010,17086,15449,1637,9.6,154086,139438,14648,9.5
Washington,9/1/2010,17112,15515,1597,9.3,153975,139396,14579,9.5
Washington,10/1/2010,17110,15567,1543,9,153635,139119,14516,9.4
Washington,11/1/2010,16998,15473,1525,9,154125,139044,15081,9.8
Washington,12/1/2010,16971,15527,1444,8.5,153650,139301,14348,9.3
Washington,1/1/2011,16723,15110,1613,9.6,153263,139250,14013,9.1
Washington,2/1/2011,16787,15316,1471,8.8,153214,139394,13820,9
Washington,3/1/2011,16746,15296,1450,8.7,153376,139639,13737,9
Washington,4/1/2011,16787,15391,1396,8.3,153543,139586,13957,9.1
Washington,5/1/2011,16719,15276,1443,8.6,153479,139624,13855,9
Washington,6/1/2011,16853,15191,1662,9.9,153346,139384,13962,9.1
Washington,7/1/2011,16580,15002,1578,9.5,153288,139524,13763,9
Washington,8/1/2011,16415,14878,1537,9.4,153760,139942,13818,9
Washington,9/1/2011,16621,15101,1520,9.1,154131,140183,13948,9
Washington,10/1/2011,16777,15310,1467,8.7,153961,140368,13594,8.8
Washington,11/1/2011,16667,15289,1378,8.3,154128,140826,13302,8.6
Washington,12/1/2011,16537,15194,1343,8.1,153995,140902,13093,8.5
Washington,1/1/2012,16396,14902,1494,9.1,154381,141584,12797,8.3
Washington,2/1/2012,16433,15030,1403,8.5,154671,141858,12813,8.3
Washington,3/1/2012,16642,15238,1404,8.4,154749,142036,12713,8.2
Washington,4/1/2012,16601,15281,1320,8,154545,141899,12646,8.2
Washington,5/1/2012,16705,15296,1409,8.4,154866,142206,12660,8.2
Washington,6/1/2012,16890,15242,1648,9.8,155083,142391,12692,8.2
Washington,7/1/2012,16617,15055,1562,9.4,154948,142292,12656,8.2
Washington,8/1/2012,16381,14973,1408,8.6,154763,142291,12471,8.1
Washington,9/1/2012,16438,15142,1296,7.9,155160,143044,12115,7.8
Washington,10/1/2012,16614,15348,1266,7.6,155554,143431,12124,7.8
Washington,11/1/2012,16432,15278,1154,7,155338,143333,12005,7.7
Washington,12/1/2012,16543,15295,1248,7.5,155628,143330,12298,7.9
Washington,1/1/2013,16309,14846,1463,9,155763,143292,12471,8
Washington,2/1/2013,16346,15057,1289,7.9,155312,143362,11950,7.7
Washington,3/1/2013,16305,15016,1289,7.9,155005,143316,11689,7.5
Washington,4/1/2013,16557,15314,1243,7.5,155394,143635,11760,7.6
Washington,5/1/2013,16586,15219,1367,8.2,155536,143882,11654,7.5
Washington,6/1/2013,16843,15231,1612,9.6,155749,143999,11751,7.5
Washington,7/1/2013,16564,15071,1493,9,155599,144264,11335,7.3
Washington,8/1/2013,16387,15046,1341,8.2,155605,144326,11279,7.2
Washington,9/1/2013,16383,15095,1288,7.9,155687,144418,11270,7.2
Washington,10/1/2013,16180,14960,1220,7.5,154673,143537,11136,7.2
Washington,11/1/2013,16469,15354,1115,6.8,155265,144479,10787,6.9
Washington,12/1/2013,16039,15022,1017,6.3,155182,144778,10404,6.7
Washington,1/1/2014,16471,15361,1110,6.7,155352,145150,10202,6.6
Washington,2/1/2014,16582,15502,1080,6.5,155483,145134,10349,6.7
Washington,3/1/2014,16842,15714,1128,6.7,156028,145648,10380,6.7
Washington,4/1/2014,16840,15795,1045,6.2,155369,145667,9702,6.2
Washington,5/1/2014,16700,15468,1232,7.4,155684,145825,9859,6.3
Washington,6/1/2014,16958,15484,1474,8.7,155707,146247,9460,6.1
Washington,7/1/2014,16844,15283,1561,9.3,156007,146399,9608,6.2
Washington,8/1/2014,16651,15172,1479,8.9,156130,146530,9599,6.1
Washington,9/1/2014,17043,15610,1433,8.4,156040,146778,9262,5.9
Washington,10/1/2014,17178,15823,1355,7.9,156417,147427,8990,5.7
Washington,11/1/2014,17237,15850,1387,8,156494,147404,9090,5.8
Washington,12/1/2014,17053,15760,1293,7.6,156332,147615,8717,5.6
Washington,1/1/2015,17203,15780,1423,8.3,157030,148145,8885,5.7
Washington,2/1/2015,17019,15714,1305,7.7,156644,148045,8599,5.5
Washington,3/1/2015,17142,15859,1283,7.5,156643,148128,8515,5.4
Washington,4/1/2015,17213,15984,1229,7.1,157060,148511,8550,5.4
Washington,5/1/2015,17087,15738,1349,7.9,157651,148817,8834,5.6
Washington,6/1/2015,17086,15593,1493,8.7,157062,148816,8247,5.3
Washington,7/1/2015,17003,15600,1403,8.3,156997,148830,8167,5.2
Washington,8/1/2015,16685,15418,1267,7.6,157172,149181,7992,5.1
Washington,9/1/2015,16713,15488,1225,7.3,156733,148826,7907,5
Washington,10/1/2015,16859,15653,1206,7.2,157167,149246,7922,5
Washington,11/1/2015,16822,15687,1135,6.7,157463,149463,8000,5.1
Washington,12/1/2015,16636,15586,1050,6.3,158035,150128,7907,5
Washington,1/1/2016,17006,15767,1239,7.3,158280,150653,7627,4.8
Washington,2/1/2016,17125,15997,1128,6.6,158640,150939,7702,4.9
Washington,3/1/2016,17329,16157,1172,6.8,159179,151218,7961,5
Washington,4/1/2016,17177,16046,1131,6.6,159141,151074,8067,5.1
Washington,5/1/2016,17080,15920,1160,6.8,158784,151132,7652,4.8
Washington,6/1/2016,17289,15882,1407,8.1,158967,151223,7744,4.9
Washington,7/1/2016,17061,15679,1382,8.1,159194,151554,7641,4.8
Washington,8/1/2016,16746,15502,1244,7.4,159562,151779,7784,4.9
Washington,9/1/2016,16914,15684,1230,7.3,159714,151761,7953,5
Washington,10/1/2016,16506,15400,1106,6.7,159605,151793,7811,4.9
Washington,11/1/2016,16462,15437,1025,6.2,159506,151954,7553,4.7
Washington,12/1/2016,16571,15595,976,5.9,159678,152157,7521,4.7
Washington,1/1/2017,16802,15710,1092,6.5,159620,152152,7468,4.7
Washington,2/1/2017,16945,15947,998,5.9,159859,152480,7379,4.6
Washington,3/1/2017,17264,16269,995,5.8,160137,153065,7073,4.4
Washington,4/1/2017,17101,16117,984,5.8,160345,153255,7089,4.4
Washington,5/1/2017,16782,15845,937,5.6,160068,153069,7000,4.4
Washington,6/1/2017,17159,16055,1104,6.4,160192,153318,6873,4.3
Washington,7/1/2017,16847,15718,1129,6.7,160462,153569,6892,4.3
Washington,8/1/2017,16644,15596,1048,6.3,160586,153503,7082,4.4
Washington,9/1/2017,16686,15715,971,5.8,161140,154286,6854,4.3
Washington,10/1/2017,16818,15988,830,4.9,160309,153609,6700,4.2
Washington,11/1/2017,16993,16166,827,4.9,160579,153805,6774,4.2
Washington,12/1/2017,16836,16050,786,4.7,160535,153904,6632,4.1
Washington,1/1/2018,16748,15856,892,5.3,160914,154425,6489,4
Washington,2/1/2018,16852,15994,858,5.1,161778,155197,6581,4.1
Washington,3/1/2018,16721,15825,896,5.4,161686,155214,6472,4
Washington,4/1/2018,16757,15881,876,5.2,161771,155312,6459,4
Washington,5/1/2018,16697,15786,911,5.5,161848,155652,6196,3.8
Washington,6/1/2018,16931,15686,1245,7.4,162210,155762,6447,4
Washington,7/1/2018,16774,15635,1139,6.8,162341,156146,6195,3.8
Washington,8/1/2018,16817,15796,1021,6.1,161660,155504,6156,3.8
Washington,9/1/2018,16771,15813,958,5.7,162087,156015,6073,3.7
Washington,10/1/2018,16967,16050,917,5.4,162602,156391,6211,3.8
Washington,11/1/2018,16943,16055,888,5.2,162836,156721,6115,3.8
Washington,12/1/2018,16757,15863,894,5.3,163206,156817,6389,3.9
Washington,1/1/2019,16831,15789,1042,6.2,162963,156487,6475,4
Washington,2/1/2019,16713,15812,901,5.4,162999,156863,6136,3.8
Washington,3/1/2019,16629,15777,852,5.1,162904,156701,6202,3.8
Washington,4/1/2019,16566,15770,796,4.8,162586,156625,5961,3.7
Washington,5/1/2019,16761,15857,904,5.4,162751,156821,5930,3.6
Washington,6/1/2019,16905,15755,1150,6.8,163168,157232,5935,3.6
Washington,7/1/2019,16685,15584,1101,6.6,163590,157529,6061,3.7
Washington,8/1/2019,16498,15511,987,6,163774,157829,5945,3.6
Washington,9/1/2019,16574,15619,955,5.8,164092,158339,5753,3.5
Washington,10/1/2019,16976,16034,942,5.5,164416,158545,5871,3.6
Washington,11/1/2019,17044,16146,898,5.3,164496,158629,5868,3.6
Washington,12/1/2019,16868,16006,862,5.1,164699,158845,5853,3.6
Washington,1/1/2020,16528,15593,935,5.7,164377,158508,5869,3.6
Washington,2/1/2020,16376,15621,755,4.6,164467,158714,5753,3.5
Washington,3/1/2020,16625,15312,1313,7.9,162559,155353,7206,4.4
Washington,4/1/2020,15404,13792,1612,10.5,156269,133185,23084,14.8
Washington,5/1/2020,16089,14200,1889,11.7,158101,137173,20929,13.2
Washington,6/1/2020,16655,14772,1883,11.3,159994,142342,17652,11
Washington,7/1/2020,16539,14766,1773,10.7,160132,143779,16352,10.2
Washington,8/1/2020,16459,14947,1512,9.2,160706,147245,13461,8.4
Washington,9/1/2020,16657,15079,1578,9.5,160174,147620,12554,7.8
Washington,10/1/2020,16973,15590,1383,8.1,161003,149931,11072,6.9
Washington,11/1/2020,16793,15578,1215,7.2,160629,149934,10694,6.7
Washington,12/1/2020,16946,15706,1240,7.3,160745,149975,10770,6.7
Washington,1/1/2021,16584,15312,1272,7.7,160088,149852,10236,6.4
Washington,2/1/2021,16609,15411,1198,7.2,160184,150189,9995,6.2
Washington,3/1/2021,16777,15633,1144,6.8,160400,150644,9756,6.1
Washington,4/1/2021,16596,15531,1065,6.4,160843,151081,9762,6.1
Washington,5/1/2021,16507,15415,1092,6.6,160800,151535,9266,5.8
Washington,6/1/2021,16802,15503,1299,7.7,161197,151734,9462,5.9
Washington,7/1/2021,16839,15723,1116,6.6,161504,152773,8731,5.4
Washington,8/1/2021,16683,15724,959,5.7,161527,153250,8276,5.1
Washington,9/1/2021,16806,15931,875,5.2,161495,153843,7652,4.7
Washington,10/1/2021,16742,15962,780,4.7,161754,154475,7279,4.5
Washington,11/1/2021,16819,16128,691,4.1,162281,155530,6751,4.2
Washington,12/1/2021,16760,16131,629,3.8,162497,156099,6398,3.9
Washington,1/1/2022,16630,15860,770,4.6,163627,157115,6512,4
Washington,2/1/2022,16674,15980,694,4.2,163899,157598,6301,3.8
Washington,3/1/2022,16802,16130,672,4,164220,158206,6014,3.7
Washington,4/1/2022,16893,16276,617,3.7,163893,157891,6002,3.7
Washington,5/1/2022,16608,15919,689,4.1,164362,158378,5983,3.6
Washington,6/1/2022,17004,16082,922,5.4,164046,158094,5951,3.6
Washington,7/1/2022,16916,16097,819,4.8,164026,158258,5768,3.5
Washington,8/1/2022,16831,16079,752,4.5,164654,158735,5919,3.6
Washington,9/1/2022,16934,16245,689,4.1,164602,158810,5792,3.5
Washington,10/1/2022,16851,16220,631,3.7,164648,158684,5964,3.6
Washington,11/1/2022,16811,16217,594,3.5,164450,158507,5943,3.6
Washington,12/1/2022,16743,16124,619,3.7,165025,159259,5766,3.5
Washington,1/1/2023,16975,16277,698,4.1,165964,160217,5747,3.5
Washington,2/1/2023,16959,16265,694,4.1,166358,160395,5962,3.6
Washington,3/1/2023,17075,16418,657,3.8,166651,160812,5839,3.5
Washington,4/1/2023,17067,16474,593,3.5,166725,160974,5751,3.4
Washington,5/1/2023,16916,16211,705,4.2,166886,160796,6089,3.6
Washington,6/1/2023,17268,16372,896,5.2,166937,160979,5958,3.6
Washington,7/1/2023,17015,16248,767,4.5,167103,161183,5920,3.5
Washington,8/1/2023,16930,16166,764,4.5,167759,161475,6284,3.7
Washington,9/1/2023,17174,16399,775,4.5,167767,161442,6326,3.8
Washington,10/1/2023,17261,16492,769,4.5,167690,161211,6479,3.9
Washington,11/1/2023,17376,16624,752,4.3,168140,161886,6254,3.7
Washington,12/1/2023,17250,16464,786,4.6,167439,161124,6315,3.8
Washington,1/1/2024,17249,16356,893,5.2,167339,161190,6149,3.7
Washington,2/1/2024,17207,16366,841,4.9,167475,161013,6462,3.9
Washington,3/1/2024,17409,16573,836,4.8,167922,161425,6497,3.9
Washington,4/1/2024,17350,16579,771,4.4,167988,161495,6492,3.9
Washington,5/1/2024,17123,16311,812,4.7,167799,161164,6635,4
Washington,6/1/2024,17532,16479,1053,6,168005,161155,6849,4.1
Washington,7/1/2024,17516,16506,1010,5.8,168315,161219,7097,4.2
Washington,8/1/2024,17409,16418,991,5.7,168496,161425,7071,4.2
Washington,9/1/2024,17625,16696,929,5.3,168703,161802,6901,4.1
Washington,10/1/2024,17788,16859,929,5.2,168428,161456,6972,4.1
Washington,11/1/2024,17665,16804,861,4.9,168304,161183,7121,4.2
Washington,12/1/2024,17540,16727,813,4.6,168547,161661,6886,4.1
Washington,1/1/2025,17925,17085,840,4.7,170744,163895,6849,4
Washington,2/1/2025,17978,17161,817,4.5,170359,163307,7052,4.1
Webster,1/1/1990,17063,15514,1549,9.1,125833,119081,6752,5.4
Webster,2/1/1990,17319,15862,1457,8.4,125710,119059,6651,5.3
Webster,3/1/1990,17362,16019,1343,7.7,125801,119203,6598,5.2
Webster,4/1/1990,17409,16043,1366,7.8,125649,118852,6797,5.4
Webster,5/1/1990,17683,16091,1592,9,125893,119151,6742,5.4
Webster,6/1/1990,18205,16286,1919,10.5,125573,118983,6590,5.2
Webster,7/1/1990,17952,16334,1618,9,125732,118810,6922,5.5
Webster,8/1/1990,17839,16206,1633,9.2,125990,118802,7188,5.7
Webster,9/1/1990,17923,16256,1667,9.3,125892,118524,7368,5.9
Webster,10/1/1990,17764,16252,1512,8.5,125995,118536,7459,5.9
Webster,11/1/1990,17594,16201,1393,7.9,126070,118306,7764,6.2
Webster,12/1/1990,17588,16109,1479,8.4,126142,118241,7901,6.3
Webster,1/1/1991,17702,15921,1781,10.1,125955,117940,8015,6.4
Webster,2/1/1991,17708,15741,1967,11.1,126020,117755,8265,6.6
Webster,3/1/1991,17312,15731,1581,9.1,126238,117652,8586,6.8
Webster,4/1/1991,17603,15984,1619,9.2,126548,118109,8439,6.7
Webster,5/1/1991,17561,15931,1630,9.3,126176,117440,8736,6.9
Webster,6/1/1991,18129,16303,1826,10.1,126331,117639,8692,6.9
Webster,7/1/1991,17914,16294,1620,9,126154,117568,8586,6.8
Webster,8/1/1991,17883,16122,1761,9.8,126150,117484,8666,6.9
Webster,9/1/1991,17890,16197,1693,9.5,126650,117928,8722,6.9
Webster,10/1/1991,17795,16203,1592,8.9,126642,117800,8842,7
Webster,11/1/1991,17318,16020,1298,7.5,126701,117770,8931,7
Webster,12/1/1991,17348,15929,1419,8.2,126664,117466,9198,7.3
Webster,1/1/1992,17550,15772,1778,10.1,127261,117978,9283,7.3
Webster,2/1/1992,17321,15651,1670,9.6,127207,117753,9454,7.4
Webster,3/1/1992,17651,16022,1629,9.2,127604,118144,9460,7.4
Webster,4/1/1992,17601,16034,1567,8.9,127841,118426,9415,7.4
Webster,5/1/1992,17862,16095,1767,9.9,128119,118375,9744,7.6
Webster,6/1/1992,18538,16341,2197,11.9,128459,118419,10040,7.8
Webster,7/1/1992,18633,16670,1963,10.5,128563,118713,9850,7.7
Webster,8/1/1992,18497,16610,1887,10.2,128613,118826,9787,7.6
Webster,9/1/1992,18509,16656,1853,10,128501,118720,9781,7.6
Webster,10/1/1992,18303,16604,1699,9.3,128026,118628,9398,7.3
Webster,11/1/1992,18215,16683,1532,8.4,128441,118876,9565,7.4
Webster,12/1/1992,17716,16303,1413,8,128554,118997,9557,7.4
Webster,1/1/1993,17569,15866,1703,9.7,128400,119075,9325,7.3
Webster,2/1/1993,17505,15988,1517,8.7,128458,119275,9183,7.1
Webster,3/1/1993,17546,16022,1524,8.7,128598,119542,9056,7
Webster,4/1/1993,17548,16025,1523,8.7,128584,119474,9110,7.1
Webster,5/1/1993,17612,16055,1557,8.8,129264,120115,9149,7.1
Webster,6/1/1993,18044,16191,1853,10.3,129411,120290,9121,7
Webster,7/1/1993,18010,16327,1683,9.3,129397,120467,8930,6.9
Webster,8/1/1993,17914,16302,1612,9,129619,120856,8763,6.8
Webster,9/1/1993,17551,16101,1450,8.3,129268,120554,8714,6.7
Webster,10/1/1993,17836,16133,1703,9.5,129573,120823,8750,6.8
Webster,11/1/1993,17781,16192,1589,8.9,129711,121169,8542,6.6
Webster,12/1/1993,17669,16064,1605,9.1,129941,121464,8477,6.5
Webster,1/1/1994,18040,15979,2061,11.4,130596,121966,8630,6.6
Webster,2/1/1994,17996,16091,1905,10.6,130669,122086,8583,6.6
Webster,3/1/1994,18129,16102,2027,11.2,130400,121930,8470,6.5
Webster,4/1/1994,18307,16369,1938,10.6,130621,122290,8331,6.4
Webster,5/1/1994,18463,16456,2007,10.9,130779,122864,7915,6.1
Webster,6/1/1994,19031,16722,2309,12.1,130561,122634,7927,6.1
Webster,7/1/1994,19043,16841,2202,11.6,130652,122706,7946,6.1
Webster,8/1/1994,19117,16932,2185,11.4,131275,123342,7933,6
Webster,9/1/1994,19007,16798,2209,11.6,131421,123687,7734,5.9
Webster,10/1/1994,19024,16762,2262,11.9,131744,124112,7632,5.8
Webster,11/1/1994,18908,16702,2206,11.7,131891,124516,7375,5.6
Webster,12/1/1994,18690,16552,2138,11.4,131951,124721,7230,5.5
Webster,1/1/1995,18705,16315,2390,12.8,132038,124663,7375,5.6
Webster,2/1/1995,18648,16474,2174,11.7,132115,124928,7187,5.4
Webster,3/1/1995,18673,16630,2043,10.9,132108,124955,7153,5.4
Webster,4/1/1995,18591,16758,1833,9.9,132590,124945,7645,5.8
Webster,5/1/1995,18432,16662,1770,9.6,131851,124421,7430,5.6
Webster,6/1/1995,18752,16918,1834,9.8,131949,124522,7427,5.6
Webster,7/1/1995,18778,17027,1751,9.3,132343,124816,7527,5.7
Webster,8/1/1995,18801,16853,1948,10.4,132336,124852,7484,5.7
Webster,9/1/1995,18598,16719,1879,10.1,132611,125133,7478,5.6
Webster,10/1/1995,18698,16879,1819,9.7,132716,125388,7328,5.5
Webster,11/1/1995,18601,16873,1728,9.3,132614,125188,7426,5.6
Webster,12/1/1995,18400,16796,1604,8.7,132511,125088,7423,5.6
Webster,1/1/1996,18468,16586,1882,10.2,132616,125125,7491,5.6
Webster,2/1/1996,18359,16751,1608,8.8,132952,125639,7313,5.5
Webster,3/1/1996,18183,16665,1518,8.3,133180,125862,7318,5.5
Webster,4/1/1996,18461,16918,1543,8.4,133409,125994,7415,5.6
Webster,5/1/1996,18557,16973,1584,8.5,133667,126244,7423,5.6
Webster,6/1/1996,18889,17174,1715,9.1,133697,126602,7095,5.3
Webster,7/1/1996,19080,17345,1735,9.1,134284,126947,7337,5.5
Webster,8/1/1996,18952,17223,1729,9.1,134054,127172,6882,5.1
Webster,9/1/1996,19020,17237,1783,9.4,134515,127536,6979,5.2
Webster,10/1/1996,19018,17377,1641,8.6,134921,127890,7031,5.2
Webster,11/1/1996,19085,17401,1684,8.8,135007,127771,7236,5.4
Webster,12/1/1996,19072,17350,1722,9,135113,127860,7253,5.4
Webster,1/1/1997,19036,17034,2002,10.5,135456,128298,7158,5.3
Webster,2/1/1997,18663,17007,1656,8.9,135400,128298,7102,5.2
Webster,3/1/1997,18844,17149,1695,9,135891,128891,7000,5.2
Webster,4/1/1997,18806,17166,1640,8.7,136016,129143,6873,5.1
Webster,5/1/1997,18270,16923,1347,7.4,136119,129464,6655,4.9
Webster,6/1/1997,18882,17347,1535,8.1,136211,129412,6799,5
Webster,7/1/1997,19055,17539,1516,8,136477,129822,6655,4.9
Webster,8/1/1997,18851,17380,1471,7.8,136618,130010,6608,4.8
Webster,9/1/1997,18775,17233,1542,8.2,136675,130019,6656,4.9
Webster,10/1/1997,18879,17279,1600,8.5,136633,130179,6454,4.7
Webster,11/1/1997,18885,17445,1440,7.6,136961,130653,6308,4.6
Webster,12/1/1997,18748,17305,1443,7.7,137155,130679,6476,4.7
Webster,1/1/1998,18898,17094,1804,9.5,137095,130726,6368,4.6
Webster,2/1/1998,18623,17166,1457,7.8,137112,130807,6306,4.6
Webster,3/1/1998,19043,17339,1704,8.9,137236,130814,6422,4.7
Webster,4/1/1998,19099,17542,1557,8.2,137150,131209,5941,4.3
Webster,5/1/1998,18964,17460,1504,7.9,137372,131325,6047,4.4
Webster,6/1/1998,19110,17471,1639,8.6,137455,131244,6212,4.5
Webster,7/1/1998,19116,17552,1564,8.2,137588,131329,6259,4.5
Webster,8/1/1998,19341,17673,1668,8.6,137570,131390,6179,4.5
Webster,9/1/1998,19154,17595,1559,8.1,138286,131986,6300,4.6
Webster,10/1/1998,18916,17497,1419,7.5,138279,131999,6280,4.5
Webster,11/1/1998,18744,17464,1280,6.8,138381,132280,6100,4.4
Webster,12/1/1998,18659,17353,1306,7,138634,132602,6032,4.4
Webster,1/1/1999,18782,17276,1506,8,139003,133027,5976,4.3
Webster,2/1/1999,18636,17326,1310,7,138967,132856,6111,4.4
Webster,3/1/1999,18677,17486,1191,6.4,138730,132947,5783,4.2
Webster,4/1/1999,18694,17590,1104,5.9,138959,132955,6004,4.3
Webster,5/1/1999,18635,17536,1099,5.9,139107,133311,5796,4.2
Webster,6/1/1999,19030,17748,1282,6.7,139329,133378,5951,4.3
Webster,7/1/1999,19026,17871,1155,6.1,139439,133414,6025,4.3
Webster,8/1/1999,18770,17728,1042,5.6,139430,133591,5838,4.2
Webster,9/1/1999,18659,17576,1083,5.8,139622,133707,5915,4.2
Webster,10/1/1999,18800,17723,1077,5.7,139771,133993,5778,4.1
Webster,11/1/1999,18636,17691,945,5.1,140025,134309,5716,4.1
Webster,12/1/1999,18504,17599,905,4.9,140177,134523,5653,4
Webster,1/1/2000,18419,17298,1121,6.1,142267,136559,5708,4
Webster,2/1/2000,18365,17332,1033,5.6,142456,136598,5858,4.1
Webster,3/1/2000,18423,17377,1046,5.7,142434,136701,5733,4
Webster,4/1/2000,18278,17328,950,5.2,142751,137270,5481,3.8
Webster,5/1/2000,18191,17141,1050,5.8,142388,136630,5758,4
Webster,6/1/2000,18548,17367,1181,6.4,142591,136940,5651,4
Webster,7/1/2000,18696,17588,1108,5.9,142278,136531,5747,4
Webster,8/1/2000,18535,17365,1170,6.3,142514,136662,5853,4.1
Webster,9/1/2000,18355,17175,1180,6.4,142518,136893,5625,3.9
Webster,10/1/2000,18356,17267,1089,5.9,142622,137088,5534,3.9
Webster,11/1/2000,18206,17119,1087,6,142962,137322,5639,3.9
Webster,12/1/2000,18131,17064,1067,5.9,143248,137614,5634,3.9
Webster,1/1/2001,18422,17049,1373,7.5,143800,137778,6023,4.2
Webster,2/1/2001,18113,16685,1428,7.9,143701,137612,6089,4.2
Webster,3/1/2001,18323,16752,1571,8.6,143924,137783,6141,4.3
Webster,4/1/2001,18355,17220,1135,6.2,143569,137299,6271,4.4
Webster,5/1/2001,18184,17078,1106,6.1,143318,137092,6226,4.3
Webster,6/1/2001,18580,17284,1296,7,143357,136873,6484,4.5
Webster,7/1/2001,18723,17543,1180,6.3,143654,137071,6583,4.6
Webster,8/1/2001,18458,17250,1208,6.5,143284,136241,7042,4.9
Webster,9/1/2001,18320,17087,1233,6.7,143989,136846,7142,5
Webster,10/1/2001,18377,17098,1279,7,144086,136392,7694,5.3
Webster,11/1/2001,18378,17037,1341,7.3,144240,136238,8003,5.5
Webster,12/1/2001,18239,16870,1369,7.5,144305,136047,8258,5.7
Webster,1/1/2002,17984,16383,1601,8.9,143883,135701,8182,5.7
Webster,2/1/2002,17911,16530,1381,7.7,144653,136438,8215,5.7
Webster,3/1/2002,18060,16632,1428,7.9,144481,136177,8304,5.7
Webster,4/1/2002,18011,16642,1369,7.6,144725,136126,8599,5.9
Webster,5/1/2002,17885,16580,1305,7.3,144938,136539,8399,5.8
Webster,6/1/2002,18268,16795,1473,8.1,144808,136415,8393,5.8
Webster,7/1/2002,18460,17103,1357,7.4,144803,136413,8390,5.8
Webster,8/1/2002,18322,16900,1422,7.8,145009,136705,8304,5.7
Webster,9/1/2002,18194,16799,1395,7.7,145552,137302,8251,5.7
Webster,10/1/2002,18151,16774,1377,7.6,145314,137008,8307,5.7
Webster,11/1/2002,17937,16554,1383,7.7,145041,136521,8520,5.9
Webster,12/1/2002,17862,16368,1494,8.4,145066,136426,8640,6
Webster,1/1/2003,18234,16593,1641,9,145937,137417,8520,5.8
Webster,2/1/2003,18254,16672,1582,8.7,146100,137482,8618,5.9
Webster,3/1/2003,18363,16713,1650,9,146022,137434,8588,5.9
Webster,4/1/2003,18420,16814,1606,8.7,146474,137633,8842,6
Webster,5/1/2003,18327,16774,1553,8.5,146500,137544,8957,6.1
Webster,6/1/2003,18862,17049,1813,9.6,147056,137790,9266,6.3
Webster,7/1/2003,18796,17165,1631,8.7,146485,137474,9011,6.2
Webster,8/1/2003,18531,17038,1493,8.1,146445,137549,8896,6.1
Webster,9/1/2003,18378,16962,1416,7.7,146530,137609,8921,6.1
Webster,10/1/2003,18577,17238,1339,7.2,146716,137984,8732,6
Webster,11/1/2003,18435,17192,1243,6.7,147000,138424,8576,5.8
Webster,12/1/2003,18545,17320,1225,6.6,146729,138411,8317,5.7
Webster,1/1/2004,18553,17115,1438,7.8,146842,138472,8370,5.7
Webster,2/1/2004,18411,17177,1234,6.7,146709,138542,8167,5.6
Webster,3/1/2004,18520,17205,1315,7.1,146944,138453,8491,5.8
Webster,4/1/2004,18622,17388,1234,6.6,146850,138680,8170,5.6
Webster,5/1/2004,18565,17342,1223,6.6,147065,138852,8212,5.6
Webster,6/1/2004,19052,17591,1461,7.7,147460,139174,8286,5.6
Webster,7/1/2004,19063,17738,1325,7,147692,139556,8136,5.5
Webster,8/1/2004,18928,17729,1199,6.3,147564,139573,7990,5.4
Webster,9/1/2004,18806,17623,1183,6.3,147415,139487,7927,5.4
Webster,10/1/2004,19069,17880,1189,6.2,147793,139732,8061,5.5
Webster,11/1/2004,19046,17907,1139,6,148162,140231,7932,5.4
Webster,12/1/2004,18943,17815,1128,6,148059,140125,7934,5.4
Webster,1/1/2005,18931,17669,1262,6.7,148029,140245,7784,5.3
Webster,2/1/2005,18762,17598,1164,6.2,148364,140385,7980,5.4
Webster,3/1/2005,18714,17577,1137,6.1,148391,140654,7737,5.2
Webster,4/1/2005,18983,17889,1094,5.8,148926,141254,7672,5.2
Webster,5/1/2005,18989,17841,1148,6,149261,141609,7651,5.1
Webster,6/1/2005,19423,18058,1365,7,149238,141714,7524,5
Webster,7/1/2005,19390,18101,1289,6.6,149432,142026,7406,5
Webster,8/1/2005,19429,18252,1177,6.1,149779,142434,7345,4.9
Webster,9/1/2005,20613,19207,1406,6.8,149954,142401,7553,5
Webster,10/1/2005,20922,19580,1342,6.4,150001,142548,7453,5
Webster,11/1/2005,20878,19502,1376,6.6,150065,142499,7566,5
Webster,12/1/2005,20113,19136,977,4.9,150030,142752,7279,4.9
Webster,1/1/2006,19693,18884,809,4.1,150214,143150,7064,4.7
Webster,2/1/2006,19468,18775,693,3.6,150641,143457,7184,4.8
Webster,3/1/2006,19614,18905,709,3.6,150813,143741,7072,4.7
Webster,4/1/2006,19703,18998,705,3.6,150881,143761,7120,4.7
Webster,5/1/2006,19688,18925,763,3.9,151069,144089,6980,4.6
Webster,6/1/2006,20354,19408,946,4.6,151354,144353,7001,4.6
Webster,7/1/2006,20690,19825,865,4.2,151377,144202,7175,4.7
Webster,8/1/2006,20154,19306,848,4.2,151716,144625,7091,4.7
Webster,9/1/2006,19915,19036,879,4.4,151662,144815,6847,4.5
Webster,10/1/2006,19808,18965,843,4.3,152041,145314,6727,4.4
Webster,11/1/2006,19746,18877,869,4.4,152406,145534,6872,4.5
Webster,12/1/2006,20098,19219,879,4.4,152732,145970,6762,4.4
Webster,1/1/2007,20244,19150,1094,5.4,153144,146028,7116,4.6
Webster,2/1/2007,19746,18823,923,4.7,152983,146057,6927,4.5
Webster,3/1/2007,19779,18892,887,4.5,153051,146320,6731,4.4
Webster,4/1/2007,19768,18844,924,4.7,152435,145586,6850,4.5
Webster,5/1/2007,19646,18703,943,4.8,152670,145903,6766,4.4
Webster,6/1/2007,19945,18777,1168,5.9,153041,146063,6979,4.6
Webster,7/1/2007,19956,18807,1149,5.8,153054,145905,7149,4.7
Webster,8/1/2007,19761,18733,1028,5.2,152749,145682,7067,4.6
Webster,9/1/2007,20103,19076,1027,5.1,153414,146244,7170,4.7
Webster,10/1/2007,19859,18950,909,4.6,153183,145946,7237,4.7
Webster,11/1/2007,19932,19050,882,4.4,153835,146595,7240,4.7
Webster,12/1/2007,19684,18717,967,4.9,153918,146273,7645,5
Webster,1/1/2008,19717,18651,1066,5.4,154063,146378,7685,5
Webster,2/1/2008,19982,18786,1196,6,153653,146156,7497,4.9
Webster,3/1/2008,20092,18883,1209,6,153908,146086,7822,5.1
Webster,4/1/2008,19850,18842,1008,5.1,153769,146132,7637,5
Webster,5/1/2008,19857,18818,1039,5.2,154303,145908,8395,5.4
Webster,6/1/2008,20474,19167,1307,6.4,154313,145737,8575,5.6
Webster,7/1/2008,20436,19122,1314,6.4,154469,145532,8937,5.8
Webster,8/1/2008,20519,19264,1255,6.1,154641,145203,9438,6.1
Webster,9/1/2008,20678,19528,1150,5.6,154570,145076,9494,6.1
Webster,10/1/2008,20517,19288,1229,6,154876,144802,10074,6.5
Webster,11/1/2008,20338,19073,1265,6.2,154639,144100,10538,6.8
Webster,12/1/2008,20078,18711,1367,6.8,154655,143369,11286,7.3
Webster,1/1/2009,19783,18107,1676,8.5,154210,142152,12058,7.8
Webster,2/1/2009,19719,18086,1633,8.3,154538,141640,12898,8.3
Webster,3/1/2009,19755,18102,1653,8.4,154133,140707,13426,8.7
Webster,4/1/2009,19842,18208,1634,8.2,154509,140656,13853,9
Webster,5/1/2009,19745,18053,1692,8.6,154747,140248,14499,9.4
Webster,6/1/2009,20222,18318,1904,9.4,154716,140009,14707,9.5
Webster,7/1/2009,20277,18275,2002,9.9,154502,139901,14601,9.5
Webster,8/1/2009,19660,17908,1752,8.9,154307,139492,14814,9.6
Webster,9/1/2009,19743,18067,1676,8.5,153827,138818,15009,9.8
Webster,10/1/2009,19513,17941,1572,8.1,153784,138432,15352,10
Webster,11/1/2009,19518,18041,1477,7.6,153878,138659,15219,9.9
Webster,12/1/2009,19474,17986,1488,7.6,153111,138013,15098,9.9
Webster,1/1/2010,16524,14906,1618,9.8,153484,138438,15046,9.8
Webster,2/1/2010,16430,14927,1503,9.1,153694,138581,15113,9.8
Webster,3/1/2010,16601,15093,1508,9.1,153954,138751,15202,9.9
Webster,4/1/2010,16747,15302,1445,8.6,154622,139297,15325,9.9
Webster,5/1/2010,16785,15235,1550,9.2,154091,139241,14849,9.6
Webster,6/1/2010,17134,15362,1772,10.3,153616,139141,14474,9.4
Webster,7/1/2010,17241,15442,1799,10.4,153691,139179,14512,9.4
Webster,8/1/2010,16992,15246,1746,10.3,154086,139438,14648,9.5
Webster,9/1/2010,16926,15191,1735,10.3,153975,139396,14579,9.5
Webster,10/1/2010,16931,15261,1670,9.9,153635,139119,14516,9.4
Webster,11/1/2010,16883,15225,1658,9.8,154125,139044,15081,9.8
Webster,12/1/2010,16799,15191,1608,9.6,153650,139301,14348,9.3
Webster,1/1/2011,16599,14851,1748,10.5,153263,139250,14013,9.1
Webster,2/1/2011,16559,14946,1613,9.7,153214,139394,13820,9
Webster,3/1/2011,16646,15073,1573,9.4,153376,139639,13737,9
Webster,4/1/2011,16557,15100,1457,8.8,153543,139586,13957,9.1
Webster,5/1/2011,16536,15038,1498,9.1,153479,139624,13855,9
Webster,6/1/2011,16825,15060,1765,10.5,153346,139384,13962,9.1
Webster,7/1/2011,16897,15207,1690,10,153288,139524,13763,9
Webster,8/1/2011,16717,15120,1597,9.6,153760,139942,13818,9
Webster,9/1/2011,16723,15087,1636,9.8,154131,140183,13948,9
Webster,10/1/2011,16603,15052,1551,9.3,153961,140368,13594,8.8
Webster,11/1/2011,16542,15119,1423,8.6,154128,140826,13302,8.6
Webster,12/1/2011,16406,15007,1399,8.5,153995,140902,13093,8.5
Webster,1/1/2012,16124,14596,1528,9.5,154381,141584,12797,8.3
Webster,2/1/2012,16106,14655,1451,9,154671,141858,12813,8.3
Webster,3/1/2012,16224,14749,1475,9.1,154749,142036,12713,8.2
Webster,4/1/2012,16196,14812,1384,8.5,154545,141899,12646,8.2
Webster,5/1/2012,16185,14747,1438,8.9,154866,142206,12660,8.2
Webster,6/1/2012,16454,14793,1661,10.1,155083,142391,12692,8.2
Webster,7/1/2012,16456,14836,1620,9.8,154948,142292,12656,8.2
Webster,8/1/2012,16173,14657,1516,9.4,154763,142291,12471,8.1
Webster,9/1/2012,16047,14581,1466,9.1,155160,143044,12115,7.8
Webster,10/1/2012,16062,14645,1417,8.8,155554,143431,12124,7.8
Webster,11/1/2012,15924,14597,1327,8.3,155338,143333,12005,7.7
Webster,12/1/2012,15901,14469,1432,9,155628,143330,12298,7.9
Webster,1/1/2013,15752,14099,1653,10.5,155763,143292,12471,8
Webster,2/1/2013,15650,14114,1536,9.8,155312,143362,11950,7.7
Webster,3/1/2013,15721,14213,1508,9.6,155005,143316,11689,7.5
Webster,4/1/2013,15827,14392,1435,9.1,155394,143635,11760,7.6
Webster,5/1/2013,15817,14354,1463,9.2,155536,143882,11654,7.5
Webster,6/1/2013,16108,14435,1673,10.4,155749,143999,11751,7.5
Webster,7/1/2013,15969,14454,1515,9.5,155599,144264,11335,7.3
Webster,8/1/2013,15675,14239,1436,9.2,155605,144326,11279,7.2
Webster,9/1/2013,15591,14189,1402,9,155687,144418,11270,7.2
Webster,10/1/2013,15463,14145,1318,8.5,154673,143537,11136,7.2
Webster,11/1/2013,15460,14263,1197,7.7,155265,144479,10787,6.9
Webster,12/1/2013,15357,14216,1141,7.4,155182,144778,10404,6.7
Webster,1/1/2014,15256,14024,1232,8.1,155352,145150,10202,6.6
Webster,2/1/2014,15259,14081,1178,7.7,155483,145134,10349,6.7
Webster,3/1/2014,15411,14206,1205,7.8,156028,145648,10380,6.7
Webster,4/1/2014,15425,14280,1145,7.4,155369,145667,9702,6.2
Webster,5/1/2014,15505,14230,1275,8.2,155684,145825,9859,6.3
Webster,6/1/2014,15746,14322,1424,9,155707,146247,9460,6.1
Webster,7/1/2014,15879,14410,1469,9.3,156007,146399,9608,6.2
Webster,8/1/2014,15711,14261,1450,9.2,156130,146530,9599,6.1
Webster,9/1/2014,15661,14226,1435,9.2,156040,146778,9262,5.9
Webster,10/1/2014,15748,14356,1392,8.8,156417,147427,8990,5.7
Webster,11/1/2014,15789,14358,1431,9.1,156494,147404,9090,5.8
Webster,12/1/2014,15676,14310,1366,8.7,156332,147615,8717,5.6
Webster,1/1/2015,15579,14104,1475,9.5,157030,148145,8885,5.7
Webster,2/1/2015,15540,14139,1401,9,156644,148045,8599,5.5
Webster,3/1/2015,15594,14205,1389,8.9,156643,148128,8515,5.4
Webster,4/1/2015,15681,14315,1366,8.7,157060,148511,8550,5.4
Webster,5/1/2015,15663,14215,1448,9.2,157651,148817,8834,5.6
Webster,6/1/2015,15766,14225,1541,9.8,157062,148816,8247,5.3
Webster,7/1/2015,15698,14267,1431,9.1,156997,148830,8167,5.2
Webster,8/1/2015,15433,14127,1306,8.5,157172,149181,7992,5.1
Webster,9/1/2015,15310,14034,1276,8.3,156733,148826,7907,5
Webster,10/1/2015,15293,14023,1270,8.3,157167,149246,7922,5
Webster,11/1/2015,15236,14049,1187,7.8,157463,149463,8000,5.1
Webster,12/1/2015,15202,14047,1155,7.6,158035,150128,7907,5
Webster,1/1/2016,15186,13863,1323,8.7,158280,150653,7627,4.8
Webster,2/1/2016,15259,13973,1286,8.4,158640,150939,7702,4.9
Webster,3/1/2016,15334,14023,1311,8.5,159179,151218,7961,5
Webster,4/1/2016,15263,14013,1250,8.2,159141,151074,8067,5.1
Webster,5/1/2016,15212,13946,1266,8.3,158784,151132,7652,4.8
Webster,6/1/2016,15479,14003,1476,9.5,158967,151223,7744,4.9
Webster,7/1/2016,15429,13988,1441,9.3,159194,151554,7641,4.8
Webster,8/1/2016,15187,13822,1365,9,159562,151779,7784,4.9
Webster,9/1/2016,15115,13783,1332,8.8,159714,151761,7953,5
Webster,10/1/2016,15003,13789,1214,8.1,159605,151793,7811,4.9
Webster,11/1/2016,14983,13859,1124,7.5,159506,151954,7553,4.7
Webster,12/1/2016,14862,13779,1083,7.3,159678,152157,7521,4.7
Webster,1/1/2017,14762,13542,1220,8.3,159620,152152,7468,4.7
Webster,2/1/2017,14707,13594,1113,7.6,159859,152480,7379,4.6
Webster,3/1/2017,14791,13726,1065,7.2,160137,153065,7073,4.4
Webster,4/1/2017,14751,13717,1034,7,160345,153255,7089,4.4
Webster,5/1/2017,14621,13588,1033,7.1,160068,153069,7000,4.4
Webster,6/1/2017,14890,13740,1150,7.7,160192,153318,6873,4.3
Webster,7/1/2017,14944,13878,1066,7.1,160462,153569,6892,4.3
Webster,8/1/2017,14798,13762,1036,7,160586,153503,7082,4.4
Webster,9/1/2017,14796,13851,945,6.4,161140,154286,6854,4.3
Webster,10/1/2017,14642,13793,849,5.8,160309,153609,6700,4.2
Webster,11/1/2017,14639,13816,823,5.6,160579,153805,6774,4.2
Webster,12/1/2017,14582,13797,785,5.4,160535,153904,6632,4.1
Webster,1/1/2018,14496,13626,870,6,160914,154425,6489,4
Webster,2/1/2018,14569,13722,847,5.8,161778,155197,6581,4.1
Webster,3/1/2018,14637,13753,884,6,161686,155214,6472,4
Webster,4/1/2018,14656,13814,842,5.7,161771,155312,6459,4
Webster,5/1/2018,14608,13722,886,6.1,161848,155652,6196,3.8
Webster,6/1/2018,14840,13762,1078,7.3,162210,155762,6447,4
Webster,7/1/2018,14865,13875,990,6.7,162341,156146,6195,3.8
Webster,8/1/2018,14563,13637,926,6.4,161660,155504,6156,3.8
Webster,9/1/2018,14452,13599,853,5.9,162087,156015,6073,3.7
Webster,10/1/2018,14463,13635,828,5.7,162602,156391,6211,3.8
Webster,11/1/2018,14453,13672,781,5.4,162836,156721,6115,3.8
Webster,12/1/2018,14376,13607,769,5.3,163206,156817,6389,3.9
Webster,1/1/2019,14334,13441,893,6.2,162963,156487,6475,4
Webster,2/1/2019,14325,13546,779,5.4,162999,156863,6136,3.8
Webster,3/1/2019,14361,13627,734,5.1,162904,156701,6202,3.8
Webster,4/1/2019,14305,13605,700,4.9,162586,156625,5961,3.7
Webster,5/1/2019,14307,13520,787,5.5,162751,156821,5930,3.6
Webster,6/1/2019,14564,13582,982,6.7,163168,157232,5935,3.6
Webster,7/1/2019,14634,13674,960,6.6,163590,157529,6061,3.7
Webster,8/1/2019,14458,13528,930,6.4,163774,157829,5945,3.6
Webster,9/1/2019,14381,13533,848,5.9,164092,158339,5753,3.5
Webster,10/1/2019,14385,13512,873,6.1,164416,158545,5871,3.6
Webster,11/1/2019,14404,13553,851,5.9,164496,158629,5868,3.6
Webster,12/1/2019,14272,13462,810,5.7,164699,158845,5853,3.6
Webster,1/1/2020,14128,13262,866,6.1,164377,158508,5869,3.6
Webster,2/1/2020,14035,13301,734,5.2,164467,158714,5753,3.5
Webster,3/1/2020,14414,13154,1260,8.7,162559,155353,7206,4.4
Webster,4/1/2020,12989,11601,1388,10.7,156269,133185,23084,14.8
Webster,5/1/2020,13220,11775,1445,10.9,158101,137173,20929,13.2
Webster,6/1/2020,13775,12395,1380,10,159994,142342,17652,11
Webster,7/1/2020,13971,12580,1391,10,160132,143779,16352,10.2
Webster,8/1/2020,13897,12705,1192,8.6,160706,147245,13461,8.4
Webster,9/1/2020,13975,12757,1218,8.7,160174,147620,12554,7.8
Webster,10/1/2020,14050,12966,1084,7.7,161003,149931,11072,6.9
Webster,11/1/2020,13965,13004,961,6.9,160629,149934,10694,6.7
Webster,12/1/2020,13860,12894,966,7,160745,149975,10770,6.7
Webster,1/1/2021,13746,12761,985,7.2,160088,149852,10236,6.4
Webster,2/1/2021,13783,12845,938,6.8,160184,150189,9995,6.2
Webster,3/1/2021,13867,12986,881,6.4,160400,150644,9756,6.1
Webster,4/1/2021,13855,13014,841,6.1,160843,151081,9762,6.1
Webster,5/1/2021,13822,12980,842,6.1,160800,151535,9266,5.8
Webster,6/1/2021,14120,13123,997,7.1,161197,151734,9462,5.9
Webster,7/1/2021,14129,13258,871,6.2,161504,152773,8731,5.4
Webster,8/1/2021,13911,13128,783,5.6,161527,153250,8276,5.1
Webster,9/1/2021,14118,13452,666,4.7,161495,153843,7652,4.7
Webster,10/1/2021,13866,13269,597,4.3,161754,154475,7279,4.5
Webster,11/1/2021,13900,13365,535,3.8,162281,155530,6751,4.2
Webster,12/1/2021,13843,13365,478,3.5,162497,156099,6398,3.9
Webster,1/1/2022,13918,13312,606,4.4,163627,157115,6512,4
Webster,2/1/2022,13944,13393,551,4,163899,157598,6301,3.8
Webster,3/1/2022,14023,13504,519,3.7,164220,158206,6014,3.7
Webster,4/1/2022,13994,13502,492,3.5,163893,157891,6002,3.7
Webster,5/1/2022,14011,13475,536,3.8,164362,158378,5983,3.6
Webster,6/1/2022,14299,13582,717,5,164046,158094,5951,3.6
Webster,7/1/2022,14316,13625,691,4.8,164026,158258,5768,3.5
Webster,8/1/2022,14097,13427,670,4.8,164654,158735,5919,3.6
Webster,9/1/2022,14030,13435,595,4.2,164602,158810,5792,3.5
Webster,10/1/2022,14016,13462,554,4,164648,158684,5964,3.6
Webster,11/1/2022,14053,13508,545,3.9,164450,158507,5943,3.6
Webster,12/1/2022,13997,13455,542,3.9,165025,159259,5766,3.5
Webster,1/1/2023,14050,13410,640,4.6,165964,160217,5747,3.5
Webster,2/1/2023,14137,13537,600,4.2,166358,160395,5962,3.6
Webster,3/1/2023,14156,13593,563,4,166651,160812,5839,3.5
Webster,4/1/2023,14166,13667,499,3.5,166725,160974,5751,3.4
Webster,5/1/2023,14118,13528,590,4.2,166886,160796,6089,3.6
Webster,6/1/2023,14317,13606,711,5,166937,160979,5958,3.6
Webster,7/1/2023,14254,13638,616,4.3,167103,161183,5920,3.5
Webster,8/1/2023,14085,13432,653,4.6,167759,161475,6284,3.7
Webster,9/1/2023,14044,13397,647,4.6,167767,161442,6326,3.8
Webster,10/1/2023,14124,13421,703,5,167690,161211,6479,3.9
Webster,11/1/2023,14130,13455,675,4.8,168140,161886,6254,3.7
Webster,12/1/2023,14002,13349,653,4.7,167439,161124,6315,3.8
Webster,1/1/2024,13994,13268,726,5.2,167339,161190,6149,3.7
Webster,2/1/2024,14008,13296,712,5.1,167475,161013,6462,3.9
Webster,3/1/2024,14194,13473,721,5.1,167922,161425,6497,3.9
Webster,4/1/2024,14106,13484,622,4.4,167988,161495,6492,3.9
Webster,5/1/2024,13975,13336,639,4.6,167799,161164,6635,4
Webster,6/1/2024,14316,13485,831,5.8,168005,161155,6849,4.1
Webster,7/1/2024,14364,13542,822,5.7,168315,161219,7097,4.2
Webster,8/1/2024,14171,13356,815,5.8,168496,161425,7071,4.2
Webster,9/1/2024,14111,13345,766,5.4,168703,161802,6901,4.1
Webster,10/1/2024,14116,13340,776,5.5,168428,161456,6972,4.1
Webster,11/1/2024,14099,13352,747,5.3,168304,161183,7121,4.2
Webster,12/1/2024,14030,13335,695,5,168547,161661,6886,4.1
Webster,1/1/2025,12928,12199,729,5.6,170744,163895,6849,4
Webster,2/1/2025,13021,12359,662,5.1,170359,163307,7052,4.1
West Baton Rouge,1/1/1990,8889,8336,553,6.2,125833,119081,6752,5.4
West Baton Rouge,2/1/1990,8931,8463,468,5.2,125710,119059,6651,5.3
West Baton Rouge,3/1/1990,8994,8529,465,5.2,125801,119203,6598,5.2
West Baton Rouge,4/1/1990,9037,8528,509,5.6,125649,118852,6797,5.4
West Baton Rouge,5/1/1990,9088,8513,575,6.3,125893,119151,6742,5.4
West Baton Rouge,6/1/1990,9206,8605,601,6.5,125573,118983,6590,5.2
West Baton Rouge,7/1/1990,9277,8684,593,6.4,125732,118810,6922,5.5
West Baton Rouge,8/1/1990,9105,8530,575,6.3,125990,118802,7188,5.7
West Baton Rouge,9/1/1990,9196,8520,676,7.4,125892,118524,7368,5.9
West Baton Rouge,10/1/1990,9285,8625,660,7.1,125995,118536,7459,5.9
West Baton Rouge,11/1/1990,9204,8676,528,5.7,126070,118306,7764,6.2
West Baton Rouge,12/1/1990,9233,8650,583,6.3,126142,118241,7901,6.3
West Baton Rouge,1/1/1991,9032,8372,660,7.3,125955,117940,8015,6.4
West Baton Rouge,2/1/1991,9114,8507,607,6.7,126020,117755,8265,6.6
West Baton Rouge,3/1/1991,9162,8579,583,6.4,126238,117652,8586,6.8
West Baton Rouge,4/1/1991,9340,8656,684,7.3,126548,118109,8439,6.7
West Baton Rouge,5/1/1991,9223,8529,694,7.5,126176,117440,8736,6.9
West Baton Rouge,6/1/1991,9433,8681,752,8,126331,117639,8692,6.9
West Baton Rouge,7/1/1991,9570,8815,755,7.9,126154,117568,8586,6.8
West Baton Rouge,8/1/1991,9338,8629,709,7.6,126150,117484,8666,6.9
West Baton Rouge,9/1/1991,9464,8748,716,7.6,126650,117928,8722,6.9
West Baton Rouge,10/1/1991,9316,8735,581,6.2,126642,117800,8842,7
West Baton Rouge,11/1/1991,9315,8752,563,6,126701,117770,8931,7
West Baton Rouge,12/1/1991,9269,8711,558,6,126664,117466,9198,7.3
West Baton Rouge,1/1/1992,9147,8472,675,7.4,127261,117978,9283,7.3
West Baton Rouge,2/1/1992,9183,8629,554,6,127207,117753,9454,7.4
West Baton Rouge,3/1/1992,9250,8708,542,5.9,127604,118144,9460,7.4
West Baton Rouge,4/1/1992,9271,8746,525,5.7,127841,118426,9415,7.4
West Baton Rouge,5/1/1992,9235,8687,548,5.9,128119,118375,9744,7.6
West Baton Rouge,6/1/1992,9563,8846,717,7.5,128459,118419,10040,7.8
West Baton Rouge,7/1/1992,9916,9218,698,7,128563,118713,9850,7.7
West Baton Rouge,8/1/1992,9737,9082,655,6.7,128613,118826,9787,7.6
West Baton Rouge,9/1/1992,9605,9005,600,6.2,128501,118720,9781,7.6
West Baton Rouge,10/1/1992,9548,9001,547,5.7,128026,118628,9398,7.3
West Baton Rouge,11/1/1992,9517,8973,544,5.7,128441,118876,9565,7.4
West Baton Rouge,12/1/1992,9217,8694,523,5.7,128554,118997,9557,7.4
West Baton Rouge,1/1/1993,9145,8479,666,7.3,128400,119075,9325,7.3
West Baton Rouge,2/1/1993,9239,8624,615,6.7,128458,119275,9183,7.1
West Baton Rouge,3/1/1993,9298,8631,667,7.2,128598,119542,9056,7
West Baton Rouge,4/1/1993,9266,8672,594,6.4,128584,119474,9110,7.1
West Baton Rouge,5/1/1993,9262,8657,605,6.5,129264,120115,9149,7.1
West Baton Rouge,6/1/1993,9423,8704,719,7.6,129411,120290,9121,7
West Baton Rouge,7/1/1993,9544,8764,780,8.2,129397,120467,8930,6.9
West Baton Rouge,8/1/1993,9360,8611,749,8,129619,120856,8763,6.8
West Baton Rouge,9/1/1993,9385,8633,752,8,129268,120554,8714,6.7
West Baton Rouge,10/1/1993,9416,8693,723,7.7,129573,120823,8750,6.8
West Baton Rouge,11/1/1993,9475,8753,722,7.6,129711,121169,8542,6.6
West Baton Rouge,12/1/1993,9376,8668,708,7.6,129941,121464,8477,6.5
West Baton Rouge,1/1/1994,9407,8467,940,10,130596,121966,8630,6.6
West Baton Rouge,2/1/1994,9403,8637,766,8.1,130669,122086,8583,6.6
West Baton Rouge,3/1/1994,9418,8635,783,8.3,130400,121930,8470,6.5
West Baton Rouge,4/1/1994,9366,8579,787,8.4,130621,122290,8331,6.4
West Baton Rouge,5/1/1994,9356,8580,776,8.3,130779,122864,7915,6.1
West Baton Rouge,6/1/1994,9648,8687,961,10,130561,122634,7927,6.1
West Baton Rouge,7/1/1994,9683,8787,896,9.3,130652,122706,7946,6.1
West Baton Rouge,8/1/1994,9603,8738,865,9,131275,123342,7933,6
West Baton Rouge,9/1/1994,9628,8839,789,8.2,131421,123687,7734,5.9
West Baton Rouge,10/1/1994,9643,8848,795,8.2,131744,124112,7632,5.8
West Baton Rouge,11/1/1994,9529,8891,638,6.7,131891,124516,7375,5.6
West Baton Rouge,12/1/1994,9433,8807,626,6.6,131951,124721,7230,5.5
West Baton Rouge,1/1/1995,9377,8679,698,7.4,132038,124663,7375,5.6
West Baton Rouge,2/1/1995,9461,8819,642,6.8,132115,124928,7187,5.4
West Baton Rouge,3/1/1995,9503,8883,620,6.5,132108,124955,7153,5.4
West Baton Rouge,4/1/1995,9605,8868,737,7.7,132590,124945,7645,5.8
West Baton Rouge,5/1/1995,9433,8790,643,6.8,131851,124421,7430,5.6
West Baton Rouge,6/1/1995,9611,8863,748,7.8,131949,124522,7427,5.6
West Baton Rouge,7/1/1995,9700,9026,674,6.9,132343,124816,7527,5.7
West Baton Rouge,8/1/1995,9580,8867,713,7.4,132336,124852,7484,5.7
West Baton Rouge,9/1/1995,9617,8897,720,7.5,132611,125133,7478,5.6
West Baton Rouge,10/1/1995,9634,9005,629,6.5,132716,125388,7328,5.5
West Baton Rouge,11/1/1995,9598,9060,538,5.6,132614,125188,7426,5.6
West Baton Rouge,12/1/1995,9434,8909,525,5.6,132511,125088,7423,5.6
West Baton Rouge,1/1/1996,9444,8765,679,7.2,132616,125125,7491,5.6
West Baton Rouge,2/1/1996,9457,8965,492,5.2,132952,125639,7313,5.5
West Baton Rouge,3/1/1996,9637,9072,565,5.9,133180,125862,7318,5.5
West Baton Rouge,4/1/1996,9649,9022,627,6.5,133409,125994,7415,5.6
West Baton Rouge,5/1/1996,9593,9037,556,5.8,133667,126244,7423,5.6
West Baton Rouge,6/1/1996,9780,9149,631,6.5,133697,126602,7095,5.3
West Baton Rouge,7/1/1996,9872,9212,660,6.7,134284,126947,7337,5.5
West Baton Rouge,8/1/1996,9798,9145,653,6.7,134054,127172,6882,5.1
West Baton Rouge,9/1/1996,9796,9230,566,5.8,134515,127536,6979,5.2
West Baton Rouge,10/1/1996,9819,9332,487,5,134921,127890,7031,5.2
West Baton Rouge,11/1/1996,9837,9356,481,4.9,135007,127771,7236,5.4
West Baton Rouge,12/1/1996,9676,9232,444,4.6,135113,127860,7253,5.4
West Baton Rouge,1/1/1997,9393,8858,535,5.7,135456,128298,7158,5.3
West Baton Rouge,2/1/1997,9454,8971,483,5.1,135400,128298,7102,5.2
West Baton Rouge,3/1/1997,9570,9102,468,4.9,135891,128891,7000,5.2
West Baton Rouge,4/1/1997,9523,9054,469,4.9,136016,129143,6873,5.1
West Baton Rouge,5/1/1997,9480,8954,526,5.5,136119,129464,6655,4.9
West Baton Rouge,6/1/1997,9628,9002,626,6.5,136211,129412,6799,5
West Baton Rouge,7/1/1997,9659,9077,582,6,136477,129822,6655,4.9
West Baton Rouge,8/1/1997,9556,8987,569,6,136618,130010,6608,4.8
West Baton Rouge,9/1/1997,9604,9053,551,5.7,136675,130019,6656,4.9
West Baton Rouge,10/1/1997,9641,9163,478,5,136633,130179,6454,4.7
West Baton Rouge,11/1/1997,9682,9245,437,4.5,136961,130653,6308,4.6
West Baton Rouge,12/1/1997,9588,9214,374,3.9,137155,130679,6476,4.7
West Baton Rouge,1/1/1998,9463,8982,481,5.1,137095,130726,6368,4.6
West Baton Rouge,2/1/1998,9532,9144,388,4.1,137112,130807,6306,4.6
West Baton Rouge,3/1/1998,9623,9202,421,4.4,137236,130814,6422,4.7
West Baton Rouge,4/1/1998,9739,9299,440,4.5,137150,131209,5941,4.3
West Baton Rouge,5/1/1998,9740,9266,474,4.9,137372,131325,6047,4.4
West Baton Rouge,6/1/1998,9804,9306,498,5.1,137455,131244,6212,4.5
West Baton Rouge,7/1/1998,9870,9399,471,4.8,137588,131329,6259,4.5
West Baton Rouge,8/1/1998,9855,9341,514,5.2,137570,131390,6179,4.5
West Baton Rouge,9/1/1998,9923,9396,527,5.3,138286,131986,6300,4.6
West Baton Rouge,10/1/1998,9956,9509,447,4.5,138279,131999,6280,4.5
West Baton Rouge,11/1/1998,9966,9538,428,4.3,138381,132280,6100,4.4
West Baton Rouge,12/1/1998,9892,9522,370,3.7,138634,132602,6032,4.4
West Baton Rouge,1/1/1999,9585,9151,434,4.5,139003,133027,5976,4.3
West Baton Rouge,2/1/1999,9653,9315,338,3.5,138967,132856,6111,4.4
West Baton Rouge,3/1/1999,9662,9321,341,3.5,138730,132947,5783,4.2
West Baton Rouge,4/1/1999,9739,9372,367,3.8,138959,132955,6004,4.3
West Baton Rouge,5/1/1999,9720,9324,396,4.1,139107,133311,5796,4.2
West Baton Rouge,6/1/1999,9884,9421,463,4.7,139329,133378,5951,4.3
West Baton Rouge,7/1/1999,9962,9506,456,4.6,139439,133414,6025,4.3
West Baton Rouge,8/1/1999,9925,9476,449,4.5,139430,133591,5838,4.2
West Baton Rouge,9/1/1999,9994,9520,474,4.7,139622,133707,5915,4.2
West Baton Rouge,10/1/1999,10007,9610,397,4,139771,133993,5778,4.1
West Baton Rouge,11/1/1999,10003,9676,327,3.3,140025,134309,5716,4.1
West Baton Rouge,12/1/1999,9921,9633,288,2.9,140177,134523,5653,4
West Baton Rouge,1/1/2000,10076,9574,502,5,142267,136559,5708,4
West Baton Rouge,2/1/2000,10144,9681,463,4.6,142456,136598,5858,4.1
West Baton Rouge,3/1/2000,10216,9720,496,4.9,142434,136701,5733,4
West Baton Rouge,4/1/2000,10254,9824,430,4.2,142751,137270,5481,3.8
West Baton Rouge,5/1/2000,10153,9641,512,5,142388,136630,5758,4
West Baton Rouge,6/1/2000,10310,9714,596,5.8,142591,136940,5651,4
West Baton Rouge,7/1/2000,10062,9503,559,5.6,142278,136531,5747,4
West Baton Rouge,8/1/2000,10069,9495,574,5.7,142514,136662,5853,4.1
West Baton Rouge,9/1/2000,10027,9494,533,5.3,142518,136893,5625,3.9
West Baton Rouge,10/1/2000,10051,9523,528,5.3,142622,137088,5534,3.9
West Baton Rouge,11/1/2000,10074,9546,528,5.2,142962,137322,5639,3.9
West Baton Rouge,12/1/2000,10041,9537,504,5,143248,137614,5634,3.9
West Baton Rouge,1/1/2001,10088,9461,627,6.2,143800,137778,6023,4.2
West Baton Rouge,2/1/2001,9983,9472,511,5.1,143701,137612,6089,4.2
West Baton Rouge,3/1/2001,10030,9465,565,5.6,143924,137783,6141,4.3
West Baton Rouge,4/1/2001,10041,9524,517,5.1,143569,137299,6271,4.4
West Baton Rouge,5/1/2001,10013,9484,529,5.3,143318,137092,6226,4.3
West Baton Rouge,6/1/2001,10141,9517,624,6.2,143357,136873,6484,4.5
West Baton Rouge,7/1/2001,9989,9432,557,5.6,143654,137071,6583,4.6
West Baton Rouge,8/1/2001,9900,9355,545,5.5,143284,136241,7042,4.9
West Baton Rouge,9/1/2001,9950,9396,554,5.6,143989,136846,7142,5
West Baton Rouge,10/1/2001,10061,9540,521,5.2,144086,136392,7694,5.3
West Baton Rouge,11/1/2001,10067,9526,541,5.4,144240,136238,8003,5.5
West Baton Rouge,12/1/2001,10039,9488,551,5.5,144305,136047,8258,5.7
West Baton Rouge,1/1/2002,9851,9223,628,6.4,143883,135701,8182,5.7
West Baton Rouge,2/1/2002,9875,9341,534,5.4,144653,136438,8215,5.7
West Baton Rouge,3/1/2002,9845,9323,522,5.3,144481,136177,8304,5.7
West Baton Rouge,4/1/2002,9940,9416,524,5.3,144725,136126,8599,5.9
West Baton Rouge,5/1/2002,9892,9329,563,5.7,144938,136539,8399,5.8
West Baton Rouge,6/1/2002,10061,9398,663,6.6,144808,136415,8393,5.8
West Baton Rouge,7/1/2002,9947,9360,587,5.9,144803,136413,8390,5.8
West Baton Rouge,8/1/2002,9956,9345,611,6.1,145009,136705,8304,5.7
West Baton Rouge,9/1/2002,10012,9409,603,6,145552,137302,8251,5.7
West Baton Rouge,10/1/2002,10069,9488,581,5.8,145314,137008,8307,5.7
West Baton Rouge,11/1/2002,9980,9423,557,5.6,145041,136521,8520,5.9
West Baton Rouge,12/1/2002,9932,9351,581,5.8,145066,136426,8640,6
West Baton Rouge,1/1/2003,9876,9181,695,7,145937,137417,8520,5.8
West Baton Rouge,2/1/2003,9968,9347,621,6.2,146100,137482,8618,5.9
West Baton Rouge,3/1/2003,10037,9327,710,7.1,146022,137434,8588,5.9
West Baton Rouge,4/1/2003,10169,9455,714,7,146474,137633,8842,6
West Baton Rouge,5/1/2003,10066,9344,722,7.2,146500,137544,8957,6.1
West Baton Rouge,6/1/2003,10186,9328,858,8.4,147056,137790,9266,6.3
West Baton Rouge,7/1/2003,10198,9395,803,7.9,146485,137474,9011,6.2
West Baton Rouge,8/1/2003,10068,9330,738,7.3,146445,137549,8896,6.1
West Baton Rouge,9/1/2003,10008,9343,665,6.6,146530,137609,8921,6.1
West Baton Rouge,10/1/2003,10099,9485,614,6.1,146716,137984,8732,6
West Baton Rouge,11/1/2003,10073,9461,612,6.1,147000,138424,8576,5.8
West Baton Rouge,12/1/2003,9993,9396,597,6,146729,138411,8317,5.7
West Baton Rouge,1/1/2004,10030,9320,710,7.1,146842,138472,8370,5.7
West Baton Rouge,2/1/2004,10062,9469,593,5.9,146709,138542,8167,5.6
West Baton Rouge,3/1/2004,10168,9539,629,6.2,146944,138453,8491,5.8
West Baton Rouge,4/1/2004,10235,9562,673,6.6,146850,138680,8170,5.6
West Baton Rouge,5/1/2004,10088,9431,657,6.5,147065,138852,8212,5.6
West Baton Rouge,6/1/2004,10362,9528,834,8,147460,139174,8286,5.6
West Baton Rouge,7/1/2004,10305,9574,731,7.1,147692,139556,8136,5.5
West Baton Rouge,8/1/2004,10225,9540,685,6.7,147564,139573,7990,5.4
West Baton Rouge,9/1/2004,10202,9538,664,6.5,147415,139487,7927,5.4
West Baton Rouge,10/1/2004,10263,9630,633,6.2,147793,139732,8061,5.5
West Baton Rouge,11/1/2004,10304,9696,608,5.9,148162,140231,7932,5.4
West Baton Rouge,12/1/2004,10210,9633,577,5.7,148059,140125,7934,5.4
West Baton Rouge,1/1/2005,9957,9281,676,6.8,148029,140245,7784,5.3
West Baton Rouge,2/1/2005,10031,9407,624,6.2,148364,140385,7980,5.4
West Baton Rouge,3/1/2005,10103,9480,623,6.2,148391,140654,7737,5.2
West Baton Rouge,4/1/2005,10216,9631,585,5.7,148926,141254,7672,5.2
West Baton Rouge,5/1/2005,10069,9481,588,5.8,149261,141609,7651,5.1
West Baton Rouge,6/1/2005,10173,9516,657,6.5,149238,141714,7524,5
West Baton Rouge,7/1/2005,10161,9571,590,5.8,149432,142026,7406,5
West Baton Rouge,8/1/2005,10133,9573,560,5.5,149779,142434,7345,4.9
West Baton Rouge,9/1/2005,11561,10311,1250,10.8,149954,142401,7553,5
West Baton Rouge,10/1/2005,11545,10497,1048,9.1,150001,142548,7453,5
West Baton Rouge,11/1/2005,11527,10509,1018,8.8,150065,142499,7566,5
West Baton Rouge,12/1/2005,10989,10385,604,5.5,150030,142752,7279,4.9
West Baton Rouge,1/1/2006,10575,10088,487,4.6,150214,143150,7064,4.7
West Baton Rouge,2/1/2006,10606,10216,390,3.7,150641,143457,7184,4.8
West Baton Rouge,3/1/2006,10638,10241,397,3.7,150813,143741,7072,4.7
West Baton Rouge,4/1/2006,10572,10198,374,3.5,150881,143761,7120,4.7
West Baton Rouge,5/1/2006,10552,10118,434,4.1,151069,144089,6980,4.6
West Baton Rouge,6/1/2006,10559,10059,500,4.7,151354,144353,7001,4.6
West Baton Rouge,7/1/2006,10410,9967,443,4.3,151377,144202,7175,4.7
West Baton Rouge,8/1/2006,10426,9996,430,4.1,151716,144625,7091,4.7
West Baton Rouge,9/1/2006,10432,10008,424,4.1,151662,144815,6847,4.5
West Baton Rouge,10/1/2006,10555,10133,422,4,152041,145314,6727,4.4
West Baton Rouge,11/1/2006,10553,10131,422,4,152406,145534,6872,4.5
West Baton Rouge,12/1/2006,10526,10143,383,3.6,152732,145970,6762,4.4
West Baton Rouge,1/1/2007,10429,9963,466,4.5,153144,146028,7116,4.6
West Baton Rouge,2/1/2007,10497,10077,420,4,152983,146057,6927,4.5
West Baton Rouge,3/1/2007,10584,10191,393,3.7,153051,146320,6731,4.4
West Baton Rouge,4/1/2007,10589,10216,373,3.5,152435,145586,6850,4.5
West Baton Rouge,5/1/2007,10625,10191,434,4.1,152670,145903,6766,4.4
West Baton Rouge,6/1/2007,10783,10263,520,4.8,153041,146063,6979,4.6
West Baton Rouge,7/1/2007,10810,10340,470,4.3,153054,145905,7149,4.7
West Baton Rouge,8/1/2007,10669,10236,433,4.1,152749,145682,7067,4.6
West Baton Rouge,9/1/2007,10719,10301,418,3.9,153414,146244,7170,4.7
West Baton Rouge,10/1/2007,10747,10387,360,3.3,153183,145946,7237,4.7
West Baton Rouge,11/1/2007,10802,10437,365,3.4,153835,146595,7240,4.7
West Baton Rouge,12/1/2007,10772,10379,393,3.6,153918,146273,7645,5
West Baton Rouge,1/1/2008,10486,10018,468,4.5,154063,146378,7685,5
West Baton Rouge,2/1/2008,10507,10103,404,3.8,153653,146156,7497,4.9
West Baton Rouge,3/1/2008,10613,10174,439,4.1,153908,146086,7822,5.1
West Baton Rouge,4/1/2008,10640,10269,371,3.5,153769,146132,7637,5
West Baton Rouge,5/1/2008,10635,10203,432,4.1,154303,145908,8395,5.4
West Baton Rouge,6/1/2008,10860,10313,547,5,154313,145737,8575,5.6
West Baton Rouge,7/1/2008,10846,10321,525,4.8,154469,145532,8937,5.8
West Baton Rouge,8/1/2008,10761,10212,549,5.1,154641,145203,9438,6.1
West Baton Rouge,9/1/2008,10862,10231,631,5.8,154570,145076,9494,6.1
West Baton Rouge,10/1/2008,10933,10356,577,5.3,154876,144802,10074,6.5
West Baton Rouge,11/1/2008,10881,10352,529,4.9,154639,144100,10538,6.8
West Baton Rouge,12/1/2008,10852,10299,553,5.1,154655,143369,11286,7.3
West Baton Rouge,1/1/2009,10546,9903,643,6.1,154210,142152,12058,7.8
West Baton Rouge,2/1/2009,10604,9986,618,5.8,154538,141640,12898,8.3
West Baton Rouge,3/1/2009,10682,10033,649,6.1,154133,140707,13426,8.7
West Baton Rouge,4/1/2009,10715,10090,625,5.8,154509,140656,13853,9
West Baton Rouge,5/1/2009,10682,9998,684,6.4,154747,140248,14499,9.4
West Baton Rouge,6/1/2009,10841,10015,826,7.6,154716,140009,14707,9.5
West Baton Rouge,7/1/2009,10945,10130,815,7.4,154502,139901,14601,9.5
West Baton Rouge,8/1/2009,10785,10046,739,6.9,154307,139492,14814,9.6
West Baton Rouge,9/1/2009,10802,10080,722,6.7,153827,138818,15009,9.8
West Baton Rouge,10/1/2009,10773,10051,722,6.7,153784,138432,15352,10
West Baton Rouge,11/1/2009,10784,10083,701,6.5,153878,138659,15219,9.9
West Baton Rouge,12/1/2009,10622,9921,701,6.6,153111,138013,15098,9.9
West Baton Rouge,1/1/2010,11801,10978,823,7,153484,138438,15046,9.8
West Baton Rouge,2/1/2010,11755,11010,745,6.3,153694,138581,15113,9.8
West Baton Rouge,3/1/2010,11860,11096,764,6.4,153954,138751,15202,9.9
West Baton Rouge,4/1/2010,11906,11143,763,6.4,154622,139297,15325,9.9
West Baton Rouge,5/1/2010,11894,11052,842,7.1,154091,139241,14849,9.6
West Baton Rouge,6/1/2010,12071,11085,986,8.2,153616,139141,14474,9.4
West Baton Rouge,7/1/2010,12066,11069,997,8.3,153691,139179,14512,9.4
West Baton Rouge,8/1/2010,12007,11053,954,7.9,154086,139438,14648,9.5
West Baton Rouge,9/1/2010,12011,11066,945,7.9,153975,139396,14579,9.5
West Baton Rouge,10/1/2010,12017,11115,902,7.5,153635,139119,14516,9.4
West Baton Rouge,11/1/2010,12033,11116,917,7.6,154125,139044,15081,9.8
West Baton Rouge,12/1/2010,11954,11063,891,7.5,153650,139301,14348,9.3
West Baton Rouge,1/1/2011,11983,10991,992,8.3,153263,139250,14013,9.1
West Baton Rouge,2/1/2011,11969,11094,875,7.3,153214,139394,13820,9
West Baton Rouge,3/1/2011,12050,11175,875,7.3,153376,139639,13737,9
West Baton Rouge,4/1/2011,12015,11186,829,6.9,153543,139586,13957,9.1
West Baton Rouge,5/1/2011,11939,11090,849,7.1,153479,139624,13855,9
West Baton Rouge,6/1/2011,12005,11041,964,8,153346,139384,13962,9.1
West Baton Rouge,7/1/2011,11959,11045,914,7.6,153288,139524,13763,9
West Baton Rouge,8/1/2011,11832,10971,861,7.3,153760,139942,13818,9
West Baton Rouge,9/1/2011,12011,11127,884,7.4,154131,140183,13948,9
West Baton Rouge,10/1/2011,12090,11250,840,6.9,153961,140368,13594,8.8
West Baton Rouge,11/1/2011,12050,11244,806,6.7,154128,140826,13302,8.6
West Baton Rouge,12/1/2011,11969,11153,816,6.8,153995,140902,13093,8.5
West Baton Rouge,1/1/2012,11853,10976,877,7.4,154381,141584,12797,8.3
West Baton Rouge,2/1/2012,11923,11101,822,6.9,154671,141858,12813,8.3
West Baton Rouge,3/1/2012,12011,11214,797,6.6,154749,142036,12713,8.2
West Baton Rouge,4/1/2012,11984,11241,743,6.2,154545,141899,12646,8.2
West Baton Rouge,5/1/2012,11935,11161,774,6.5,154866,142206,12660,8.2
West Baton Rouge,6/1/2012,12078,11171,907,7.5,155083,142391,12692,8.2
West Baton Rouge,7/1/2012,11962,11101,861,7.2,154948,142292,12656,8.2
West Baton Rouge,8/1/2012,11925,11128,797,6.7,154763,142291,12471,8.1
West Baton Rouge,9/1/2012,12014,11279,735,6.1,155160,143044,12115,7.8
West Baton Rouge,10/1/2012,12097,11379,718,5.9,155554,143431,12124,7.8
West Baton Rouge,11/1/2012,12021,11363,658,5.5,155338,143333,12005,7.7
West Baton Rouge,12/1/2012,11937,11243,694,5.8,155628,143330,12298,7.9
West Baton Rouge,1/1/2013,12077,11260,817,6.8,155763,143292,12471,8
West Baton Rouge,2/1/2013,12138,11397,741,6.1,155312,143362,11950,7.7
West Baton Rouge,3/1/2013,12264,11533,731,6,155005,143316,11689,7.5
West Baton Rouge,4/1/2013,12354,11656,698,5.6,155394,143635,11760,7.6
West Baton Rouge,5/1/2013,12357,11608,749,6.1,155536,143882,11654,7.5
West Baton Rouge,6/1/2013,12460,11604,856,6.9,155749,143999,11751,7.5
West Baton Rouge,7/1/2013,12399,11597,802,6.5,155599,144264,11335,7.3
West Baton Rouge,8/1/2013,12299,11560,739,6,155605,144326,11279,7.2
West Baton Rouge,9/1/2013,12366,11662,704,5.7,155687,144418,11270,7.2
West Baton Rouge,10/1/2013,12347,11697,650,5.3,154673,143537,11136,7.2
West Baton Rouge,11/1/2013,12380,11761,619,5,155265,144479,10787,6.9
West Baton Rouge,12/1/2013,12171,11617,554,4.6,155182,144778,10404,6.7
West Baton Rouge,1/1/2014,12313,11681,632,5.1,155352,145150,10202,6.6
West Baton Rouge,2/1/2014,12422,11822,600,4.8,155483,145134,10349,6.7
West Baton Rouge,3/1/2014,12602,11983,619,4.9,156028,145648,10380,6.7
West Baton Rouge,4/1/2014,12656,12060,596,4.7,155369,145667,9702,6.2
West Baton Rouge,5/1/2014,12746,12069,677,5.3,155684,145825,9859,6.3
West Baton Rouge,6/1/2014,12848,12065,783,6.1,155707,146247,9460,6.1
West Baton Rouge,7/1/2014,12937,12100,837,6.5,156007,146399,9608,6.2
West Baton Rouge,8/1/2014,12938,12118,820,6.3,156130,146530,9599,6.1
West Baton Rouge,9/1/2014,13035,12228,807,6.2,156040,146778,9262,5.9
West Baton Rouge,10/1/2014,13222,12418,804,6.1,156417,147427,8990,5.7
West Baton Rouge,11/1/2014,13142,12323,819,6.2,156494,147404,9090,5.8
West Baton Rouge,12/1/2014,12932,12178,754,5.8,156332,147615,8717,5.6
West Baton Rouge,1/1/2015,13069,12212,857,6.6,157030,148145,8885,5.7
West Baton Rouge,2/1/2015,13095,12323,772,5.9,156644,148045,8599,5.5
West Baton Rouge,3/1/2015,13162,12435,727,5.5,156643,148128,8515,5.4
West Baton Rouge,4/1/2015,13219,12513,706,5.3,157060,148511,8550,5.4
West Baton Rouge,5/1/2015,13239,12501,738,5.6,157651,148817,8834,5.6
West Baton Rouge,6/1/2015,13256,12458,798,6,157062,148816,8247,5.3
West Baton Rouge,7/1/2015,13301,12503,798,6,156997,148830,8167,5.2
West Baton Rouge,8/1/2015,13185,12458,727,5.5,157172,149181,7992,5.1
West Baton Rouge,9/1/2015,13207,12480,727,5.5,156733,148826,7907,5
West Baton Rouge,10/1/2015,13264,12600,664,5,157167,149246,7922,5
West Baton Rouge,11/1/2015,13241,12598,643,4.9,157463,149463,8000,5.1
West Baton Rouge,12/1/2015,13068,12461,607,4.6,158035,150128,7907,5
West Baton Rouge,1/1/2016,13050,12359,691,5.3,158280,150653,7627,4.8
West Baton Rouge,2/1/2016,13170,12529,641,4.9,158640,150939,7702,4.9
West Baton Rouge,3/1/2016,13331,12659,672,5,159179,151218,7961,5
West Baton Rouge,4/1/2016,13302,12653,649,4.9,159141,151074,8067,5.1
West Baton Rouge,5/1/2016,13223,12539,684,5.2,158784,151132,7652,4.8
West Baton Rouge,6/1/2016,13393,12551,842,6.3,158967,151223,7744,4.9
West Baton Rouge,7/1/2016,13414,12591,823,6.1,159194,151554,7641,4.8
West Baton Rouge,8/1/2016,13139,12373,766,5.8,159562,151779,7784,4.9
West Baton Rouge,9/1/2016,13259,12512,747,5.6,159714,151761,7953,5
West Baton Rouge,10/1/2016,13323,12651,672,5,159605,151793,7811,4.9
West Baton Rouge,11/1/2016,13205,12586,619,4.7,159506,151954,7553,4.7
West Baton Rouge,12/1/2016,13028,12417,611,4.7,159678,152157,7521,4.7
West Baton Rouge,1/1/2017,13269,12585,684,5.2,159620,152152,7468,4.7
West Baton Rouge,2/1/2017,13443,12817,626,4.7,159859,152480,7379,4.6
West Baton Rouge,3/1/2017,13490,12893,597,4.4,160137,153065,7073,4.4
West Baton Rouge,4/1/2017,13471,12888,583,4.3,160345,153255,7089,4.4
West Baton Rouge,5/1/2017,13325,12737,588,4.4,160068,153069,7000,4.4
West Baton Rouge,6/1/2017,13439,12725,714,5.3,160192,153318,6873,4.3
West Baton Rouge,7/1/2017,13530,12827,703,5.2,160462,153569,6892,4.3
West Baton Rouge,8/1/2017,13523,12840,683,5.1,160586,153503,7082,4.4
West Baton Rouge,9/1/2017,13619,12990,629,4.6,161140,154286,6854,4.3
West Baton Rouge,10/1/2017,13576,13024,552,4.1,160309,153609,6700,4.2
West Baton Rouge,11/1/2017,13552,13017,535,3.9,160579,153805,6774,4.2
West Baton Rouge,12/1/2017,13420,12904,516,3.8,160535,153904,6632,4.1
West Baton Rouge,1/1/2018,13416,12811,605,4.5,160914,154425,6489,4
West Baton Rouge,2/1/2018,13595,13021,574,4.2,161778,155197,6581,4.1
West Baton Rouge,3/1/2018,13761,13183,578,4.2,161686,155214,6472,4
West Baton Rouge,4/1/2018,13718,13168,550,4,161771,155312,6459,4
West Baton Rouge,5/1/2018,13590,13012,578,4.3,161848,155652,6196,3.8
West Baton Rouge,6/1/2018,13796,13060,736,5.3,162210,155762,6447,4
West Baton Rouge,7/1/2018,13796,13086,710,5.1,162341,156146,6195,3.8
West Baton Rouge,8/1/2018,13585,12968,617,4.5,161660,155504,6156,3.8
West Baton Rouge,9/1/2018,13648,13082,566,4.1,162087,156015,6073,3.7
West Baton Rouge,10/1/2018,13773,13205,568,4.1,162602,156391,6211,3.8
West Baton Rouge,11/1/2018,13799,13271,528,3.8,162836,156721,6115,3.8
West Baton Rouge,12/1/2018,13704,13153,551,4,163206,156817,6389,3.9
West Baton Rouge,1/1/2019,13623,12972,651,4.8,162963,156487,6475,4
West Baton Rouge,2/1/2019,13708,13146,562,4.1,162999,156863,6136,3.8
West Baton Rouge,3/1/2019,13731,13214,517,3.8,162904,156701,6202,3.8
West Baton Rouge,4/1/2019,13651,13166,485,3.6,162586,156625,5961,3.7
West Baton Rouge,5/1/2019,13585,13019,566,4.2,162751,156821,5930,3.6
West Baton Rouge,6/1/2019,13714,12997,717,5.2,163168,157232,5935,3.6
West Baton Rouge,7/1/2019,13652,12956,696,5.1,163590,157529,6061,3.7
West Baton Rouge,8/1/2019,13557,12905,652,4.8,163774,157829,5945,3.6
West Baton Rouge,9/1/2019,13600,13005,595,4.4,164092,158339,5753,3.5
West Baton Rouge,10/1/2019,13691,13100,591,4.3,164416,158545,5871,3.6
West Baton Rouge,11/1/2019,13736,13167,569,4.1,164496,158629,5868,3.6
West Baton Rouge,12/1/2019,13516,12970,546,4,164699,158845,5853,3.6
West Baton Rouge,1/1/2020,13497,12889,608,4.5,164377,158508,5869,3.6
West Baton Rouge,2/1/2020,13521,13038,483,3.6,164467,158714,5753,3.5
West Baton Rouge,3/1/2020,13718,12865,853,6.2,162559,155353,7206,4.4
West Baton Rouge,4/1/2020,12588,11183,1405,11.2,156269,133185,23084,14.8
West Baton Rouge,5/1/2020,12889,11507,1382,10.7,158101,137173,20929,13.2
West Baton Rouge,6/1/2020,13268,11904,1364,10.3,159994,142342,17652,11
West Baton Rouge,7/1/2020,13389,12094,1295,9.7,160132,143779,16352,10.2
West Baton Rouge,8/1/2020,13431,12373,1058,7.9,160706,147245,13461,8.4
West Baton Rouge,9/1/2020,13619,12542,1077,7.9,160174,147620,12554,7.8
West Baton Rouge,10/1/2020,13765,12820,945,6.9,161003,149931,11072,6.9
West Baton Rouge,11/1/2020,13633,12792,841,6.2,160629,149934,10694,6.7
West Baton Rouge,12/1/2020,13525,12688,837,6.2,160745,149975,10770,6.7
West Baton Rouge,1/1/2021,13389,12544,845,6.3,160088,149852,10236,6.4
West Baton Rouge,2/1/2021,13521,12710,811,6,160184,150189,9995,6.2
West Baton Rouge,3/1/2021,13624,12845,779,5.7,160400,150644,9756,6.1
West Baton Rouge,4/1/2021,13672,12906,766,5.6,160843,151081,9762,6.1
West Baton Rouge,5/1/2021,13614,12866,748,5.5,160800,151535,9266,5.8
West Baton Rouge,6/1/2021,13592,12726,866,6.4,161197,151734,9462,5.9
West Baton Rouge,7/1/2021,13588,12840,748,5.5,161504,152773,8731,5.4
West Baton Rouge,8/1/2021,13521,12883,638,4.7,161527,153250,8276,5.1
West Baton Rouge,9/1/2021,13817,13244,573,4.1,161495,153843,7652,4.7
West Baton Rouge,10/1/2021,13795,13287,508,3.7,161754,154475,7279,4.5
West Baton Rouge,11/1/2021,13860,13402,458,3.3,162281,155530,6751,4.2
West Baton Rouge,12/1/2021,13724,13318,406,3,162497,156099,6398,3.9
West Baton Rouge,1/1/2022,13773,13271,502,3.6,163627,157115,6512,4
West Baton Rouge,2/1/2022,13955,13496,459,3.3,163899,157598,6301,3.8
West Baton Rouge,3/1/2022,14032,13601,431,3.1,164220,158206,6014,3.7
West Baton Rouge,4/1/2022,13918,13530,388,2.8,163893,157891,6002,3.7
West Baton Rouge,5/1/2022,13877,13446,431,3.1,164362,158378,5983,3.6
West Baton Rouge,6/1/2022,13914,13353,561,4,164046,158094,5951,3.6
West Baton Rouge,7/1/2022,13945,13417,528,3.8,164026,158258,5768,3.5
West Baton Rouge,8/1/2022,13940,13440,500,3.6,164654,158735,5919,3.6
West Baton Rouge,9/1/2022,13910,13468,442,3.2,164602,158810,5792,3.5
West Baton Rouge,10/1/2022,13926,13510,416,3,164648,158684,5964,3.6
West Baton Rouge,11/1/2022,13925,13524,401,2.9,164450,158507,5943,3.6
West Baton Rouge,12/1/2022,13834,13436,398,2.9,165025,159259,5766,3.5
West Baton Rouge,1/1/2023,13770,13298,472,3.4,165964,160217,5747,3.5
West Baton Rouge,2/1/2023,13909,13488,421,3,166358,160395,5962,3.6
West Baton Rouge,3/1/2023,14087,13647,440,3.1,166651,160812,5839,3.5
West Baton Rouge,4/1/2023,13992,13595,397,2.8,166725,160974,5751,3.4
West Baton Rouge,5/1/2023,13929,13459,470,3.4,166886,160796,6089,3.6
West Baton Rouge,6/1/2023,13914,13370,544,3.9,166937,160979,5958,3.6
West Baton Rouge,7/1/2023,13915,13443,472,3.4,167103,161183,5920,3.5
West Baton Rouge,8/1/2023,13982,13466,516,3.7,167759,161475,6284,3.7
West Baton Rouge,9/1/2023,14038,13571,467,3.3,167767,161442,6326,3.8
West Baton Rouge,10/1/2023,14105,13645,460,3.3,167690,161211,6479,3.9
West Baton Rouge,11/1/2023,14162,13718,444,3.1,168140,161886,6254,3.7
West Baton Rouge,12/1/2023,13996,13532,464,3.3,167439,161124,6315,3.8
West Baton Rouge,1/1/2024,13937,13429,508,3.6,167339,161190,6149,3.7
West Baton Rouge,2/1/2024,14067,13573,494,3.5,167475,161013,6462,3.9
West Baton Rouge,3/1/2024,14259,13772,487,3.4,167922,161425,6497,3.9
West Baton Rouge,4/1/2024,14170,13748,422,3,167988,161495,6492,3.9
West Baton Rouge,5/1/2024,14067,13627,440,3.1,167799,161164,6635,4
West Baton Rouge,6/1/2024,14108,13502,606,4.3,168005,161155,6849,4.1
West Baton Rouge,7/1/2024,14197,13548,649,4.6,168315,161219,7097,4.2
West Baton Rouge,8/1/2024,14133,13521,612,4.3,168496,161425,7071,4.2
West Baton Rouge,9/1/2024,14073,13497,576,4.1,168703,161802,6901,4.1
West Baton Rouge,10/1/2024,14176,13582,594,4.2,168428,161456,6972,4.1
West Baton Rouge,11/1/2024,14158,13598,560,4,168304,161183,7121,4.2
West Baton Rouge,12/1/2024,14017,13521,496,3.5,168547,161661,6886,4.1
West Baton Rouge,1/1/2025,13816,13262,554,4,170744,163895,6849,4
West Baton Rouge,2/1/2025,13920,13381,539,3.9,170359,163307,7052,4.1
West Carroll,1/1/1990,4870,4178,692,14.2,125833,119081,6752,5.4
West Carroll,2/1/1990,4705,4071,634,13.5,125710,119059,6651,5.3
West Carroll,3/1/1990,4761,4182,579,12.2,125801,119203,6598,5.2
West Carroll,4/1/1990,5078,4345,733,14.4,125649,118852,6797,5.4
West Carroll,5/1/1990,5192,4538,654,12.6,125893,119151,6742,5.4
West Carroll,6/1/1990,5228,4492,736,14.1,125573,118983,6590,5.2
West Carroll,7/1/1990,5124,4457,667,13,125732,118810,6922,5.5
West Carroll,8/1/1990,5064,4595,469,9.3,125990,118802,7188,5.7
West Carroll,9/1/1990,5143,4727,416,8.1,125892,118524,7368,5.9
West Carroll,10/1/1990,4968,4579,389,7.8,125995,118536,7459,5.9
West Carroll,11/1/1990,4981,4433,548,11,126070,118306,7764,6.2
West Carroll,12/1/1990,4821,4141,680,14.1,126142,118241,7901,6.3
West Carroll,1/1/1991,5108,3929,1179,23.1,125955,117940,8015,6.4
West Carroll,2/1/1991,5166,4017,1149,22.2,126020,117755,8265,6.6
West Carroll,3/1/1991,5339,4130,1209,22.6,126238,117652,8586,6.8
West Carroll,4/1/1991,5484,4313,1171,21.4,126548,118109,8439,6.7
West Carroll,5/1/1991,5570,4396,1174,21.1,126176,117440,8736,6.9
West Carroll,6/1/1991,5677,4472,1205,21.2,126331,117639,8692,6.9
West Carroll,7/1/1991,5501,4559,942,17.1,126154,117568,8586,6.8
West Carroll,8/1/1991,5224,4655,569,10.9,126150,117484,8666,6.9
West Carroll,9/1/1991,5197,4683,514,9.9,126650,117928,8722,6.9
West Carroll,10/1/1991,5265,4799,466,8.9,126642,117800,8842,7
West Carroll,11/1/1991,5221,4643,578,11.1,126701,117770,8931,7
West Carroll,12/1/1991,5167,4437,730,14.1,126664,117466,9198,7.3
West Carroll,1/1/1992,5370,4161,1209,22.5,127261,117978,9283,7.3
West Carroll,2/1/1992,5421,4289,1132,20.9,127207,117753,9454,7.4
West Carroll,3/1/1992,5549,4377,1172,21.1,127604,118144,9460,7.4
West Carroll,4/1/1992,5422,4520,902,16.6,127841,118426,9415,7.4
West Carroll,5/1/1992,5333,4490,843,15.8,128119,118375,9744,7.6
West Carroll,6/1/1992,5496,4514,982,17.9,128459,118419,10040,7.8
West Carroll,7/1/1992,5549,4754,795,14.3,128563,118713,9850,7.7
West Carroll,8/1/1992,5399,4760,639,11.8,128613,118826,9787,7.6
West Carroll,9/1/1992,5526,4939,587,10.6,128501,118720,9781,7.6
West Carroll,10/1/1992,5620,5095,525,9.3,128026,118628,9398,7.3
West Carroll,11/1/1992,5573,4962,611,11,128441,118876,9565,7.4
West Carroll,12/1/1992,5408,4550,858,15.9,128554,118997,9557,7.4
West Carroll,1/1/1993,5415,4450,965,17.8,128400,119075,9325,7.3
West Carroll,2/1/1993,5337,4469,868,16.3,128458,119275,9183,7.1
West Carroll,3/1/1993,5501,4650,851,15.5,128598,119542,9056,7
West Carroll,4/1/1993,5289,4492,797,15.1,128584,119474,9110,7.1
West Carroll,5/1/1993,5339,4599,740,13.9,129264,120115,9149,7.1
West Carroll,6/1/1993,5496,4689,807,14.7,129411,120290,9121,7
West Carroll,7/1/1993,5412,4695,717,13.2,129397,120467,8930,6.9
West Carroll,8/1/1993,5338,4648,690,12.9,129619,120856,8763,6.8
West Carroll,9/1/1993,5376,4812,564,10.5,129268,120554,8714,6.7
West Carroll,10/1/1993,5423,4873,550,10.1,129573,120823,8750,6.8
West Carroll,11/1/1993,5259,4662,597,11.4,129711,121169,8542,6.6
West Carroll,12/1/1993,5313,4587,726,13.7,129941,121464,8477,6.5
West Carroll,1/1/1994,5346,4029,1317,24.6,130596,121966,8630,6.6
West Carroll,2/1/1994,5382,4083,1299,24.1,130669,122086,8583,6.6
West Carroll,3/1/1994,5558,4336,1222,22,130400,121930,8470,6.5
West Carroll,4/1/1994,5454,4353,1101,20.2,130621,122290,8331,6.4
West Carroll,5/1/1994,5289,4277,1012,19.1,130779,122864,7915,6.1
West Carroll,6/1/1994,5176,4193,983,19,130561,122634,7927,6.1
West Carroll,7/1/1994,5024,4101,923,18.4,130652,122706,7946,6.1
West Carroll,8/1/1994,5012,4179,833,16.6,131275,123342,7933,6
West Carroll,9/1/1994,4976,4263,713,14.3,131421,123687,7734,5.9
West Carroll,10/1/1994,5136,4417,719,14,131744,124112,7632,5.8
West Carroll,11/1/1994,5098,4353,745,14.6,131891,124516,7375,5.6
West Carroll,12/1/1994,5169,4166,1003,19.4,131951,124721,7230,5.5
West Carroll,1/1/1995,5289,3978,1311,24.8,132038,124663,7375,5.6
West Carroll,2/1/1995,5047,3945,1102,21.8,132115,124928,7187,5.4
West Carroll,3/1/1995,5075,4017,1058,20.8,132108,124955,7153,5.4
West Carroll,4/1/1995,5231,4290,941,18,132590,124945,7645,5.8
West Carroll,5/1/1995,5224,4331,893,17.1,131851,124421,7430,5.6
West Carroll,6/1/1995,5500,4578,922,16.8,131949,124522,7427,5.6
West Carroll,7/1/1995,5300,4529,771,14.5,132343,124816,7527,5.7
West Carroll,8/1/1995,5275,4558,717,13.6,132336,124852,7484,5.7
West Carroll,9/1/1995,5375,4777,598,11.1,132611,125133,7478,5.6
West Carroll,10/1/1995,5452,4940,512,9.4,132716,125388,7328,5.5
West Carroll,11/1/1995,5188,4606,582,11.2,132614,125188,7426,5.6
West Carroll,12/1/1995,5045,4389,656,13,132511,125088,7423,5.6
West Carroll,1/1/1996,5130,4151,979,19.1,132616,125125,7491,5.6
West Carroll,2/1/1996,5008,4139,869,17.4,132952,125639,7313,5.5
West Carroll,3/1/1996,5047,4283,764,15.1,133180,125862,7318,5.5
West Carroll,4/1/1996,5282,4486,796,15.1,133409,125994,7415,5.6
West Carroll,5/1/1996,5011,4316,695,13.9,133667,126244,7423,5.6
West Carroll,6/1/1996,5168,4435,733,14.2,133697,126602,7095,5.3
West Carroll,7/1/1996,5212,4537,675,13,134284,126947,7337,5.5
West Carroll,8/1/1996,4977,4392,585,11.8,134054,127172,6882,5.1
West Carroll,9/1/1996,5213,4725,488,9.4,134515,127536,6979,5.2
West Carroll,10/1/1996,5320,4810,510,9.6,134921,127890,7031,5.2
West Carroll,11/1/1996,5116,4573,543,10.6,135007,127771,7236,5.4
West Carroll,12/1/1996,4874,4154,720,14.8,135113,127860,7253,5.4
West Carroll,1/1/1997,5064,4080,984,19.4,135456,128298,7158,5.3
West Carroll,2/1/1997,5206,4268,938,18,135400,128298,7102,5.2
West Carroll,3/1/1997,5291,4317,974,18.4,135891,128891,7000,5.2
West Carroll,4/1/1997,5230,4468,762,14.6,136016,129143,6873,5.1
West Carroll,5/1/1997,5220,4520,700,13.4,136119,129464,6655,4.9
West Carroll,6/1/1997,5436,4682,754,13.9,136211,129412,6799,5
West Carroll,7/1/1997,5292,4600,692,13.1,136477,129822,6655,4.9
West Carroll,8/1/1997,5061,4478,583,11.5,136618,130010,6608,4.8
West Carroll,9/1/1997,5176,4641,535,10.3,136675,130019,6656,4.9
West Carroll,10/1/1997,5342,4886,456,8.5,136633,130179,6454,4.7
West Carroll,11/1/1997,5312,4732,580,10.9,136961,130653,6308,4.6
West Carroll,12/1/1997,5147,4389,758,14.7,137155,130679,6476,4.7
West Carroll,1/1/1998,5338,4308,1030,19.3,137095,130726,6368,4.6
West Carroll,2/1/1998,5114,4348,766,15,137112,130807,6306,4.6
West Carroll,3/1/1998,5210,4406,804,15.4,137236,130814,6422,4.7
West Carroll,4/1/1998,5114,4436,678,13.3,137150,131209,5941,4.3
West Carroll,5/1/1998,5183,4511,672,13,137372,131325,6047,4.4
West Carroll,6/1/1998,5338,4681,657,12.3,137455,131244,6212,4.5
West Carroll,7/1/1998,5293,4704,589,11.1,137588,131329,6259,4.5
West Carroll,8/1/1998,5150,4588,562,10.9,137570,131390,6179,4.5
West Carroll,9/1/1998,5192,4670,522,10.1,138286,131986,6300,4.6
West Carroll,10/1/1998,5200,4759,441,8.5,138279,131999,6280,4.5
West Carroll,11/1/1998,5252,4752,500,9.5,138381,132280,6100,4.4
West Carroll,12/1/1998,5196,4464,732,14.1,138634,132602,6032,4.4
West Carroll,1/1/1999,5319,4353,966,18.2,139003,133027,5976,4.3
West Carroll,2/1/1999,5002,4194,808,16.2,138967,132856,6111,4.4
West Carroll,3/1/1999,5085,4315,770,15.1,138730,132947,5783,4.2
West Carroll,4/1/1999,5189,4469,720,13.9,138959,132955,6004,4.3
West Carroll,5/1/1999,5197,4551,646,12.4,139107,133311,5796,4.2
West Carroll,6/1/1999,5436,4702,734,13.5,139329,133378,5951,4.3
West Carroll,7/1/1999,5471,4897,574,10.5,139439,133414,6025,4.3
West Carroll,8/1/1999,5506,4939,567,10.3,139430,133591,5838,4.2
West Carroll,9/1/1999,5440,4865,575,10.6,139622,133707,5915,4.2
West Carroll,10/1/1999,5218,4646,572,11,139771,133993,5778,4.1
West Carroll,11/1/1999,5243,4590,653,12.5,140025,134309,5716,4.1
West Carroll,12/1/1999,5112,4382,730,14.3,140177,134523,5653,4
West Carroll,1/1/2000,4773,4195,578,12.1,142267,136559,5708,4
West Carroll,2/1/2000,4613,4110,503,10.9,142456,136598,5858,4.1
West Carroll,3/1/2000,4660,4196,464,10,142434,136701,5733,4
West Carroll,4/1/2000,4751,4361,390,8.2,142751,137270,5481,3.8
West Carroll,5/1/2000,4753,4341,412,8.7,142388,136630,5758,4
West Carroll,6/1/2000,4815,4382,433,9,142591,136940,5651,4
West Carroll,7/1/2000,4888,4493,395,8.1,142278,136531,5747,4
West Carroll,8/1/2000,4845,4434,411,8.5,142514,136662,5853,4.1
West Carroll,9/1/2000,4889,4504,385,7.9,142518,136893,5625,3.9
West Carroll,10/1/2000,5004,4601,403,8.1,142622,137088,5534,3.9
West Carroll,11/1/2000,4985,4497,488,9.8,142962,137322,5639,3.9
West Carroll,12/1/2000,4949,4414,535,10.8,143248,137614,5634,3.9
West Carroll,1/1/2001,4840,4169,671,13.9,143800,137778,6023,4.2
West Carroll,2/1/2001,4809,4244,565,11.7,143701,137612,6089,4.2
West Carroll,3/1/2001,4965,4329,636,12.8,143924,137783,6141,4.3
West Carroll,4/1/2001,4844,4341,503,10.4,143569,137299,6271,4.4
West Carroll,5/1/2001,4853,4357,496,10.2,143318,137092,6226,4.3
West Carroll,6/1/2001,4926,4410,516,10.5,143357,136873,6484,4.5
West Carroll,7/1/2001,4887,4400,487,10,143654,137071,6583,4.6
West Carroll,8/1/2001,4878,4382,496,10.2,143284,136241,7042,4.9
West Carroll,9/1/2001,4949,4479,470,9.5,143989,136846,7142,5
West Carroll,10/1/2001,4884,4417,467,9.6,144086,136392,7694,5.3
West Carroll,11/1/2001,4816,4338,478,9.9,144240,136238,8003,5.5
West Carroll,12/1/2001,4782,4265,517,10.8,144305,136047,8258,5.7
West Carroll,1/1/2002,4846,4205,641,13.2,143883,135701,8182,5.7
West Carroll,2/1/2002,4724,4175,549,11.6,144653,136438,8215,5.7
West Carroll,3/1/2002,4741,4181,560,11.8,144481,136177,8304,5.7
West Carroll,4/1/2002,4696,4176,520,11.1,144725,136126,8599,5.9
West Carroll,5/1/2002,4828,4291,537,11.1,144938,136539,8399,5.8
West Carroll,6/1/2002,4800,4223,577,12,144808,136415,8393,5.8
West Carroll,7/1/2002,4798,4278,520,10.8,144803,136413,8390,5.8
West Carroll,8/1/2002,4836,4320,516,10.7,145009,136705,8304,5.7
West Carroll,9/1/2002,4734,4278,456,9.6,145552,137302,8251,5.7
West Carroll,10/1/2002,4938,4483,455,9.2,145314,137008,8307,5.7
West Carroll,11/1/2002,4830,4370,460,9.5,145041,136521,8520,5.9
West Carroll,12/1/2002,4819,4310,509,10.6,145066,136426,8640,6
West Carroll,1/1/2003,4779,4099,680,14.2,145937,137417,8520,5.8
West Carroll,2/1/2003,4575,3953,622,13.6,146100,137482,8618,5.9
West Carroll,3/1/2003,4699,4020,679,14.4,146022,137434,8588,5.9
West Carroll,4/1/2003,4765,4158,607,12.7,146474,137633,8842,6
West Carroll,5/1/2003,4756,4149,607,12.8,146500,137544,8957,6.1
West Carroll,6/1/2003,4902,4160,742,15.1,147056,137790,9266,6.3
West Carroll,7/1/2003,4748,4066,682,14.4,146485,137474,9011,6.2
West Carroll,8/1/2003,4843,4182,661,13.6,146445,137549,8896,6.1
West Carroll,9/1/2003,4685,4117,568,12.1,146530,137609,8921,6.1
West Carroll,10/1/2003,4892,4363,529,10.8,146716,137984,8732,6
West Carroll,11/1/2003,4862,4275,587,12.1,147000,138424,8576,5.8
West Carroll,12/1/2003,4651,4073,578,12.4,146729,138411,8317,5.7
West Carroll,1/1/2004,4724,3966,758,16,146842,138472,8370,5.7
West Carroll,2/1/2004,4565,3919,646,14.2,146709,138542,8167,5.6
West Carroll,3/1/2004,4601,3920,681,14.8,146944,138453,8491,5.8
West Carroll,4/1/2004,4615,3991,624,13.5,146850,138680,8170,5.6
West Carroll,5/1/2004,4543,3984,559,12.3,147065,138852,8212,5.6
West Carroll,6/1/2004,4613,4007,606,13.1,147460,139174,8286,5.6
West Carroll,7/1/2004,4570,4021,549,12,147692,139556,8136,5.5
West Carroll,8/1/2004,4524,4024,500,11.1,147564,139573,7990,5.4
West Carroll,9/1/2004,4432,3934,498,11.2,147415,139487,7927,5.4
West Carroll,10/1/2004,4611,4138,473,10.3,147793,139732,8061,5.5
West Carroll,11/1/2004,4507,4045,462,10.3,148162,140231,7932,5.4
West Carroll,12/1/2004,4409,3881,528,12,148059,140125,7934,5.4
West Carroll,1/1/2005,4550,3895,655,14.4,148029,140245,7784,5.3
West Carroll,2/1/2005,4412,3812,600,13.6,148364,140385,7980,5.4
West Carroll,3/1/2005,4354,3807,547,12.6,148391,140654,7737,5.2
West Carroll,4/1/2005,4563,4075,488,10.7,148926,141254,7672,5.2
West Carroll,5/1/2005,4597,4138,459,10,149261,141609,7651,5.1
West Carroll,6/1/2005,4694,4163,531,11.3,149238,141714,7524,5
West Carroll,7/1/2005,4505,4002,503,11.2,149432,142026,7406,5
West Carroll,8/1/2005,4457,4005,452,10.1,149779,142434,7345,4.9
West Carroll,9/1/2005,5038,4503,535,10.6,149954,142401,7553,5
West Carroll,10/1/2005,5132,4670,462,9,150001,142548,7453,5
West Carroll,11/1/2005,5379,4898,481,8.9,150065,142499,7566,5
West Carroll,12/1/2005,5407,5005,402,7.4,150030,142752,7279,4.9
West Carroll,1/1/2006,5529,5132,397,7.2,150214,143150,7064,4.7
West Carroll,2/1/2006,5549,5222,327,5.9,150641,143457,7184,4.8
West Carroll,3/1/2006,5482,5169,313,5.7,150813,143741,7072,4.7
West Carroll,4/1/2006,5353,5054,299,5.6,150881,143761,7120,4.7
West Carroll,5/1/2006,5136,4837,299,5.8,151069,144089,6980,4.6
West Carroll,6/1/2006,5023,4662,361,7.2,151354,144353,7001,4.6
West Carroll,7/1/2006,4962,4641,321,6.5,151377,144202,7175,4.7
West Carroll,8/1/2006,4976,4669,307,6.2,151716,144625,7091,4.7
West Carroll,9/1/2006,5107,4809,298,5.8,151662,144815,6847,4.5
West Carroll,10/1/2006,4970,4697,273,5.5,152041,145314,6727,4.4
West Carroll,11/1/2006,4663,4351,312,6.7,152406,145534,6872,4.5
West Carroll,12/1/2006,4523,4177,346,7.6,152732,145970,6762,4.4
West Carroll,1/1/2007,4465,3994,471,10.5,153144,146028,7116,4.6
West Carroll,2/1/2007,4511,4065,446,9.9,152983,146057,6927,4.5
West Carroll,3/1/2007,4480,4082,398,8.9,153051,146320,6731,4.4
West Carroll,4/1/2007,4502,4049,453,10.1,152435,145586,6850,4.5
West Carroll,5/1/2007,4368,3955,413,9.5,152670,145903,6766,4.4
West Carroll,6/1/2007,4357,3896,461,10.6,153041,146063,6979,4.6
West Carroll,7/1/2007,4394,3923,471,10.7,153054,145905,7149,4.7
West Carroll,8/1/2007,4435,4040,395,8.9,152749,145682,7067,4.6
West Carroll,9/1/2007,4638,4278,360,7.8,153414,146244,7170,4.7
West Carroll,10/1/2007,4633,4308,325,7,153183,145946,7237,4.7
West Carroll,11/1/2007,4553,4236,317,7,153835,146595,7240,4.7
West Carroll,12/1/2007,4549,4134,415,9.1,153918,146273,7645,5
West Carroll,1/1/2008,4543,4043,500,11,154063,146378,7685,5
West Carroll,2/1/2008,4475,4030,445,9.9,153653,146156,7497,4.9
West Carroll,3/1/2008,4622,4192,430,9.3,153908,146086,7822,5.1
West Carroll,4/1/2008,4495,4116,379,8.4,153769,146132,7637,5
West Carroll,5/1/2008,4443,4051,392,8.8,154303,145908,8395,5.4
West Carroll,6/1/2008,4462,3988,474,10.6,154313,145737,8575,5.6
West Carroll,7/1/2008,4419,3953,466,10.5,154469,145532,8937,5.8
West Carroll,8/1/2008,4375,3944,431,9.9,154641,145203,9438,6.1
West Carroll,9/1/2008,4275,3883,392,9.2,154570,145076,9494,6.1
West Carroll,10/1/2008,4394,3988,406,9.2,154876,144802,10074,6.5
West Carroll,11/1/2008,4479,4027,452,10.1,154639,144100,10538,6.8
West Carroll,12/1/2008,4307,3774,533,12.4,154655,143369,11286,7.3
West Carroll,1/1/2009,4515,3742,773,17.1,154210,142152,12058,7.8
West Carroll,2/1/2009,4458,3717,741,16.6,154538,141640,12898,8.3
West Carroll,3/1/2009,4452,3736,716,16.1,154133,140707,13426,8.7
West Carroll,4/1/2009,4624,3878,746,16.1,154509,140656,13853,9
West Carroll,5/1/2009,4645,3937,708,15.2,154747,140248,14499,9.4
West Carroll,6/1/2009,4687,3951,736,15.7,154716,140009,14707,9.5
West Carroll,7/1/2009,4721,3926,795,16.8,154502,139901,14601,9.5
West Carroll,8/1/2009,4537,3835,702,15.5,154307,139492,14814,9.6
West Carroll,9/1/2009,4414,3745,669,15.2,153827,138818,15009,9.8
West Carroll,10/1/2009,4362,3690,672,15.4,153784,138432,15352,10
West Carroll,11/1/2009,4388,3706,682,15.5,153878,138659,15219,9.9
West Carroll,12/1/2009,4408,3673,735,16.7,153111,138013,15098,9.9
West Carroll,1/1/2010,4317,3484,833,19.3,153484,138438,15046,9.8
West Carroll,2/1/2010,4454,3632,822,18.5,153694,138581,15113,9.8
West Carroll,3/1/2010,4486,3703,783,17.5,153954,138751,15202,9.9
West Carroll,4/1/2010,4484,3816,668,14.9,154622,139297,15325,9.9
West Carroll,5/1/2010,4445,3784,661,14.9,154091,139241,14849,9.6
West Carroll,6/1/2010,4527,3814,713,15.7,153616,139141,14474,9.4
West Carroll,7/1/2010,4593,3942,651,14.2,153691,139179,14512,9.4
West Carroll,8/1/2010,4454,3870,584,13.1,154086,139438,14648,9.5
West Carroll,9/1/2010,4368,3793,575,13.2,153975,139396,14579,9.5
West Carroll,10/1/2010,4406,3842,564,12.8,153635,139119,14516,9.4
West Carroll,11/1/2010,4357,3746,611,14,154125,139044,15081,9.8
West Carroll,12/1/2010,4305,3635,670,15.6,153650,139301,14348,9.3
West Carroll,1/1/2011,4314,3529,785,18.2,153263,139250,14013,9.1
West Carroll,2/1/2011,4300,3536,764,17.8,153214,139394,13820,9
West Carroll,3/1/2011,4297,3583,714,16.6,153376,139639,13737,9
West Carroll,4/1/2011,4274,3650,624,14.6,153543,139586,13957,9.1
West Carroll,5/1/2011,4266,3673,593,13.9,153479,139624,13855,9
West Carroll,6/1/2011,4318,3640,678,15.7,153346,139384,13962,9.1
West Carroll,7/1/2011,4434,3772,662,14.9,153288,139524,13763,9
West Carroll,8/1/2011,4319,3701,618,14.3,153760,139942,13818,9
West Carroll,9/1/2011,4199,3627,572,13.6,154131,140183,13948,9
West Carroll,10/1/2011,4180,3637,543,13,153961,140368,13594,8.8
West Carroll,11/1/2011,4155,3617,538,12.9,154128,140826,13302,8.6
West Carroll,12/1/2011,4142,3564,578,14,153995,140902,13093,8.5
West Carroll,1/1/2012,4164,3470,694,16.7,154381,141584,12797,8.3
West Carroll,2/1/2012,4159,3518,641,15.4,154671,141858,12813,8.3
West Carroll,3/1/2012,4129,3545,584,14.1,154749,142036,12713,8.2
West Carroll,4/1/2012,4110,3589,521,12.7,154545,141899,12646,8.2
West Carroll,5/1/2012,4141,3622,519,12.5,154866,142206,12660,8.2
West Carroll,6/1/2012,4227,3650,577,13.7,155083,142391,12692,8.2
West Carroll,7/1/2012,4398,3816,582,13.2,154948,142292,12656,8.2
West Carroll,8/1/2012,4259,3740,519,12.2,154763,142291,12471,8.1
West Carroll,9/1/2012,4054,3601,453,11.2,155160,143044,12115,7.8
West Carroll,10/1/2012,4066,3631,435,10.7,155554,143431,12124,7.8
West Carroll,11/1/2012,4110,3671,439,10.7,155338,143333,12005,7.7
West Carroll,12/1/2012,4214,3697,517,12.3,155628,143330,12298,7.9
West Carroll,1/1/2013,4270,3642,628,14.7,155763,143292,12471,8
West Carroll,2/1/2013,4279,3690,589,13.8,155312,143362,11950,7.7
West Carroll,3/1/2013,4166,3599,567,13.6,155005,143316,11689,7.5
West Carroll,4/1/2013,4199,3661,538,12.8,155394,143635,11760,7.6
West Carroll,5/1/2013,4231,3706,525,12.4,155536,143882,11654,7.5
West Carroll,6/1/2013,4237,3672,565,13.3,155749,143999,11751,7.5
West Carroll,7/1/2013,4422,3908,514,11.6,155599,144264,11335,7.3
West Carroll,8/1/2013,4392,3917,475,10.8,155605,144326,11279,7.2
West Carroll,9/1/2013,4320,3840,480,11.1,155687,144418,11270,7.2
West Carroll,10/1/2013,4115,3694,421,10.2,154673,143537,11136,7.2
West Carroll,11/1/2013,4074,3636,438,10.8,155265,144479,10787,6.9
West Carroll,12/1/2013,4137,3672,465,11.2,155182,144778,10404,6.7
West Carroll,1/1/2014,4123,3617,506,12.3,155352,145150,10202,6.6
West Carroll,2/1/2014,4136,3641,495,12,155483,145134,10349,6.7
West Carroll,3/1/2014,4107,3626,481,11.7,156028,145648,10380,6.7
West Carroll,4/1/2014,4119,3665,454,11,155369,145667,9702,6.2
West Carroll,5/1/2014,4146,3628,518,12.5,155684,145825,9859,6.3
West Carroll,6/1/2014,4253,3694,559,13.1,155707,146247,9460,6.1
West Carroll,7/1/2014,4348,3776,572,13.2,156007,146399,9608,6.2
West Carroll,8/1/2014,4286,3762,524,12.2,156130,146530,9599,6.1
West Carroll,9/1/2014,4356,3798,558,12.8,156040,146778,9262,5.9
West Carroll,10/1/2014,4147,3608,539,13,156417,147427,8990,5.7
West Carroll,11/1/2014,4182,3605,577,13.8,156494,147404,9090,5.8
West Carroll,12/1/2014,4386,3693,693,15.8,156332,147615,8717,5.6
West Carroll,1/1/2015,4201,3492,709,16.9,157030,148145,8885,5.7
West Carroll,2/1/2015,4187,3518,669,16,156644,148045,8599,5.5
West Carroll,3/1/2015,4150,3520,630,15.2,156643,148128,8515,5.4
West Carroll,4/1/2015,4037,3468,569,14.1,157060,148511,8550,5.4
West Carroll,5/1/2015,4109,3526,583,14.2,157651,148817,8834,5.6
West Carroll,6/1/2015,4294,3704,590,13.7,157062,148816,8247,5.3
West Carroll,7/1/2015,4215,3692,523,12.4,156997,148830,8167,5.2
West Carroll,8/1/2015,4044,3600,444,11,157172,149181,7992,5.1
West Carroll,9/1/2015,3984,3527,457,11.5,156733,148826,7907,5
West Carroll,10/1/2015,3929,3490,439,11.2,157167,149246,7922,5
West Carroll,11/1/2015,3971,3528,443,11.2,157463,149463,8000,5.1
West Carroll,12/1/2015,4063,3570,493,12.1,158035,150128,7907,5
West Carroll,1/1/2016,4154,3568,586,14.1,158280,150653,7627,4.8
West Carroll,2/1/2016,4075,3552,523,12.8,158640,150939,7702,4.9
West Carroll,3/1/2016,4076,3580,496,12.2,159179,151218,7961,5
West Carroll,4/1/2016,4127,3630,497,12,159141,151074,8067,5.1
West Carroll,5/1/2016,4173,3707,466,11.2,158784,151132,7652,4.8
West Carroll,6/1/2016,4343,3851,492,11.3,158967,151223,7744,4.9
West Carroll,7/1/2016,4156,3676,480,11.5,159194,151554,7641,4.8
West Carroll,8/1/2016,4177,3714,463,11.1,159562,151779,7784,4.9
West Carroll,9/1/2016,4048,3561,487,12,159714,151761,7953,5
West Carroll,10/1/2016,3918,3477,441,11.3,159605,151793,7811,4.9
West Carroll,11/1/2016,3972,3550,422,10.6,159506,151954,7553,4.7
West Carroll,12/1/2016,4000,3493,507,12.7,159678,152157,7521,4.7
West Carroll,1/1/2017,4090,3492,598,14.6,159620,152152,7468,4.7
West Carroll,2/1/2017,4065,3518,547,13.5,159859,152480,7379,4.6
West Carroll,3/1/2017,4048,3582,466,11.5,160137,153065,7073,4.4
West Carroll,4/1/2017,4030,3622,408,10.1,160345,153255,7089,4.4
West Carroll,5/1/2017,4033,3683,350,8.7,160068,153069,7000,4.4
West Carroll,6/1/2017,4184,3835,349,8.3,160192,153318,6873,4.3
West Carroll,7/1/2017,4054,3708,346,8.5,160462,153569,6892,4.3
West Carroll,8/1/2017,3964,3614,350,8.8,160586,153503,7082,4.4
West Carroll,9/1/2017,3912,3589,323,8.3,161140,154286,6854,4.3
West Carroll,10/1/2017,3842,3547,295,7.7,160309,153609,6700,4.2
West Carroll,11/1/2017,3815,3514,301,7.9,160579,153805,6774,4.2
West Carroll,12/1/2017,3887,3530,357,9.2,160535,153904,6632,4.1
West Carroll,1/1/2018,3991,3551,440,11,160914,154425,6489,4
West Carroll,2/1/2018,3982,3547,435,10.9,161778,155197,6581,4.1
West Carroll,3/1/2018,4062,3666,396,9.7,161686,155214,6472,4
West Carroll,4/1/2018,4021,3679,342,8.5,161771,155312,6459,4
West Carroll,5/1/2018,4063,3750,313,7.7,161848,155652,6196,3.8
West Carroll,6/1/2018,4176,3798,378,9.1,162210,155762,6447,4
West Carroll,7/1/2018,4071,3724,347,8.5,162341,156146,6195,3.8
West Carroll,8/1/2018,3925,3603,322,8.2,161660,155504,6156,3.8
West Carroll,9/1/2018,3879,3584,295,7.6,162087,156015,6073,3.7
West Carroll,10/1/2018,3925,3632,293,7.5,162602,156391,6211,3.8
West Carroll,11/1/2018,3908,3598,310,7.9,162836,156721,6115,3.8
West Carroll,12/1/2018,3969,3576,393,9.9,163206,156817,6389,3.9
West Carroll,1/1/2019,3613,3161,452,12.5,162963,156487,6475,4
West Carroll,2/1/2019,3656,3213,443,12.1,162999,156863,6136,3.8
West Carroll,3/1/2019,3651,3233,418,11.4,162904,156701,6202,3.8
West Carroll,4/1/2019,3560,3194,366,10.3,162586,156625,5961,3.7
West Carroll,5/1/2019,3612,3291,321,8.9,162751,156821,5930,3.6
West Carroll,6/1/2019,3675,3322,353,9.6,163168,157232,5935,3.6
West Carroll,7/1/2019,3578,3236,342,9.6,163590,157529,6061,3.7
West Carroll,8/1/2019,3617,3282,335,9.3,163774,157829,5945,3.6
West Carroll,9/1/2019,3667,3356,311,8.5,164092,158339,5753,3.5
West Carroll,10/1/2019,3606,3281,325,9,164416,158545,5871,3.6
West Carroll,11/1/2019,3616,3249,367,10.1,164496,158629,5868,3.6
West Carroll,12/1/2019,3663,3235,428,11.7,164699,158845,5853,3.6
West Carroll,1/1/2020,3650,3182,468,12.8,164377,158508,5869,3.6
West Carroll,2/1/2020,3647,3262,385,10.6,164467,158714,5753,3.5
West Carroll,3/1/2020,3910,3269,641,16.4,162559,155353,7206,4.4
West Carroll,4/1/2020,3431,3032,399,11.6,156269,133185,23084,14.8
West Carroll,5/1/2020,3493,3101,392,11.2,158101,137173,20929,13.2
West Carroll,6/1/2020,3612,3168,444,12.3,159994,142342,17652,11
West Carroll,7/1/2020,3578,3190,388,10.8,160132,143779,16352,10.2
West Carroll,8/1/2020,3661,3335,326,8.9,160706,147245,13461,8.4
West Carroll,9/1/2020,3675,3340,335,9.1,160174,147620,12554,7.8
West Carroll,10/1/2020,3659,3377,282,7.7,161003,149931,11072,6.9
West Carroll,11/1/2020,3603,3344,259,7.2,160629,149934,10694,6.7
West Carroll,12/1/2020,3619,3320,299,8.3,160745,149975,10770,6.7
West Carroll,1/1/2021,3619,3292,327,9,160088,149852,10236,6.4
West Carroll,2/1/2021,3479,3179,300,8.6,160184,150189,9995,6.2
West Carroll,3/1/2021,3527,3242,285,8.1,160400,150644,9756,6.1
West Carroll,4/1/2021,3571,3326,245,6.9,160843,151081,9762,6.1
West Carroll,5/1/2021,3462,3230,232,6.7,160800,151535,9266,5.8
West Carroll,6/1/2021,3590,3336,254,7.1,161197,151734,9462,5.9
West Carroll,7/1/2021,3381,3160,221,6.5,161504,152773,8731,5.4
West Carroll,8/1/2021,3362,3161,201,6,161527,153250,8276,5.1
West Carroll,9/1/2021,3536,3355,181,5.1,161495,153843,7652,4.7
West Carroll,10/1/2021,3466,3296,170,4.9,161754,154475,7279,4.5
West Carroll,11/1/2021,3446,3275,171,5,162281,155530,6751,4.2
West Carroll,12/1/2021,3493,3320,173,5,162497,156099,6398,3.9
West Carroll,1/1/2022,3508,3261,247,7,163627,157115,6512,4
West Carroll,2/1/2022,3530,3309,221,6.3,163899,157598,6301,3.8
West Carroll,3/1/2022,3530,3344,186,5.3,164220,158206,6014,3.7
West Carroll,4/1/2022,3575,3408,167,4.7,163893,157891,6002,3.7
West Carroll,5/1/2022,3547,3371,176,5,164362,158378,5983,3.6
West Carroll,6/1/2022,3659,3436,223,6.1,164046,158094,5951,3.6
West Carroll,7/1/2022,3515,3311,204,5.8,164026,158258,5768,3.5
West Carroll,8/1/2022,3407,3215,192,5.6,164654,158735,5919,3.6
West Carroll,9/1/2022,3408,3226,182,5.3,164602,158810,5792,3.5
West Carroll,10/1/2022,3380,3224,156,4.6,164648,158684,5964,3.6
West Carroll,11/1/2022,3342,3176,166,5,164450,158507,5943,3.6
West Carroll,12/1/2022,3354,3171,183,5.5,165025,159259,5766,3.5
West Carroll,1/1/2023,3427,3166,261,7.6,165964,160217,5747,3.5
West Carroll,2/1/2023,3404,3148,256,7.5,166358,160395,5962,3.6
West Carroll,3/1/2023,3418,3166,252,7.4,166651,160812,5839,3.5
West Carroll,4/1/2023,3477,3278,199,5.7,166725,160974,5751,3.4
West Carroll,5/1/2023,3463,3265,198,5.7,166886,160796,6089,3.6
West Carroll,6/1/2023,3589,3373,216,6,166937,160979,5958,3.6
West Carroll,7/1/2023,3509,3325,184,5.2,167103,161183,5920,3.5
West Carroll,8/1/2023,3433,3246,187,5.4,167759,161475,6284,3.7
West Carroll,9/1/2023,3422,3225,197,5.8,167767,161442,6326,3.8
West Carroll,10/1/2023,3415,3210,205,6,167690,161211,6479,3.9
West Carroll,11/1/2023,3430,3222,208,6.1,168140,161886,6254,3.7
West Carroll,12/1/2023,3457,3220,237,6.9,167439,161124,6315,3.8
West Carroll,1/1/2024,3511,3191,320,9.1,167339,161190,6149,3.7
West Carroll,2/1/2024,3413,3105,308,9,167475,161013,6462,3.9
West Carroll,3/1/2024,3417,3100,317,9.3,167922,161425,6497,3.9
West Carroll,4/1/2024,3448,3172,276,8,167988,161495,6492,3.9
West Carroll,5/1/2024,3381,3134,247,7.3,167799,161164,6635,4
West Carroll,6/1/2024,3613,3333,280,7.7,168005,161155,6849,4.1
West Carroll,7/1/2024,3582,3295,287,8,168315,161219,7097,4.2
West Carroll,8/1/2024,3521,3247,274,7.8,168496,161425,7071,4.2
West Carroll,9/1/2024,3567,3299,268,7.5,168703,161802,6901,4.1
West Carroll,10/1/2024,3527,3268,259,7.3,168428,161456,6972,4.1
West Carroll,11/1/2024,3470,3206,264,7.6,168304,161183,7121,4.2
West Carroll,12/1/2024,3474,3209,265,7.6,168547,161661,6886,4.1
West Carroll,1/1/2025,3545,3250,295,8.3,170744,163895,6849,4
West Carroll,2/1/2025,3417,3159,258,7.6,170359,163307,7052,4.1
West Feliciana,1/1/1990,3709,3338,371,10,125833,119081,6752,5.4
West Feliciana,2/1/1990,3608,3292,316,8.8,125710,119059,6651,5.3
West Feliciana,3/1/1990,3580,3297,283,7.9,125801,119203,6598,5.2
West Feliciana,4/1/1990,3557,3318,239,6.7,125649,118852,6797,5.4
West Feliciana,5/1/1990,3501,3278,223,6.4,125893,119151,6742,5.4
West Feliciana,6/1/1990,3556,3315,241,6.8,125573,118983,6590,5.2
West Feliciana,7/1/1990,3713,3453,260,7,125732,118810,6922,5.5
West Feliciana,8/1/1990,3695,3442,253,6.8,125990,118802,7188,5.7
West Feliciana,9/1/1990,3856,3619,237,6.1,125892,118524,7368,5.9
West Feliciana,10/1/1990,4067,3849,218,5.4,125995,118536,7459,5.9
West Feliciana,11/1/1990,3999,3787,212,5.3,126070,118306,7764,6.2
West Feliciana,12/1/1990,3644,3424,220,6,126142,118241,7901,6.3
West Feliciana,1/1/1991,3889,3498,391,10.1,125955,117940,8015,6.4
West Feliciana,2/1/1991,3913,3537,376,9.6,126020,117755,8265,6.6
West Feliciana,3/1/1991,3889,3621,268,6.9,126238,117652,8586,6.8
West Feliciana,4/1/1991,3896,3659,237,6.1,126548,118109,8439,6.7
West Feliciana,5/1/1991,3845,3603,242,6.3,126176,117440,8736,6.9
West Feliciana,6/1/1991,3892,3605,287,7.4,126331,117639,8692,6.9
West Feliciana,7/1/1991,4062,3826,236,5.8,126154,117568,8586,6.8
West Feliciana,8/1/1991,4054,3774,280,6.9,126150,117484,8666,6.9
West Feliciana,9/1/1991,4038,3793,245,6.1,126650,117928,8722,6.9
West Feliciana,10/1/1991,4170,3958,212,5.1,126642,117800,8842,7
West Feliciana,11/1/1991,4143,3977,166,4,126701,117770,8931,7
West Feliciana,12/1/1991,4122,3921,201,4.9,126664,117466,9198,7.3
West Feliciana,1/1/1992,4225,3872,353,8.4,127261,117978,9283,7.3
West Feliciana,2/1/1992,4221,3949,272,6.4,127207,117753,9454,7.4
West Feliciana,3/1/1992,4377,4173,204,4.7,127604,118144,9460,7.4
West Feliciana,4/1/1992,4400,4215,185,4.2,127841,118426,9415,7.4
West Feliciana,5/1/1992,4254,4039,215,5.1,128119,118375,9744,7.6
West Feliciana,6/1/1992,4226,3995,231,5.5,128459,118419,10040,7.8
West Feliciana,7/1/1992,4431,4194,237,5.3,128563,118713,9850,7.7
West Feliciana,8/1/1992,4235,4010,225,5.3,128613,118826,9787,7.6
West Feliciana,9/1/1992,3977,3751,226,5.7,128501,118720,9781,7.6
West Feliciana,10/1/1992,3856,3650,206,5.3,128026,118628,9398,7.3
West Feliciana,11/1/1992,3817,3597,220,5.8,128441,118876,9565,7.4
West Feliciana,12/1/1992,3728,3502,226,6.1,128554,118997,9557,7.4
West Feliciana,1/1/1993,3787,3469,318,8.4,128400,119075,9325,7.3
West Feliciana,2/1/1993,3730,3450,280,7.5,128458,119275,9183,7.1
West Feliciana,3/1/1993,3684,3444,240,6.5,128598,119542,9056,7
West Feliciana,4/1/1993,3652,3407,245,6.7,128584,119474,9110,7.1
West Feliciana,5/1/1993,3625,3391,234,6.5,129264,120115,9149,7.1
West Feliciana,6/1/1993,3703,3423,280,7.6,129411,120290,9121,7
West Feliciana,7/1/1993,3705,3411,294,7.9,129397,120467,8930,6.9
West Feliciana,8/1/1993,3686,3385,301,8.2,129619,120856,8763,6.8
West Feliciana,9/1/1993,3610,3301,309,8.6,129268,120554,8714,6.7
West Feliciana,10/1/1993,3573,3329,244,6.8,129573,120823,8750,6.8
West Feliciana,11/1/1993,3538,3308,230,6.5,129711,121169,8542,6.6
West Feliciana,12/1/1993,3503,3277,226,6.5,129941,121464,8477,6.5
West Feliciana,1/1/1994,3651,3327,324,8.9,130596,121966,8630,6.6
West Feliciana,2/1/1994,3664,3312,352,9.6,130669,122086,8583,6.6
West Feliciana,3/1/1994,3707,3350,357,9.6,130400,121930,8470,6.5
West Feliciana,4/1/1994,3861,3559,302,7.8,130621,122290,8331,6.4
West Feliciana,5/1/1994,3873,3589,284,7.3,130779,122864,7915,6.1
West Feliciana,6/1/1994,3904,3577,327,8.4,130561,122634,7927,6.1
West Feliciana,7/1/1994,4106,3774,332,8.1,130652,122706,7946,6.1
West Feliciana,8/1/1994,4099,3761,338,8.2,131275,123342,7933,6
West Feliciana,9/1/1994,4120,3734,386,9.4,131421,123687,7734,5.9
West Feliciana,10/1/1994,4064,3747,317,7.8,131744,124112,7632,5.8
West Feliciana,11/1/1994,4010,3709,301,7.5,131891,124516,7375,5.6
West Feliciana,12/1/1994,4025,3681,344,8.5,131951,124721,7230,5.5
West Feliciana,1/1/1995,3659,3251,408,11.2,132038,124663,7375,5.6
West Feliciana,2/1/1995,3600,3249,351,9.8,132115,124928,7187,5.4
West Feliciana,3/1/1995,3593,3275,318,8.9,132108,124955,7153,5.4
West Feliciana,4/1/1995,3630,3398,232,6.4,132590,124945,7645,5.8
West Feliciana,5/1/1995,3613,3393,220,6.1,131851,124421,7430,5.6
West Feliciana,6/1/1995,3620,3379,241,6.7,131949,124522,7427,5.6
West Feliciana,7/1/1995,3667,3453,214,5.8,132343,124816,7527,5.7
West Feliciana,8/1/1995,3646,3427,219,6,132336,124852,7484,5.7
West Feliciana,9/1/1995,3502,3228,274,7.8,132611,125133,7478,5.6
West Feliciana,10/1/1995,3610,3385,225,6.2,132716,125388,7328,5.5
West Feliciana,11/1/1995,3573,3409,164,4.6,132614,125188,7426,5.6
West Feliciana,12/1/1995,3727,3473,254,6.8,132511,125088,7423,5.6
West Feliciana,1/1/1996,3884,3560,324,8.3,132616,125125,7491,5.6
West Feliciana,2/1/1996,3646,3359,287,7.9,132952,125639,7313,5.5
West Feliciana,3/1/1996,3613,3362,251,6.9,133180,125862,7318,5.5
West Feliciana,4/1/1996,3613,3362,251,6.9,133409,125994,7415,5.6
West Feliciana,5/1/1996,3598,3410,188,5.2,133667,126244,7423,5.6
West Feliciana,6/1/1996,3662,3437,225,6.1,133697,126602,7095,5.3
West Feliciana,7/1/1996,3747,3464,283,7.6,134284,126947,7337,5.5
West Feliciana,8/1/1996,3650,3397,253,6.9,134054,127172,6882,5.1
West Feliciana,9/1/1996,3617,3368,249,6.9,134515,127536,6979,5.2
West Feliciana,10/1/1996,3581,3330,251,7,134921,127890,7031,5.2
West Feliciana,11/1/1996,3573,3328,245,6.9,135007,127771,7236,5.4
West Feliciana,12/1/1996,3543,3315,228,6.4,135113,127860,7253,5.4
West Feliciana,1/1/1997,3696,3407,289,7.8,135456,128298,7158,5.3
West Feliciana,2/1/1997,3658,3381,277,7.6,135400,128298,7102,5.2
West Feliciana,3/1/1997,3717,3459,258,6.9,135891,128891,7000,5.2
West Feliciana,4/1/1997,3861,3604,257,6.7,136016,129143,6873,5.1
West Feliciana,5/1/1997,3856,3612,244,6.3,136119,129464,6655,4.9
West Feliciana,6/1/1997,3786,3533,253,6.7,136211,129412,6799,5
West Feliciana,7/1/1997,3824,3587,237,6.2,136477,129822,6655,4.9
West Feliciana,8/1/1997,3772,3527,245,6.5,136618,130010,6608,4.8
West Feliciana,9/1/1997,3640,3389,251,6.9,136675,130019,6656,4.9
West Feliciana,10/1/1997,3704,3474,230,6.2,136633,130179,6454,4.7
West Feliciana,11/1/1997,3675,3427,248,6.7,136961,130653,6308,4.6
West Feliciana,12/1/1997,3651,3420,231,6.3,137155,130679,6476,4.7
West Feliciana,1/1/1998,3760,3495,265,7,137095,130726,6368,4.6
West Feliciana,2/1/1998,3725,3517,208,5.6,137112,130807,6306,4.6
West Feliciana,3/1/1998,3752,3548,204,5.4,137236,130814,6422,4.7
West Feliciana,4/1/1998,3861,3672,189,4.9,137150,131209,5941,4.3
West Feliciana,5/1/1998,3783,3597,186,4.9,137372,131325,6047,4.4
West Feliciana,6/1/1998,3729,3545,184,4.9,137455,131244,6212,4.5
West Feliciana,7/1/1998,3599,3411,188,5.2,137588,131329,6259,4.5
West Feliciana,8/1/1998,3576,3383,193,5.4,137570,131390,6179,4.5
West Feliciana,9/1/1998,3583,3362,221,6.2,138286,131986,6300,4.6
West Feliciana,10/1/1998,3504,3321,183,5.2,138279,131999,6280,4.5
West Feliciana,11/1/1998,3450,3285,165,4.8,138381,132280,6100,4.4
West Feliciana,12/1/1998,3402,3247,155,4.6,138634,132602,6032,4.4
West Feliciana,1/1/1999,3787,3582,205,5.4,139003,133027,5976,4.3
West Feliciana,2/1/1999,3748,3585,163,4.3,138967,132856,6111,4.4
West Feliciana,3/1/1999,3705,3574,131,3.5,138730,132947,5783,4.2
West Feliciana,4/1/1999,3763,3652,111,2.9,138959,132955,6004,4.3
West Feliciana,5/1/1999,3738,3607,131,3.5,139107,133311,5796,4.2
West Feliciana,6/1/1999,3720,3570,150,4,139329,133378,5951,4.3
West Feliciana,7/1/1999,3727,3538,189,5.1,139439,133414,6025,4.3
West Feliciana,8/1/1999,3708,3514,194,5.2,139430,133591,5838,4.2
West Feliciana,9/1/1999,3596,3425,171,4.8,139622,133707,5915,4.2
West Feliciana,10/1/1999,3544,3371,173,4.9,139771,133993,5778,4.1
West Feliciana,11/1/1999,3480,3352,128,3.7,140025,134309,5716,4.1
West Feliciana,12/1/1999,3446,3308,138,4,140177,134523,5653,4
West Feliciana,1/1/2000,4787,4460,327,6.8,142267,136559,5708,4
West Feliciana,2/1/2000,4801,4511,290,6,142456,136598,5858,4.1
West Feliciana,3/1/2000,4819,4528,291,6,142434,136701,5733,4
West Feliciana,4/1/2000,4842,4577,265,5.5,142751,137270,5481,3.8
West Feliciana,5/1/2000,4807,4490,317,6.6,142388,136630,5758,4
West Feliciana,6/1/2000,4871,4526,345,7.1,142591,136940,5651,4
West Feliciana,7/1/2000,4762,4427,335,7,142278,136531,5747,4
West Feliciana,8/1/2000,4756,4424,332,7,142514,136662,5853,4.1
West Feliciana,9/1/2000,4756,4423,333,7,142518,136893,5625,3.9
West Feliciana,10/1/2000,4751,4437,314,6.6,142622,137088,5534,3.9
West Feliciana,11/1/2000,4754,4447,307,6.5,142962,137322,5639,3.9
West Feliciana,12/1/2000,4736,4442,294,6.2,143248,137614,5634,3.9
West Feliciana,1/1/2001,4763,4395,368,7.7,143800,137778,6023,4.2
West Feliciana,2/1/2001,4735,4400,335,7.1,143701,137612,6089,4.2
West Feliciana,3/1/2001,4731,4396,335,7.1,143924,137783,6141,4.3
West Feliciana,4/1/2001,4737,4424,313,6.6,143569,137299,6271,4.4
West Feliciana,5/1/2001,4707,4406,301,6.4,143318,137092,6226,4.3
West Feliciana,6/1/2001,4784,4421,363,7.6,143357,136873,6484,4.5
West Feliciana,7/1/2001,4735,4383,352,7.4,143654,137071,6583,4.6
West Feliciana,8/1/2001,4686,4346,340,7.3,143284,136241,7042,4.9
West Feliciana,9/1/2001,4737,4366,371,7.8,143989,136846,7142,5
West Feliciana,10/1/2001,4770,4431,339,7.1,144086,136392,7694,5.3
West Feliciana,11/1/2001,4790,4425,365,7.6,144240,136238,8003,5.5
West Feliciana,12/1/2001,4771,4407,364,7.6,144305,136047,8258,5.7
West Feliciana,1/1/2002,4666,4279,387,8.3,143883,135701,8182,5.7
West Feliciana,2/1/2002,4650,4334,316,6.8,144653,136438,8215,5.7
West Feliciana,3/1/2002,4620,4326,294,6.4,144481,136177,8304,5.7
West Feliciana,4/1/2002,4678,4370,308,6.6,144725,136126,8599,5.9
West Feliciana,5/1/2002,4627,4329,298,6.4,144938,136539,8399,5.8
West Feliciana,6/1/2002,4729,4362,367,7.8,144808,136415,8393,5.8
West Feliciana,7/1/2002,4703,4345,358,7.6,144803,136413,8390,5.8
West Feliciana,8/1/2002,4704,4336,368,7.8,145009,136705,8304,5.7
West Feliciana,9/1/2002,4734,4366,368,7.8,145552,137302,8251,5.7
West Feliciana,10/1/2002,4734,4404,330,7,145314,137008,8307,5.7
West Feliciana,11/1/2002,4711,4373,338,7.2,145041,136521,8520,5.9
West Feliciana,12/1/2002,4677,4339,338,7.2,145066,136426,8640,6
West Feliciana,1/1/2003,4650,4282,368,7.9,145937,137417,8520,5.8
West Feliciana,2/1/2003,4712,4360,352,7.5,146100,137482,8618,5.9
West Feliciana,3/1/2003,4686,4349,337,7.2,146022,137434,8588,5.9
West Feliciana,4/1/2003,4725,4409,316,6.7,146474,137633,8842,6
West Feliciana,5/1/2003,4710,4357,353,7.5,146500,137544,8957,6.1
West Feliciana,6/1/2003,4779,4350,429,9,147056,137790,9266,6.3
West Feliciana,7/1/2003,4799,4380,419,8.7,146485,137474,9011,6.2
West Feliciana,8/1/2003,4749,4350,399,8.4,146445,137549,8896,6.1
West Feliciana,9/1/2003,4726,4356,370,7.8,146530,137609,8921,6.1
West Feliciana,10/1/2003,4740,4422,318,6.7,146716,137984,8732,6
West Feliciana,11/1/2003,4739,4412,327,6.9,147000,138424,8576,5.8
West Feliciana,12/1/2003,4701,4381,320,6.8,146729,138411,8317,5.7
West Feliciana,1/1/2004,4664,4278,386,8.3,146842,138472,8370,5.7
West Feliciana,2/1/2004,4689,4346,343,7.3,146709,138542,8167,5.6
West Feliciana,3/1/2004,4728,4378,350,7.4,146944,138453,8491,5.8
West Feliciana,4/1/2004,4697,4389,308,6.6,146850,138680,8170,5.6
West Feliciana,5/1/2004,4656,4329,327,7,147065,138852,8212,5.6
West Feliciana,6/1/2004,4761,4373,388,8.1,147460,139174,8286,5.6
West Feliciana,7/1/2004,4725,4394,331,7,147692,139556,8136,5.5
West Feliciana,8/1/2004,4662,4379,283,6.1,147564,139573,7990,5.4
West Feliciana,9/1/2004,4657,4378,279,6,147415,139487,7927,5.4
West Feliciana,10/1/2004,4681,4420,261,5.6,147793,139732,8061,5.5
West Feliciana,11/1/2004,4724,4450,274,5.8,148162,140231,7932,5.4
West Feliciana,12/1/2004,4697,4422,275,5.9,148059,140125,7934,5.4
West Feliciana,1/1/2005,4647,4328,319,6.9,148029,140245,7784,5.3
West Feliciana,2/1/2005,4706,4387,319,6.8,148364,140385,7980,5.4
West Feliciana,3/1/2005,4694,4422,272,5.8,148391,140654,7737,5.2
West Feliciana,4/1/2005,4757,4492,265,5.6,148926,141254,7672,5.2
West Feliciana,5/1/2005,4708,4422,286,6.1,149261,141609,7651,5.1
West Feliciana,6/1/2005,4826,4437,389,8.1,149238,141714,7524,5
West Feliciana,7/1/2005,4801,4464,337,7,149432,142026,7406,5
West Feliciana,8/1/2005,4792,4464,328,6.8,149779,142434,7345,4.9
West Feliciana,9/1/2005,5499,4808,691,12.6,149954,142401,7553,5
West Feliciana,10/1/2005,5503,4895,608,11,150001,142548,7453,5
West Feliciana,11/1/2005,5516,4902,614,11.1,150065,142499,7566,5
West Feliciana,12/1/2005,5208,4843,365,7,150030,142752,7279,4.9
West Feliciana,1/1/2006,4942,4633,309,6.3,150214,143150,7064,4.7
West Feliciana,2/1/2006,4918,4691,227,4.6,150641,143457,7184,4.8
West Feliciana,3/1/2006,4921,4702,219,4.5,150813,143741,7072,4.7
West Feliciana,4/1/2006,4865,4683,182,3.7,150881,143761,7120,4.7
West Feliciana,5/1/2006,4890,4647,243,5,151069,144089,6980,4.6
West Feliciana,6/1/2006,4918,4618,300,6.1,151354,144353,7001,4.6
West Feliciana,7/1/2006,4811,4576,235,4.9,151377,144202,7175,4.7
West Feliciana,8/1/2006,4832,4589,243,5,151716,144625,7091,4.7
West Feliciana,9/1/2006,4835,4595,240,5,151662,144815,6847,4.5
West Feliciana,10/1/2006,4884,4652,232,4.8,152041,145314,6727,4.4
West Feliciana,11/1/2006,4893,4652,241,4.9,152406,145534,6872,4.5
West Feliciana,12/1/2006,4880,4657,223,4.6,152732,145970,6762,4.4
West Feliciana,1/1/2007,4677,4418,259,5.5,153144,146028,7116,4.6
West Feliciana,2/1/2007,4686,4469,217,4.6,152983,146057,6927,4.5
West Feliciana,3/1/2007,4729,4519,210,4.4,153051,146320,6731,4.4
West Feliciana,4/1/2007,4735,4530,205,4.3,152435,145586,6850,4.5
West Feliciana,5/1/2007,4773,4519,254,5.3,152670,145903,6766,4.4
West Feliciana,6/1/2007,4852,4552,300,6.2,153041,146063,6979,4.6
West Feliciana,7/1/2007,4855,4586,269,5.5,153054,145905,7149,4.7
West Feliciana,8/1/2007,4844,4539,305,6.3,152749,145682,7067,4.6
West Feliciana,9/1/2007,4873,4569,304,6.2,153414,146244,7170,4.7
West Feliciana,10/1/2007,4857,4607,250,5.1,153183,145946,7237,4.7
West Feliciana,11/1/2007,4888,4629,259,5.3,153835,146595,7240,4.7
West Feliciana,12/1/2007,4863,4602,261,5.4,153918,146273,7645,5
West Feliciana,1/1/2008,4697,4425,272,5.8,154063,146378,7685,5
West Feliciana,2/1/2008,4675,4462,213,4.6,153653,146156,7497,4.9
West Feliciana,3/1/2008,4704,4493,211,4.5,153908,146086,7822,5.1
West Feliciana,4/1/2008,4726,4535,191,4,153769,146132,7637,5
West Feliciana,5/1/2008,4735,4505,230,4.9,154303,145908,8395,5.4
West Feliciana,6/1/2008,4843,4555,288,5.9,154313,145737,8575,5.6
West Feliciana,7/1/2008,4814,4558,256,5.3,154469,145532,8937,5.8
West Feliciana,8/1/2008,4783,4510,273,5.7,154641,145203,9438,6.1
West Feliciana,9/1/2008,4818,4518,300,6.2,154570,145076,9494,6.1
West Feliciana,10/1/2008,4873,4574,299,6.1,154876,144802,10074,6.5
West Feliciana,11/1/2008,4879,4571,308,6.3,154639,144100,10538,6.8
West Feliciana,12/1/2008,4855,4549,306,6.3,154655,143369,11286,7.3
West Feliciana,1/1/2009,4705,4372,333,7.1,154210,142152,12058,7.8
West Feliciana,2/1/2009,4727,4409,318,6.7,154538,141640,12898,8.3
West Feliciana,3/1/2009,4763,4430,333,7,154133,140707,13426,8.7
West Feliciana,4/1/2009,4777,4455,322,6.7,154509,140656,13853,9
West Feliciana,5/1/2009,4779,4413,366,7.7,154747,140248,14499,9.4
West Feliciana,6/1/2009,4848,4422,426,8.8,154716,140009,14707,9.5
West Feliciana,7/1/2009,4826,4472,354,7.3,154502,139901,14601,9.5
West Feliciana,8/1/2009,4805,4437,368,7.7,154307,139492,14814,9.6
West Feliciana,9/1/2009,4813,4451,362,7.5,153827,138818,15009,9.8
West Feliciana,10/1/2009,4792,4436,356,7.4,153784,138432,15352,10
West Feliciana,11/1/2009,4793,4452,341,7.1,153878,138659,15219,9.9
West Feliciana,12/1/2009,4718,4379,339,7.2,153111,138013,15098,9.9
West Feliciana,1/1/2010,5140,4813,327,6.4,153484,138438,15046,9.8
West Feliciana,2/1/2010,5170,4879,291,5.6,153694,138581,15113,9.8
West Feliciana,3/1/2010,5225,4920,305,5.8,153954,138751,15202,9.9
West Feliciana,4/1/2010,5265,4968,297,5.6,154622,139297,15325,9.9
West Feliciana,5/1/2010,5260,4928,332,6.3,154091,139241,14849,9.6
West Feliciana,6/1/2010,5321,4946,375,7,153616,139141,14474,9.4
West Feliciana,7/1/2010,5319,4967,352,6.6,153691,139179,14512,9.4
West Feliciana,8/1/2010,5312,4951,361,6.8,154086,139438,14648,9.5
West Feliciana,9/1/2010,5274,4931,343,6.5,153975,139396,14579,9.5
West Feliciana,10/1/2010,5286,4952,334,6.3,153635,139119,14516,9.4
West Feliciana,11/1/2010,5248,4929,319,6.1,154125,139044,15081,9.8
West Feliciana,12/1/2010,5187,4877,310,6,153650,139301,14348,9.3
West Feliciana,1/1/2011,5087,4755,332,6.5,153263,139250,14013,9.1
West Feliciana,2/1/2011,5111,4816,295,5.8,153214,139394,13820,9
West Feliciana,3/1/2011,5135,4837,298,5.8,153376,139639,13737,9
West Feliciana,4/1/2011,5167,4873,294,5.7,153543,139586,13957,9.1
West Feliciana,5/1/2011,5178,4848,330,6.4,153479,139624,13855,9
West Feliciana,6/1/2011,5197,4827,370,7.1,153346,139384,13962,9.1
West Feliciana,7/1/2011,5211,4864,347,6.7,153288,139524,13763,9
West Feliciana,8/1/2011,5161,4827,334,6.5,153760,139942,13818,9
West Feliciana,9/1/2011,5198,4867,331,6.4,154131,140183,13948,9
West Feliciana,10/1/2011,5229,4907,322,6.2,153961,140368,13594,8.8
West Feliciana,11/1/2011,5205,4908,297,5.7,154128,140826,13302,8.6
West Feliciana,12/1/2011,5155,4865,290,5.6,153995,140902,13093,8.5
West Feliciana,1/1/2012,5060,4740,320,6.3,154381,141584,12797,8.3
West Feliciana,2/1/2012,5127,4817,310,6,154671,141858,12813,8.3
West Feliciana,3/1/2012,5141,4844,297,5.8,154749,142036,12713,8.2
West Feliciana,4/1/2012,5154,4868,286,5.5,154545,141899,12646,8.2
West Feliciana,5/1/2012,5158,4858,300,5.8,154866,142206,12660,8.2
West Feliciana,6/1/2012,5218,4860,358,6.9,155083,142391,12692,8.2
West Feliciana,7/1/2012,5210,4871,339,6.5,154948,142292,12656,8.2
West Feliciana,8/1/2012,5157,4858,299,5.8,154763,142291,12471,8.1
West Feliciana,9/1/2012,5164,4900,264,5.1,155160,143044,12115,7.8
West Feliciana,10/1/2012,5212,4945,267,5.1,155554,143431,12124,7.8
West Feliciana,11/1/2012,5190,4941,249,4.8,155338,143333,12005,7.7
West Feliciana,12/1/2012,5163,4896,267,5.2,155628,143330,12298,7.9
West Feliciana,1/1/2013,5120,4793,327,6.4,155763,143292,12471,8
West Feliciana,2/1/2013,5158,4860,298,5.8,155312,143362,11950,7.7
West Feliciana,3/1/2013,5162,4881,281,5.4,155005,143316,11689,7.5
West Feliciana,4/1/2013,5213,4935,278,5.3,155394,143635,11760,7.6
West Feliciana,5/1/2013,5250,4943,307,5.8,155536,143882,11654,7.5
West Feliciana,6/1/2013,5301,4949,352,6.6,155749,143999,11751,7.5
West Feliciana,7/1/2013,5311,4989,322,6.1,155599,144264,11335,7.3
West Feliciana,8/1/2013,5264,4965,299,5.7,155605,144326,11279,7.2
West Feliciana,9/1/2013,5281,4989,292,5.5,155687,144418,11270,7.2
West Feliciana,10/1/2013,5265,4977,288,5.5,154673,143537,11136,7.2
West Feliciana,11/1/2013,5265,4998,267,5.1,155265,144479,10787,6.9
West Feliciana,12/1/2013,5202,4956,246,4.7,155182,144778,10404,6.7
West Feliciana,1/1/2014,5131,4866,265,5.2,155352,145150,10202,6.6
West Feliciana,2/1/2014,5194,4934,260,5,155483,145134,10349,6.7
West Feliciana,3/1/2014,5246,4973,273,5.2,156028,145648,10380,6.7
West Feliciana,4/1/2014,5257,5000,257,4.9,155369,145667,9702,6.2
West Feliciana,5/1/2014,5298,5004,294,5.5,155684,145825,9859,6.3
West Feliciana,6/1/2014,5345,5023,322,6,155707,146247,9460,6.1
West Feliciana,7/1/2014,5404,5074,330,6.1,156007,146399,9608,6.2
West Feliciana,8/1/2014,5390,5070,320,5.9,156130,146530,9599,6.1
West Feliciana,9/1/2014,5419,5114,305,5.6,156040,146778,9262,5.9
West Feliciana,10/1/2014,5467,5155,312,5.7,156417,147427,8990,5.7
West Feliciana,11/1/2014,5442,5118,324,6,156494,147404,9090,5.8
West Feliciana,12/1/2014,5390,5085,305,5.7,156332,147615,8717,5.6
West Feliciana,1/1/2015,5334,5005,329,6.2,157030,148145,8885,5.7
West Feliciana,2/1/2015,5358,5054,304,5.7,156644,148045,8599,5.5
West Feliciana,3/1/2015,5360,5083,277,5.2,156643,148128,8515,5.4
West Feliciana,4/1/2015,5374,5095,279,5.2,157060,148511,8550,5.4
West Feliciana,5/1/2015,5404,5113,291,5.4,157651,148817,8834,5.6
West Feliciana,6/1/2015,5420,5124,296,5.5,157062,148816,8247,5.3
West Feliciana,7/1/2015,5436,5147,289,5.3,156997,148830,8167,5.2
West Feliciana,8/1/2015,5379,5114,265,4.9,157172,149181,7992,5.1
West Feliciana,9/1/2015,5361,5093,268,5,156733,148826,7907,5
West Feliciana,10/1/2015,5388,5118,270,5,157167,149246,7922,5
West Feliciana,11/1/2015,5391,5131,260,4.8,157463,149463,8000,5.1
West Feliciana,12/1/2015,5338,5098,240,4.5,158035,150128,7907,5
West Feliciana,1/1/2016,5290,4988,302,5.7,158280,150653,7627,4.8
West Feliciana,2/1/2016,5324,5050,274,5.1,158640,150939,7702,4.9
West Feliciana,3/1/2016,5375,5097,278,5.2,159179,151218,7961,5
West Feliciana,4/1/2016,5381,5100,281,5.2,159141,151074,8067,5.1
West Feliciana,5/1/2016,5363,5087,276,5.1,158784,151132,7652,4.8
West Feliciana,6/1/2016,5420,5100,320,5.9,158967,151223,7744,4.9
West Feliciana,7/1/2016,5404,5105,299,5.5,159194,151554,7641,4.8
West Feliciana,8/1/2016,5289,5002,287,5.4,159562,151779,7784,4.9
West Feliciana,9/1/2016,5312,5023,289,5.4,159714,151761,7953,5
West Feliciana,10/1/2016,5296,5050,246,4.6,159605,151793,7811,4.9
West Feliciana,11/1/2016,5273,5045,228,4.3,159506,151954,7553,4.7
West Feliciana,12/1/2016,5188,4977,211,4.1,159678,152157,7521,4.7
West Feliciana,1/1/2017,5243,4991,252,4.8,159620,152152,7468,4.7
West Feliciana,2/1/2017,5303,5073,230,4.3,159859,152480,7379,4.6
West Feliciana,3/1/2017,5330,5110,220,4.1,160137,153065,7073,4.4
West Feliciana,4/1/2017,5338,5118,220,4.1,160345,153255,7089,4.4
West Feliciana,5/1/2017,5308,5099,209,3.9,160068,153069,7000,4.4
West Feliciana,6/1/2017,5359,5118,241,4.5,160192,153318,6873,4.3
West Feliciana,7/1/2017,5369,5131,238,4.4,160462,153569,6892,4.3
West Feliciana,8/1/2017,5345,5099,246,4.6,160586,153503,7082,4.4
West Feliciana,9/1/2017,5352,5123,229,4.3,161140,154286,6854,4.3
West Feliciana,10/1/2017,5323,5129,194,3.6,160309,153609,6700,4.2
West Feliciana,11/1/2017,5318,5126,192,3.6,160579,153805,6774,4.2
West Feliciana,12/1/2017,5278,5087,191,3.6,160535,153904,6632,4.1
West Feliciana,1/1/2018,5282,5064,218,4.1,160914,154425,6489,4
West Feliciana,2/1/2018,5360,5143,217,4,161778,155197,6581,4.1
West Feliciana,3/1/2018,5439,5219,220,4,161686,155214,6472,4
West Feliciana,4/1/2018,5411,5206,205,3.8,161771,155312,6459,4
West Feliciana,5/1/2018,5383,5178,205,3.8,161848,155652,6196,3.8
West Feliciana,6/1/2018,5451,5193,258,4.7,162210,155762,6447,4
West Feliciana,7/1/2018,5439,5206,233,4.3,162341,156146,6195,3.8
West Feliciana,8/1/2018,5349,5141,208,3.9,161660,155504,6156,3.8
West Feliciana,9/1/2018,5368,5168,200,3.7,162087,156015,6073,3.7
West Feliciana,10/1/2018,5411,5219,192,3.5,162602,156391,6211,3.8
West Feliciana,11/1/2018,5406,5231,175,3.2,162836,156721,6115,3.8
West Feliciana,12/1/2018,5359,5183,176,3.3,163206,156817,6389,3.9
West Feliciana,1/1/2019,5364,5146,218,4.1,162963,156487,6475,4
West Feliciana,2/1/2019,5431,5232,199,3.7,162999,156863,6136,3.8
West Feliciana,3/1/2019,5449,5261,188,3.5,162904,156701,6202,3.8
West Feliciana,4/1/2019,5397,5227,170,3.1,162586,156625,5961,3.7
West Feliciana,5/1/2019,5386,5193,193,3.6,162751,156821,5930,3.6
West Feliciana,6/1/2019,5420,5180,240,4.4,163168,157232,5935,3.6
West Feliciana,7/1/2019,5408,5163,245,4.5,163590,157529,6061,3.7
West Feliciana,8/1/2019,5404,5170,234,4.3,163774,157829,5945,3.6
West Feliciana,9/1/2019,5429,5211,218,4,164092,158339,5753,3.5
West Feliciana,10/1/2019,5442,5217,225,4.1,164416,158545,5871,3.6
West Feliciana,11/1/2019,5439,5214,225,4.1,164496,158629,5868,3.6
West Feliciana,12/1/2019,5348,5139,209,3.9,164699,158845,5853,3.6
West Feliciana,1/1/2020,5234,5011,223,4.3,164377,158508,5869,3.6
West Feliciana,2/1/2020,5268,5088,180,3.4,164467,158714,5753,3.5
West Feliciana,3/1/2020,5337,5032,305,5.7,162559,155353,7206,4.4
West Feliciana,4/1/2020,4762,4371,391,8.2,156269,133185,23084,14.8
West Feliciana,5/1/2020,4887,4501,386,7.9,158101,137173,20929,13.2
West Feliciana,6/1/2020,5029,4648,381,7.6,159994,142342,17652,11
West Feliciana,7/1/2020,5056,4708,348,6.9,160132,143779,16352,10.2
West Feliciana,8/1/2020,5118,4841,277,5.4,160706,147245,13461,8.4
West Feliciana,9/1/2020,5208,4919,289,5.5,160174,147620,12554,7.8
West Feliciana,10/1/2020,5298,5027,271,5.1,161003,149931,11072,6.9
West Feliciana,11/1/2020,5232,4989,243,4.6,160629,149934,10694,6.7
West Feliciana,12/1/2020,5209,4960,249,4.8,160745,149975,10770,6.7
West Feliciana,1/1/2021,5160,4908,252,4.9,160088,149852,10236,6.4
West Feliciana,2/1/2021,5201,4970,231,4.4,160184,150189,9995,6.2
West Feliciana,3/1/2021,5237,5023,214,4.1,160400,150644,9756,6.1
West Feliciana,4/1/2021,5287,5060,227,4.3,160843,151081,9762,6.1
West Feliciana,5/1/2021,5254,5033,221,4.2,160800,151535,9266,5.8
West Feliciana,6/1/2021,5229,4984,245,4.7,161197,151734,9462,5.9
West Feliciana,7/1/2021,5226,5005,221,4.2,161504,152773,8731,5.4
West Feliciana,8/1/2021,5213,5021,192,3.7,161527,153250,8276,5.1
West Feliciana,9/1/2021,5335,5172,163,3.1,161495,153843,7652,4.7
West Feliciana,10/1/2021,5346,5191,155,2.9,161754,154475,7279,4.5
West Feliciana,11/1/2021,5354,5211,143,2.7,162281,155530,6751,4.2
West Feliciana,12/1/2021,5322,5199,123,2.3,162497,156099,6398,3.9
West Feliciana,1/1/2022,5349,5192,157,2.9,163627,157115,6512,4
West Feliciana,2/1/2022,5414,5278,136,2.5,163899,157598,6301,3.8
West Feliciana,3/1/2022,5447,5314,133,2.4,164220,158206,6014,3.7
West Feliciana,4/1/2022,5432,5312,120,2.2,163893,157891,6002,3.7
West Feliciana,5/1/2022,5399,5273,126,2.3,164362,158378,5983,3.6
West Feliciana,6/1/2022,5410,5236,174,3.2,164046,158094,5951,3.6
West Feliciana,7/1/2022,5425,5267,158,2.9,164026,158258,5768,3.5
West Feliciana,8/1/2022,5390,5239,151,2.8,164654,158735,5919,3.6
West Feliciana,9/1/2022,5404,5262,142,2.6,164602,158810,5792,3.5
West Feliciana,10/1/2022,5405,5277,128,2.4,164648,158684,5964,3.6
West Feliciana,11/1/2022,5396,5270,126,2.3,164450,158507,5943,3.6
West Feliciana,12/1/2022,5372,5245,127,2.4,165025,159259,5766,3.5
West Feliciana,1/1/2023,5353,5207,146,2.7,165964,160217,5747,3.5
West Feliciana,2/1/2023,5415,5268,147,2.7,166358,160395,5962,3.6
West Feliciana,3/1/2023,5456,5325,131,2.4,166651,160812,5839,3.5
West Feliciana,4/1/2023,5444,5325,119,2.2,166725,160974,5751,3.4
West Feliciana,5/1/2023,5407,5269,138,2.6,166886,160796,6089,3.6
West Feliciana,6/1/2023,5404,5244,160,3,166937,160979,5958,3.6
West Feliciana,7/1/2023,5415,5279,136,2.5,167103,161183,5920,3.5
West Feliciana,8/1/2023,5406,5264,142,2.6,167759,161475,6284,3.7
West Feliciana,9/1/2023,5472,5308,164,3,167767,161442,6326,3.8
West Feliciana,10/1/2023,5485,5328,157,2.9,167690,161211,6479,3.9
West Feliciana,11/1/2023,5507,5357,150,2.7,168140,161886,6254,3.7
West Feliciana,12/1/2023,5459,5301,158,2.9,167439,161124,6315,3.8
West Feliciana,1/1/2024,5435,5264,171,3.1,167339,161190,6149,3.7
West Feliciana,2/1/2024,5443,5281,162,3,167475,161013,6462,3.9
West Feliciana,3/1/2024,5512,5358,154,2.8,167922,161425,6497,3.9
West Feliciana,4/1/2024,5506,5368,138,2.5,167988,161495,6492,3.9
West Feliciana,5/1/2024,5458,5318,140,2.6,167799,161164,6635,4
West Feliciana,6/1/2024,5485,5301,184,3.4,168005,161155,6849,4.1
West Feliciana,7/1/2024,5514,5322,192,3.5,168315,161219,7097,4.2
West Feliciana,8/1/2024,5483,5299,184,3.4,168496,161425,7071,4.2
West Feliciana,9/1/2024,5483,5292,191,3.5,168703,161802,6901,4.1
West Feliciana,10/1/2024,5505,5322,183,3.3,168428,161456,6972,4.1
West Feliciana,11/1/2024,5483,5307,176,3.2,168304,161183,7121,4.2
West Feliciana,12/1/2024,5467,5290,177,3.2,168547,161661,6886,4.1
West Feliciana,1/1/2025,5734,5552,182,3.2,170744,163895,6849,4
West Feliciana,2/1/2025,5786,5617,169,2.9,170359,163307,7052,4.1
Winn,1/1/1990,5867,5590,277,4.7,125833,119081,6752,5.4
Winn,2/1/1990,6070,5793,277,4.6,125710,119059,6651,5.3
Winn,3/1/1990,6232,5997,235,3.8,125801,119203,6598,5.2
Winn,4/1/1990,6044,5840,204,3.4,125649,118852,6797,5.4
Winn,5/1/1990,6085,5840,245,4,125893,119151,6742,5.4
Winn,6/1/1990,6157,5863,294,4.8,125573,118983,6590,5.2
Winn,7/1/1990,6240,5973,267,4.3,125732,118810,6922,5.5
Winn,8/1/1990,6171,5935,236,3.8,125990,118802,7188,5.7
Winn,9/1/1990,6172,5900,272,4.4,125892,118524,7368,5.9
Winn,10/1/1990,6131,5867,264,4.3,125995,118536,7459,5.9
Winn,11/1/1990,6084,5803,281,4.6,126070,118306,7764,6.2
Winn,12/1/1990,6041,5757,284,4.7,126142,118241,7901,6.3
Winn,1/1/1991,5907,5523,384,6.5,125955,117940,8015,6.4
Winn,2/1/1991,5845,5373,472,8.1,126020,117755,8265,6.6
Winn,3/1/1991,5914,5484,430,7.3,126238,117652,8586,6.8
Winn,4/1/1991,5940,5538,402,6.8,126548,118109,8439,6.7
Winn,5/1/1991,5983,5525,458,7.7,126176,117440,8736,6.9
Winn,6/1/1991,6087,5609,478,7.9,126331,117639,8692,6.9
Winn,7/1/1991,6104,5762,342,5.6,126154,117568,8586,6.8
Winn,8/1/1991,6235,5787,448,7.2,126150,117484,8666,6.9
Winn,9/1/1991,6066,5718,348,5.7,126650,117928,8722,6.9
Winn,10/1/1991,5978,5670,308,5.2,126642,117800,8842,7
Winn,11/1/1991,5947,5649,298,5,126701,117770,8931,7
Winn,12/1/1991,5891,5548,343,5.8,126664,117466,9198,7.3
Winn,1/1/1992,5920,5485,435,7.3,127261,117978,9283,7.3
Winn,2/1/1992,5862,5447,415,7.1,127207,117753,9454,7.4
Winn,3/1/1992,5894,5519,375,6.4,127604,118144,9460,7.4
Winn,4/1/1992,5925,5597,328,5.5,127841,118426,9415,7.4
Winn,5/1/1992,5922,5611,311,5.3,128119,118375,9744,7.6
Winn,6/1/1992,6048,5666,382,6.3,128459,118419,10040,7.8
Winn,7/1/1992,6368,6043,325,5.1,128563,118713,9850,7.7
Winn,8/1/1992,6308,6033,275,4.4,128613,118826,9787,7.6
Winn,9/1/1992,6177,5904,273,4.4,128501,118720,9781,7.6
Winn,10/1/1992,6211,5962,249,4,128026,118628,9398,7.3
Winn,11/1/1992,6246,6016,230,3.7,128441,118876,9565,7.4
Winn,12/1/1992,6068,5836,232,3.8,128554,118997,9557,7.4
Winn,1/1/1993,6171,5844,327,5.3,128400,119075,9325,7.3
Winn,2/1/1993,6210,5930,280,4.5,128458,119275,9183,7.1
Winn,3/1/1993,6146,5882,264,4.3,128598,119542,9056,7
Winn,4/1/1993,6165,5905,260,4.2,128584,119474,9110,7.1
Winn,5/1/1993,6138,5912,226,3.7,129264,120115,9149,7.1
Winn,6/1/1993,6263,6007,256,4.1,129411,120290,9121,7
Winn,7/1/1993,6258,6052,206,3.3,129397,120467,8930,6.9
Winn,8/1/1993,6270,6061,209,3.3,129619,120856,8763,6.8
Winn,9/1/1993,6138,5949,189,3.1,129268,120554,8714,6.7
Winn,10/1/1993,6366,6134,232,3.6,129573,120823,8750,6.8
Winn,11/1/1993,6378,6139,239,3.7,129711,121169,8542,6.6
Winn,12/1/1993,6307,6072,235,3.7,129941,121464,8477,6.5
Winn,1/1/1994,6358,6023,335,5.3,130596,121966,8630,6.6
Winn,2/1/1994,6385,6093,292,4.6,130669,122086,8583,6.6
Winn,3/1/1994,6421,6090,331,5.2,130400,121930,8470,6.5
Winn,4/1/1994,6265,5967,298,4.8,130621,122290,8331,6.4
Winn,5/1/1994,6266,5964,302,4.8,130779,122864,7915,6.1
Winn,6/1/1994,6305,5976,329,5.2,130561,122634,7927,6.1
Winn,7/1/1994,6516,6197,319,4.9,130652,122706,7946,6.1
Winn,8/1/1994,6538,6202,336,5.1,131275,123342,7933,6
Winn,9/1/1994,6508,6174,334,5.1,131421,123687,7734,5.9
Winn,10/1/1994,6361,6044,317,5,131744,124112,7632,5.8
Winn,11/1/1994,6344,6043,301,4.7,131891,124516,7375,5.6
Winn,12/1/1994,6273,5990,283,4.5,131951,124721,7230,5.5
Winn,1/1/1995,6307,5956,351,5.6,132038,124663,7375,5.6
Winn,2/1/1995,6305,5996,309,4.9,132115,124928,7187,5.4
Winn,3/1/1995,6450,6102,348,5.4,132108,124955,7153,5.4
Winn,4/1/1995,6462,6114,348,5.4,132590,124945,7645,5.8
Winn,5/1/1995,6430,6100,330,5.1,131851,124421,7430,5.6
Winn,6/1/1995,6552,6161,391,6,131949,124522,7427,5.6
Winn,7/1/1995,6665,6315,350,5.3,132343,124816,7527,5.7
Winn,8/1/1995,6707,6340,367,5.5,132336,124852,7484,5.7
Winn,9/1/1995,6615,6263,352,5.3,132611,125133,7478,5.6
Winn,10/1/1995,6712,6251,461,6.9,132716,125388,7328,5.5
Winn,11/1/1995,6676,6203,473,7.1,132614,125188,7426,5.6
Winn,12/1/1995,6610,6160,450,6.8,132511,125088,7423,5.6
Winn,1/1/1996,6576,6020,556,8.5,132616,125125,7491,5.6
Winn,2/1/1996,6527,6101,426,6.5,132952,125639,7313,5.5
Winn,3/1/1996,6618,6143,475,7.2,133180,125862,7318,5.5
Winn,4/1/1996,6520,6074,446,6.8,133409,125994,7415,5.6
Winn,5/1/1996,6523,6099,424,6.5,133667,126244,7423,5.6
Winn,6/1/1996,6612,6158,454,6.9,133697,126602,7095,5.3
Winn,7/1/1996,6601,6191,410,6.2,134284,126947,7337,5.5
Winn,8/1/1996,6457,6058,399,6.2,134054,127172,6882,5.1
Winn,9/1/1996,6393,6039,354,5.5,134515,127536,6979,5.2
Winn,10/1/1996,6595,6246,349,5.3,134921,127890,7031,5.2
Winn,11/1/1996,6596,6263,333,5,135007,127771,7236,5.4
Winn,12/1/1996,6609,6242,367,5.6,135113,127860,7253,5.4
Winn,1/1/1997,6698,6145,553,8.3,135456,128298,7158,5.3
Winn,2/1/1997,6579,6122,457,6.9,135400,128298,7102,5.2
Winn,3/1/1997,6672,6185,487,7.3,135891,128891,7000,5.2
Winn,4/1/1997,6591,6242,349,5.3,136016,129143,6873,5.1
Winn,5/1/1997,6545,6210,335,5.1,136119,129464,6655,4.9
Winn,6/1/1997,6685,6261,424,6.3,136211,129412,6799,5
Winn,7/1/1997,6763,6385,378,5.6,136477,129822,6655,4.9
Winn,8/1/1997,6762,6426,336,5,136618,130010,6608,4.8
Winn,9/1/1997,6599,6236,363,5.5,136675,130019,6656,4.9
Winn,10/1/1997,6632,6326,306,4.6,136633,130179,6454,4.7
Winn,11/1/1997,6616,6314,302,4.6,136961,130653,6308,4.6
Winn,12/1/1997,6563,6219,344,5.2,137155,130679,6476,4.7
Winn,1/1/1998,6589,6145,444,6.7,137095,130726,6368,4.6
Winn,2/1/1998,6492,6149,343,5.3,137112,130807,6306,4.6
Winn,3/1/1998,6634,6209,425,6.4,137236,130814,6422,4.7
Winn,4/1/1998,6615,6230,385,5.8,137150,131209,5941,4.3
Winn,5/1/1998,6538,6137,401,6.1,137372,131325,6047,4.4
Winn,6/1/1998,6561,6104,457,7,137455,131244,6212,4.5
Winn,7/1/1998,6460,6062,398,6.2,137588,131329,6259,4.5
Winn,8/1/1998,6466,6045,421,6.5,137570,131390,6179,4.5
Winn,9/1/1998,6446,6000,446,6.9,138286,131986,6300,4.6
Winn,10/1/1998,6499,6095,404,6.2,138279,131999,6280,4.5
Winn,11/1/1998,6382,6005,377,5.9,138381,132280,6100,4.4
Winn,12/1/1998,6417,5936,481,7.5,138634,132602,6032,4.4
Winn,1/1/1999,6473,5926,547,8.5,139003,133027,5976,4.3
Winn,2/1/1999,6362,5952,410,6.4,138967,132856,6111,4.4
Winn,3/1/1999,6329,5956,373,5.9,138730,132947,5783,4.2
Winn,4/1/1999,6270,5940,330,5.3,138959,132955,6004,4.3
Winn,5/1/1999,6402,6081,321,5,139107,133311,5796,4.2
Winn,6/1/1999,6465,6060,405,6.3,139329,133378,5951,4.3
Winn,7/1/1999,6420,6026,394,6.1,139439,133414,6025,4.3
Winn,8/1/1999,6377,5984,393,6.2,139430,133591,5838,4.2
Winn,9/1/1999,6361,5957,404,6.4,139622,133707,5915,4.2
Winn,10/1/1999,6344,5978,366,5.8,139771,133993,5778,4.1
Winn,11/1/1999,6378,6040,338,5.3,140025,134309,5716,4.1
Winn,12/1/1999,6307,6028,279,4.4,140177,134523,5653,4
Winn,1/1/2000,6034,5666,368,6.1,142267,136559,5708,4
Winn,2/1/2000,5967,5644,323,5.4,142456,136598,5858,4.1
Winn,3/1/2000,6051,5658,393,6.5,142434,136701,5733,4
Winn,4/1/2000,6028,5703,325,5.4,142751,137270,5481,3.8
Winn,5/1/2000,5942,5579,363,6.1,142388,136630,5758,4
Winn,6/1/2000,5995,5566,429,7.2,142591,136940,5651,4
Winn,7/1/2000,5943,5556,387,6.5,142278,136531,5747,4
Winn,8/1/2000,5851,5460,391,6.7,142514,136662,5853,4.1
Winn,9/1/2000,5903,5524,379,6.4,142518,136893,5625,3.9
Winn,10/1/2000,6192,5747,445,7.2,142622,137088,5534,3.9
Winn,11/1/2000,6080,5693,387,6.4,142962,137322,5639,3.9
Winn,12/1/2000,6144,5743,401,6.5,143248,137614,5634,3.9
Winn,1/1/2001,6091,5609,482,7.9,143800,137778,6023,4.2
Winn,2/1/2001,6133,5694,439,7.2,143701,137612,6089,4.2
Winn,3/1/2001,6256,5781,475,7.6,143924,137783,6141,4.3
Winn,4/1/2001,6042,5616,426,7.1,143569,137299,6271,4.4
Winn,5/1/2001,5991,5583,408,6.8,143318,137092,6226,4.3
Winn,6/1/2001,6077,5601,476,7.8,143357,136873,6484,4.5
Winn,7/1/2001,6095,5668,427,7,143654,137071,6583,4.6
Winn,8/1/2001,6014,5579,435,7.2,143284,136241,7042,4.9
Winn,9/1/2001,6055,5598,457,7.5,143989,136846,7142,5
Winn,10/1/2001,6206,5733,473,7.6,144086,136392,7694,5.3
Winn,11/1/2001,6149,5705,444,7.2,144240,136238,8003,5.5
Winn,12/1/2001,6070,5647,423,7,144305,136047,8258,5.7
Winn,1/1/2002,6012,5526,486,8.1,143883,135701,8182,5.7
Winn,2/1/2002,5924,5531,393,6.6,144653,136438,8215,5.7
Winn,3/1/2002,5960,5566,394,6.6,144481,136177,8304,5.7
Winn,4/1/2002,5917,5499,418,7.1,144725,136126,8599,5.9
Winn,5/1/2002,6045,5604,441,7.3,144938,136539,8399,5.8
Winn,6/1/2002,6087,5596,491,8.1,144808,136415,8393,5.8
Winn,7/1/2002,6152,5698,454,7.4,144803,136413,8390,5.8
Winn,8/1/2002,6145,5702,443,7.2,145009,136705,8304,5.7
Winn,9/1/2002,6065,5631,434,7.2,145552,137302,8251,5.7
Winn,10/1/2002,6236,5828,408,6.5,145314,137008,8307,5.7
Winn,11/1/2002,6282,5773,509,8.1,145041,136521,8520,5.9
Winn,12/1/2002,6299,5776,523,8.3,145066,136426,8640,6
Winn,1/1/2003,6356,5758,598,9.4,145937,137417,8520,5.8
Winn,2/1/2003,6167,5635,532,8.6,146100,137482,8618,5.9
Winn,3/1/2003,6229,5688,541,8.7,146022,137434,8588,5.9
Winn,4/1/2003,6123,5607,516,8.4,146474,137633,8842,6
Winn,5/1/2003,6106,5583,523,8.6,146500,137544,8957,6.1
Winn,6/1/2003,6345,5676,669,10.5,147056,137790,9266,6.3
Winn,7/1/2003,6233,5660,573,9.2,146485,137474,9011,6.2
Winn,8/1/2003,6291,5760,531,8.4,146445,137549,8896,6.1
Winn,9/1/2003,6201,5715,486,7.8,146530,137609,8921,6.1
Winn,10/1/2003,6367,5938,429,6.7,146716,137984,8732,6
Winn,11/1/2003,6296,5867,429,6.8,147000,138424,8576,5.8
Winn,12/1/2003,6109,5709,400,6.5,146729,138411,8317,5.7
Winn,1/1/2004,6091,5646,445,7.3,146842,138472,8370,5.7
Winn,2/1/2004,6024,5626,398,6.6,146709,138542,8167,5.6
Winn,3/1/2004,5984,5571,413,6.9,146944,138453,8491,5.8
Winn,4/1/2004,5913,5548,365,6.2,146850,138680,8170,5.6
Winn,5/1/2004,5876,5501,375,6.4,147065,138852,8212,5.6
Winn,6/1/2004,5969,5507,462,7.7,147460,139174,8286,5.6
Winn,7/1/2004,6116,5666,450,7.4,147692,139556,8136,5.5
Winn,8/1/2004,6090,5728,362,5.9,147564,139573,7990,5.4
Winn,9/1/2004,6041,5661,380,6.3,147415,139487,7927,5.4
Winn,10/1/2004,6107,5761,346,5.7,147793,139732,8061,5.5
Winn,11/1/2004,6057,5705,352,5.8,148162,140231,7932,5.4
Winn,12/1/2004,5885,5544,341,5.8,148059,140125,7934,5.4
Winn,1/1/2005,6044,5657,387,6.4,148029,140245,7784,5.3
Winn,2/1/2005,5905,5558,347,5.9,148364,140385,7980,5.4
Winn,3/1/2005,5879,5544,335,5.7,148391,140654,7737,5.2
Winn,4/1/2005,5985,5658,327,5.5,148926,141254,7672,5.2
Winn,5/1/2005,6065,5708,357,5.9,149261,141609,7651,5.1
Winn,6/1/2005,6230,5815,415,6.7,149238,141714,7524,5
Winn,7/1/2005,6350,5973,377,5.9,149432,142026,7406,5
Winn,8/1/2005,6266,5919,347,5.5,149779,142434,7345,4.9
Winn,9/1/2005,6846,6338,508,7.4,149954,142401,7553,5
Winn,10/1/2005,6897,6397,500,7.2,150001,142548,7453,5
Winn,11/1/2005,6651,6124,527,7.9,150065,142499,7566,5
Winn,12/1/2005,6338,6021,317,5,150030,142752,7279,4.9
Winn,1/1/2006,6487,6212,275,4.2,150214,143150,7064,4.7
Winn,2/1/2006,6455,6223,232,3.6,150641,143457,7184,4.8
Winn,3/1/2006,6481,6233,248,3.8,150813,143741,7072,4.7
Winn,4/1/2006,6493,6251,242,3.7,150881,143761,7120,4.7
Winn,5/1/2006,6379,6106,273,4.3,151069,144089,6980,4.6
Winn,6/1/2006,6399,6076,323,5,151354,144353,7001,4.6
Winn,7/1/2006,6357,6082,275,4.3,151377,144202,7175,4.7
Winn,8/1/2006,6311,6032,279,4.4,151716,144625,7091,4.7
Winn,9/1/2006,6422,6144,278,4.3,151662,144815,6847,4.5
Winn,10/1/2006,6518,6252,266,4.1,152041,145314,6727,4.4
Winn,11/1/2006,6502,6220,282,4.3,152406,145534,6872,4.5
Winn,12/1/2006,6293,6025,268,4.3,152732,145970,6762,4.4
Winn,1/1/2007,6358,6026,332,5.2,153144,146028,7116,4.6
Winn,2/1/2007,6400,6121,279,4.4,152983,146057,6927,4.5
Winn,3/1/2007,6332,6035,297,4.7,153051,146320,6731,4.4
Winn,4/1/2007,6386,6083,303,4.7,152435,145586,6850,4.5
Winn,5/1/2007,6249,5928,321,5.1,152670,145903,6766,4.4
Winn,6/1/2007,6190,5813,377,6.1,153041,146063,6979,4.6
Winn,7/1/2007,6352,6018,334,5.3,153054,145905,7149,4.7
Winn,8/1/2007,6343,6036,307,4.8,152749,145682,7067,4.6
Winn,9/1/2007,6479,6180,299,4.6,153414,146244,7170,4.7
Winn,10/1/2007,6625,6350,275,4.2,153183,145946,7237,4.7
Winn,11/1/2007,6549,6266,283,4.3,153835,146595,7240,4.7
Winn,12/1/2007,6485,6180,305,4.7,153918,146273,7645,5
Winn,1/1/2008,6541,6202,339,5.2,154063,146378,7685,5
Winn,2/1/2008,6382,6099,283,4.4,153653,146156,7497,4.9
Winn,3/1/2008,6586,6261,325,4.9,153908,146086,7822,5.1
Winn,4/1/2008,6615,6313,302,4.6,153769,146132,7637,5
Winn,5/1/2008,6547,6220,327,5,154303,145908,8395,5.4
Winn,6/1/2008,6473,6090,383,5.9,154313,145737,8575,5.6
Winn,7/1/2008,6498,6114,384,5.9,154469,145532,8937,5.8
Winn,8/1/2008,6424,6052,372,5.8,154641,145203,9438,6.1
Winn,9/1/2008,6412,6071,341,5.3,154570,145076,9494,6.1
Winn,10/1/2008,6444,6070,374,5.8,154876,144802,10074,6.5
Winn,11/1/2008,6516,6145,371,5.7,154639,144100,10538,6.8
Winn,12/1/2008,6241,5841,400,6.4,154655,143369,11286,7.3
Winn,1/1/2009,6478,5979,499,7.7,154210,142152,12058,7.8
Winn,2/1/2009,6411,5874,537,8.4,154538,141640,12898,8.3
Winn,3/1/2009,6527,5997,530,8.1,154133,140707,13426,8.7
Winn,4/1/2009,6611,6114,497,7.5,154509,140656,13853,9
Winn,5/1/2009,6724,6200,524,7.8,154747,140248,14499,9.4
Winn,6/1/2009,6729,6129,600,8.9,154716,140009,14707,9.5
Winn,7/1/2009,6770,6172,598,8.8,154502,139901,14601,9.5
Winn,8/1/2009,6542,5988,554,8.5,154307,139492,14814,9.6
Winn,9/1/2009,6442,5889,553,8.6,153827,138818,15009,9.8
Winn,10/1/2009,6479,5956,523,8.1,153784,138432,15352,10
Winn,11/1/2009,6480,5958,522,8.1,153878,138659,15219,9.9
Winn,12/1/2009,6429,5907,522,8.1,153111,138013,15098,9.9
Winn,1/1/2010,5605,5079,526,9.4,153484,138438,15046,9.8
Winn,2/1/2010,5731,5242,489,8.5,153694,138581,15113,9.8
Winn,3/1/2010,5755,5266,489,8.5,153954,138751,15202,9.9
Winn,4/1/2010,5854,5392,462,7.9,154622,139297,15325,9.9
Winn,5/1/2010,5890,5404,486,8.3,154091,139241,14849,9.6
Winn,6/1/2010,6042,5491,551,9.1,153616,139141,14474,9.4
Winn,7/1/2010,5963,5421,542,9.1,153691,139179,14512,9.4
Winn,8/1/2010,5884,5364,520,8.8,154086,139438,14648,9.5
Winn,9/1/2010,5861,5336,525,9,153975,139396,14579,9.5
Winn,10/1/2010,5818,5314,504,8.7,153635,139119,14516,9.4
Winn,11/1/2010,5751,5237,514,8.9,154125,139044,15081,9.8
Winn,12/1/2010,5664,5179,485,8.6,153650,139301,14348,9.3
Winn,1/1/2011,5657,5084,573,10.1,153263,139250,14013,9.1
Winn,2/1/2011,5649,5150,499,8.8,153214,139394,13820,9
Winn,3/1/2011,5694,5207,487,8.6,153376,139639,13737,9
Winn,4/1/2011,5657,5181,476,8.4,153543,139586,13957,9.1
Winn,5/1/2011,5679,5199,480,8.5,153479,139624,13855,9
Winn,6/1/2011,5743,5191,552,9.6,153346,139384,13962,9.1
Winn,7/1/2011,5778,5241,537,9.3,153288,139524,13763,9
Winn,8/1/2011,5686,5165,521,9.2,153760,139942,13818,9
Winn,9/1/2011,5642,5137,505,9,154131,140183,13948,9
Winn,10/1/2011,5573,5096,477,8.6,153961,140368,13594,8.8
Winn,11/1/2011,5681,5215,466,8.2,154128,140826,13302,8.6
Winn,12/1/2011,5648,5200,448,7.9,153995,140902,13093,8.5
Winn,1/1/2012,5568,5074,494,8.9,154381,141584,12797,8.3
Winn,2/1/2012,5578,5056,522,9.4,154671,141858,12813,8.3
Winn,3/1/2012,5574,5116,458,8.2,154749,142036,12713,8.2
Winn,4/1/2012,5595,5160,435,7.8,154545,141899,12646,8.2
Winn,5/1/2012,5703,5248,455,8,154866,142206,12660,8.2
Winn,6/1/2012,5846,5321,525,9,155083,142391,12692,8.2
Winn,7/1/2012,5956,5433,523,8.8,154948,142292,12656,8.2
Winn,8/1/2012,5833,5358,475,8.1,154763,142291,12471,8.1
Winn,9/1/2012,5776,5339,437,7.6,155160,143044,12115,7.8
Winn,10/1/2012,5745,5331,414,7.2,155554,143431,12124,7.8
Winn,11/1/2012,5705,5323,382,6.7,155338,143333,12005,7.7
Winn,12/1/2012,5740,5307,433,7.5,155628,143330,12298,7.9
Winn,1/1/2013,5418,4909,509,9.4,155763,143292,12471,8
Winn,2/1/2013,5380,4948,432,8,155312,143362,11950,7.7
Winn,3/1/2013,5294,4875,419,7.9,155005,143316,11689,7.5
Winn,4/1/2013,5362,4941,421,7.9,155394,143635,11760,7.6
Winn,5/1/2013,5426,4985,441,8.1,155536,143882,11654,7.5
Winn,6/1/2013,5541,5054,487,8.8,155749,143999,11751,7.5
Winn,7/1/2013,5526,5075,451,8.2,155599,144264,11335,7.3
Winn,8/1/2013,5430,5003,427,7.9,155605,144326,11279,7.2
Winn,9/1/2013,5364,4965,399,7.4,155687,144418,11270,7.2
Winn,10/1/2013,5248,4878,370,7.1,154673,143537,11136,7.2
Winn,11/1/2013,5268,4907,361,6.9,155265,144479,10787,6.9
Winn,12/1/2013,5248,4919,329,6.3,155182,144778,10404,6.7
Winn,1/1/2014,5201,4852,349,6.7,155352,145150,10202,6.6
Winn,2/1/2014,5216,4897,319,6.1,155483,145134,10349,6.7
Winn,3/1/2014,5202,4862,340,6.5,156028,145648,10380,6.7
Winn,4/1/2014,5232,4917,315,6,155369,145667,9702,6.2
Winn,5/1/2014,5278,4914,364,6.9,155684,145825,9859,6.3
Winn,6/1/2014,5485,5065,420,7.7,155707,146247,9460,6.1
Winn,7/1/2014,5554,5100,454,8.2,156007,146399,9608,6.2
Winn,8/1/2014,5524,5066,458,8.3,156130,146530,9599,6.1
Winn,9/1/2014,5476,5025,451,8.2,156040,146778,9262,5.9
Winn,10/1/2014,5490,5076,414,7.5,156417,147427,8990,5.7
Winn,11/1/2014,5497,5042,455,8.3,156494,147404,9090,5.8
Winn,12/1/2014,5504,5066,438,8,156332,147615,8717,5.6
Winn,1/1/2015,5417,4961,456,8.4,157030,148145,8885,5.7
Winn,2/1/2015,5367,4961,406,7.6,156644,148045,8599,5.5
Winn,3/1/2015,5336,4910,426,8,156643,148128,8515,5.4
Winn,4/1/2015,5321,4871,450,8.5,157060,148511,8550,5.4
Winn,5/1/2015,5336,4840,496,9.3,157651,148817,8834,5.6
Winn,6/1/2015,5458,4947,511,9.4,157062,148816,8247,5.3
Winn,7/1/2015,5458,4964,494,9.1,156997,148830,8167,5.2
Winn,8/1/2015,5294,4856,438,8.3,157172,149181,7992,5.1
Winn,9/1/2015,5247,4805,442,8.4,156733,148826,7907,5
Winn,10/1/2015,5200,4781,419,8.1,157167,149246,7922,5
Winn,11/1/2015,5093,4690,403,7.9,157463,149463,8000,5.1
Winn,12/1/2015,5199,4805,394,7.6,158035,150128,7907,5
Winn,1/1/2016,5177,4743,434,8.4,158280,150653,7627,4.8
Winn,2/1/2016,5212,4823,389,7.5,158640,150939,7702,4.9
Winn,3/1/2016,5240,4861,379,7.2,159179,151218,7961,5
Winn,4/1/2016,5226,4845,381,7.3,159141,151074,8067,5.1
Winn,5/1/2016,5264,4859,405,7.7,158784,151132,7652,4.8
Winn,6/1/2016,5359,4926,433,8.1,158967,151223,7744,4.9
Winn,7/1/2016,5342,4911,431,8.1,159194,151554,7641,4.8
Winn,8/1/2016,5202,4788,414,8,159562,151779,7784,4.9
Winn,9/1/2016,5111,4709,402,7.9,159714,151761,7953,5
Winn,10/1/2016,5026,4649,377,7.5,159605,151793,7811,4.9
Winn,11/1/2016,5005,4644,361,7.2,159506,151954,7553,4.7
Winn,12/1/2016,5031,4637,394,7.8,159678,152157,7521,4.7
Winn,1/1/2017,5035,4636,399,7.9,159620,152152,7468,4.7
Winn,2/1/2017,4982,4621,361,7.2,159859,152480,7379,4.6
Winn,3/1/2017,5021,4684,337,6.7,160137,153065,7073,4.4
Winn,4/1/2017,5118,4794,324,6.3,160345,153255,7089,4.4
Winn,5/1/2017,5128,4801,327,6.4,160068,153069,7000,4.4
Winn,6/1/2017,5233,4883,350,6.7,160192,153318,6873,4.3
Winn,7/1/2017,5281,4926,355,6.7,160462,153569,6892,4.3
Winn,8/1/2017,5074,4742,332,6.5,160586,153503,7082,4.4
Winn,9/1/2017,4983,4682,301,6,161140,154286,6854,4.3
Winn,10/1/2017,4909,4641,268,5.5,160309,153609,6700,4.2
Winn,11/1/2017,4894,4625,269,5.5,160579,153805,6774,4.2
Winn,12/1/2017,4900,4624,276,5.6,160535,153904,6632,4.1
Winn,1/1/2018,4917,4612,305,6.2,160914,154425,6489,4
Winn,2/1/2018,4923,4631,292,5.9,161778,155197,6581,4.1
Winn,3/1/2018,4987,4694,293,5.9,161686,155214,6472,4
Winn,4/1/2018,4998,4713,285,5.7,161771,155312,6459,4
Winn,5/1/2018,5042,4751,291,5.8,161848,155652,6196,3.8
Winn,6/1/2018,5186,4805,381,7.3,162210,155762,6447,4
Winn,7/1/2018,5026,4684,342,6.8,162341,156146,6195,3.8
Winn,8/1/2018,4921,4609,312,6.3,161660,155504,6156,3.8
Winn,9/1/2018,4834,4539,295,6.1,162087,156015,6073,3.7
Winn,10/1/2018,4925,4640,285,5.8,162602,156391,6211,3.8
Winn,11/1/2018,4833,4553,280,5.8,162836,156721,6115,3.8
Winn,12/1/2018,4788,4515,273,5.7,163206,156817,6389,3.9
Winn,1/1/2019,4815,4495,320,6.6,162963,156487,6475,4
Winn,2/1/2019,4787,4511,276,5.8,162999,156863,6136,3.8
Winn,3/1/2019,4807,4553,254,5.3,162904,156701,6202,3.8
Winn,4/1/2019,4738,4493,245,5.2,162586,156625,5961,3.7
Winn,5/1/2019,4810,4535,275,5.7,162751,156821,5930,3.6
Winn,6/1/2019,4843,4515,328,6.8,163168,157232,5935,3.6
Winn,7/1/2019,4993,4653,340,6.8,163590,157529,6061,3.7
Winn,8/1/2019,4967,4651,316,6.4,163774,157829,5945,3.6
Winn,9/1/2019,4954,4666,288,5.8,164092,158339,5753,3.5
Winn,10/1/2019,4899,4602,297,6.1,164416,158545,5871,3.6
Winn,11/1/2019,4807,4508,299,6.2,164496,158629,5868,3.6
Winn,12/1/2019,4797,4508,289,6,164699,158845,5853,3.6
Winn,1/1/2020,4799,4496,303,6.3,164377,158508,5869,3.6
Winn,2/1/2020,4730,4471,259,5.5,164467,158714,5753,3.5
Winn,3/1/2020,4924,4475,449,9.1,162559,155353,7206,4.4
Winn,4/1/2020,4350,4010,340,7.8,156269,133185,23084,14.8
Winn,5/1/2020,4486,4124,362,8.1,158101,137173,20929,13.2
Winn,6/1/2020,4696,4298,398,8.5,159994,142342,17652,11
Winn,7/1/2020,4633,4221,412,8.9,160132,143779,16352,10.2
Winn,8/1/2020,4696,4323,373,7.9,160706,147245,13461,8.4
Winn,9/1/2020,4698,4320,378,8,160174,147620,12554,7.8
Winn,10/1/2020,4674,4351,323,6.9,161003,149931,11072,6.9
Winn,11/1/2020,4576,4276,300,6.6,160629,149934,10694,6.7
Winn,12/1/2020,4582,4264,318,6.9,160745,149975,10770,6.7
Winn,1/1/2021,4537,4231,306,6.7,160088,149852,10236,6.4
Winn,2/1/2021,4558,4273,285,6.3,160184,150189,9995,6.2
Winn,3/1/2021,4558,4290,268,5.9,160400,150644,9756,6.1
Winn,4/1/2021,4527,4288,239,5.3,160843,151081,9762,6.1
Winn,5/1/2021,4498,4258,240,5.3,160800,151535,9266,5.8
Winn,6/1/2021,4658,4383,275,5.9,161197,151734,9462,5.9
Winn,7/1/2021,4620,4373,247,5.3,161504,152773,8731,5.4
Winn,8/1/2021,4555,4343,212,4.7,161527,153250,8276,5.1
Winn,9/1/2021,4630,4433,197,4.3,161495,153843,7652,4.7
Winn,10/1/2021,4530,4355,175,3.9,161754,154475,7279,4.5
Winn,11/1/2021,4450,4295,155,3.5,162281,155530,6751,4.2
Winn,12/1/2021,4487,4339,148,3.3,162497,156099,6398,3.9
Winn,1/1/2022,4512,4315,197,4.4,163627,157115,6512,4
Winn,2/1/2022,4495,4332,163,3.6,163899,157598,6301,3.8
Winn,3/1/2022,4545,4382,163,3.6,164220,158206,6014,3.7
Winn,4/1/2022,4592,4436,156,3.4,163893,157891,6002,3.7
Winn,5/1/2022,4555,4380,175,3.8,164362,158378,5983,3.6
Winn,6/1/2022,4644,4403,241,5.2,164046,158094,5951,3.6
Winn,7/1/2022,4648,4428,220,4.7,164026,158258,5768,3.5
Winn,8/1/2022,4629,4429,200,4.3,164654,158735,5919,3.6
Winn,9/1/2022,4612,4434,178,3.9,164602,158810,5792,3.5
Winn,10/1/2022,4606,4435,171,3.7,164648,158684,5964,3.6
Winn,11/1/2022,4531,4361,170,3.8,164450,158507,5943,3.6
Winn,12/1/2022,4533,4358,175,3.9,165025,159259,5766,3.5
Winn,1/1/2023,4686,4481,205,4.4,165964,160217,5747,3.5
Winn,2/1/2023,4714,4520,194,4.1,166358,160395,5962,3.6
Winn,3/1/2023,4781,4587,194,4.1,166651,160812,5839,3.5
Winn,4/1/2023,4772,4596,176,3.7,166725,160974,5751,3.4
Winn,5/1/2023,4786,4581,205,4.3,166886,160796,6089,3.6
Winn,6/1/2023,4862,4629,233,4.8,166937,160979,5958,3.6
Winn,7/1/2023,4901,4703,198,4,167103,161183,5920,3.5
Winn,8/1/2023,4939,4729,210,4.3,167759,161475,6284,3.7
Winn,9/1/2023,4812,4606,206,4.3,167767,161442,6326,3.8
Winn,10/1/2023,4821,4618,203,4.2,167690,161211,6479,3.9
Winn,11/1/2023,4824,4618,206,4.3,168140,161886,6254,3.7
Winn,12/1/2023,4843,4613,230,4.7,167439,161124,6315,3.8
Winn,1/1/2024,4875,4612,263,5.4,167339,161190,6149,3.7
Winn,2/1/2024,4779,4541,238,5,167475,161013,6462,3.9
Winn,3/1/2024,4719,4487,232,4.9,167922,161425,6497,3.9
Winn,4/1/2024,4739,4513,226,4.8,167988,161495,6492,3.9
Winn,5/1/2024,4713,4476,237,5,167799,161164,6635,4
Winn,6/1/2024,4873,4566,307,6.3,168005,161155,6849,4.1
Winn,7/1/2024,4873,4598,275,5.6,168315,161219,7097,4.2
Winn,8/1/2024,4809,4535,274,5.7,168496,161425,7071,4.2
Winn,9/1/2024,4761,4500,261,5.5,168703,161802,6901,4.1
Winn,10/1/2024,4733,4476,257,5.4,168428,161456,6972,4.1
Winn,11/1/2024,4660,4400,260,5.6,168304,161183,7121,4.2
Winn,12/1/2024,4654,4414,240,5.2,168547,161661,6886,4.1
Winn,1/1/2025,4701,4450,251,5.3,170744,163895,6849,4
Winn,2/1/2025,4583,4368,215,4.7,170359,163307,7052,4.1
